,證券代號,證券名稱,外陸資買進股數(不含外資自營商),外陸資賣出股數(不含外資自營商),外陸資買賣超股數(不含外資自營商),外資自營商買進股數,外資自營商賣出股數,外資自營商買賣超股數,投信買進股數,投信賣出股數,投信買賣超股數,自營商買賣超股數,自營商買進股數(自行買賣),自營商賣出股數(自行買賣),自營商買賣超股數(自行買賣),自營商買進股數(避險),自營商賣出股數(避險),自營商買賣超股數(避險),三大法人買賣超股數,Date
0,00632R,元大台灣50反1,278000,281000,-3000,0,0,0,168000,0,168000,82152600,435000,0,435000,91615600,9898000,81717600,82317600,2021-06-09
1,00715L,期街口布蘭特正2,4785024,1479000,3306024,0,0,0,0,0,0,13695000,0,0,0,15307000,1612000,13695000,17001024,2021-06-09
2,00637L,元大滬深300正2,8624000,17000,8607000,0,0,0,0,0,0,4985170,0,0,0,14424220,9439050,4985170,13592170,2021-06-09
3,2618,長榮航,44712000,31651870,13060130,0,0,0,0,0,0,-1574160,5091387,5559547,-468160,196000,1302000,-1106000,11485970,2021-06-09
4,00642U,期元大S&P石油,1395000,461000,934000,0,0,0,0,0,0,9028000,0,0,0,9169000,141000,9028000,9962000,2021-06-09
5,1314,中石化,19274000,11039000,8235000,0,0,0,0,0,0,-2114187,263000,381187,-118187,223000,2219000,-1996000,6120813,2021-06-09
6,3014,聯陽,8312200,3976000,4336200,0,0,0,687000,0,687000,46469,140000,220000,-80000,256469,130000,126469,5069669,2021-06-09
7,2883,開發金,13766000,9353901,4412099,0,0,0,0,1089000,-1089000,682000,0,117000,-117000,814000,15000,799000,4005099,2021-06-09
8,3545,敦泰,12458600,8953261,3505339,0,0,0,385000,342000,43000,95000,772000,764000,8000,87000,0,87000,3643339,2021-06-09
9,2314,台揚,6996200,4983000,2013200,0,0,0,1131000,0,1131000,456000,154000,18000,136000,324000,4000,320000,3600200,2021-06-09
10,3711,日月光投控,7784463,4572400,3212063,0,0,0,16000,0,16000,-94750,2388,15000,-12612,10000,92138,-82138,3133313,2021-06-09
11,067709,大立光元富07購01,0,0,0,0,0,0,0,0,0,2923000,0,0,0,2923000,0,2923000,2923000,2021-06-09
12,035943,晶相光凱基13購01,0,0,0,0,0,0,0,0,0,2750000,0,0,0,3030000,280000,2750000,2750000,2021-06-09
13,9958,世紀鋼,2329000,1271000,1058000,0,0,0,1025000,0,1025000,661016,11094,13030,-1936,693952,31000,662952,2744016,2021-06-09
14,036219,晶相光國泰12購01,0,0,0,0,0,0,0,0,0,2644000,0,0,0,2879000,235000,2644000,2644000,2021-06-09
15,4142,國光生,3470000,824000,2646000,0,0,0,0,0,0,-28800,33000,33000,0,31200,60000,-28800,2617200,2021-06-09
16,2367,燿華,2740000,286000,2454000,0,0,0,0,0,0,-7000,0,0,0,16000,23000,-7000,2447000,2021-06-09
17,8046,南電,4552530,2750544,1801986,0,0,0,752000,7000,745000,-216467,208049,402000,-193951,100286,122802,-22516,2330519,2021-06-09
18,087682,台積電元大0B購05,0,0,0,0,0,0,0,0,0,2320000,0,0,0,2994000,674000,2320000,2320000,2021-06-09
19,2449,京元電子,9032000,6608000,2424000,0,0,0,5000,160000,-155000,42102,62672,66570,-3898,184000,138000,46000,2311102,2021-06-09
20,031343,晶相光元大0A購01,0,0,0,0,0,0,0,0,0,2110000,0,0,0,2223000,113000,2110000,2110000,2021-06-09
21,036464,永豐餘元大0C購02,0,0,0,0,0,0,0,0,0,2097000,0,0,0,2161000,64000,2097000,2097000,2021-06-09
22,2401,凌陽,10073000,9202340,870660,0,0,0,0,0,0,1004410,550717,508307,42410,1736000,774000,962000,1875070,2021-06-09
23,031064,聯陽元大0A購01,0,0,0,0,0,0,0,0,0,1834000,0,0,0,1866000,32000,1834000,1834000,2021-06-09
24,03486B,臺股指凱基07熊19,0,0,0,0,0,0,0,0,0,1822000,0,0,0,2819000,997000,1822000,1822000,2021-06-09
25,1313,聯成,4297000,2201181,2095819,0,0,0,0,0,0,-288000,0,10000,-10000,54000,332000,-278000,1807819,2021-06-09
26,8016,矽創,2371000,895000,1476000,0,0,0,546000,264000,282000,41142,50560,103548,-52988,139130,45000,94130,1799142,2021-06-09
27,00633L,富邦上証正2,1010000,20000,990000,0,0,0,0,0,0,803000,0,0,0,1786000,983000,803000,1793000,2021-06-09
28,2548,華固,2159642,323000,1836642,0,0,0,0,0,0,-44000,0,34000,-34000,0,10000,-10000,1792642,2021-06-09
29,00669R,國泰美國道瓊反1,1479000,39000,1440000,0,0,0,0,0,0,340000,0,0,0,1173000,833000,340000,1780000,2021-06-09
30,6257,矽格,1982000,214000,1768000,0,0,0,0,0,0,2000,64000,62000,2000,10000,10000,0,1770000,2021-06-09
31,3049,和鑫,2350000,570000,1780000,0,0,0,0,0,0,-30000,0,0,0,0,30000,-30000,1750000,2021-06-09
32,2383,台光電,2383767,1916000,467767,0,0,0,891000,11000,880000,377401,176377,15000,161377,254024,38000,216024,1725168,2021-06-09
33,036465,永豐餘元大0C購03,0,0,0,0,0,0,0,0,0,1666000,0,0,0,2250000,584000,1666000,1666000,2021-06-09
34,033512,南茂統一0C購01,0,0,0,0,0,0,0,0,0,1632000,0,0,0,2308000,676000,1632000,1632000,2021-06-09
35,1905,華紙,10909050,9276000,1633050,0,0,0,0,0,0,-4000,0,0,0,0,4000,-4000,1629050,2021-06-09
36,3189,景碩,5413325,4898134,515191,0,0,0,1410000,230000,1180000,-95138,112000,188138,-76138,170000,189000,-19000,1600053,2021-06-09
37,034264,光罩國票0C購02,0,0,0,0,0,0,0,0,0,1560000,0,0,0,2040000,480000,1560000,1560000,2021-06-09
38,020022,元大電動車N,0,0,0,0,0,0,0,0,0,1559000,0,0,0,3218000,1659000,1559000,1559000,2021-06-09
39,033393,晶相光元大12購01,0,0,0,0,0,0,0,0,0,1552000,0,0,0,1600000,48000,1552000,1552000,2021-06-09
40,1609,大亞,3174000,1464000,1710000,0,0,0,0,0,0,-216000,0,0,0,11000,227000,-216000,1494000,2021-06-09
41,1802,台玻,6864000,4286000,2578000,0,0,0,0,50000,-50000,-1046294,1013668,2078962,-1065294,269000,250000,19000,1481706,2021-06-09
42,4961,天鈺,4483020,3313070,1169950,0,0,0,734000,407000,327000,-24000,11000,35000,-24000,0,0,0,1472950,2021-06-09
43,3305,昇貿,3157000,1844000,1313000,0,0,0,0,0,0,155000,250000,145000,105000,50000,0,50000,1468000,2021-06-09
44,2103,台橡,3337000,1934000,1403000,0,0,0,0,0,0,41000,290000,0,290000,7000,256000,-249000,1444000,2021-06-09
45,03758C,T50反1元大0B牛09,0,0,0,0,0,0,0,0,0,1420000,0,0,0,3355000,1935000,1420000,1420000,2021-06-09
46,088325,華通元大09購02,0,0,0,0,0,0,0,0,0,1383000,0,0,0,1393000,10000,1383000,1383000,2021-06-09
47,032647,南茂統一0A購02,0,0,0,0,0,0,0,0,0,1318000,0,0,0,1318000,0,1318000,1318000,2021-06-09
48,1102,亞泥,3419000,2058700,1360300,0,0,0,0,334000,-334000,273240,151000,8760,142240,131000,0,131000,1299540,2021-06-09
49,081441,順德統一08購01,0,0,0,0,0,0,0,0,0,1291000,0,0,0,1649000,358000,1291000,1291000,2021-06-09
50,6213,聯茂,1662000,557000,1105000,0,0,0,68000,0,68000,111308,251001,223000,28001,83307,0,83307,1284308,2021-06-09
51,033795,台郡元大0B購02,0,0,0,0,0,0,0,0,0,1281000,0,0,0,1676000,395000,1281000,1281000,2021-06-09
52,071800,新光金國票06購01,0,0,0,0,0,0,0,0,0,1281000,0,0,0,1281000,0,1281000,1281000,2021-06-09
53,077393,台積電凱基0B購01,0,0,0,0,0,0,0,0,0,1224000,0,0,0,1309000,85000,1224000,1224000,2021-06-09
54,089945,南電永豐0A購01,0,0,0,0,0,0,0,0,0,1199000,0,0,0,1576000,377000,1199000,1199000,2021-06-09
55,033191,友達凱基15購01,0,0,0,0,0,0,0,0,0,1198000,0,0,0,1721000,523000,1198000,1198000,2021-06-09
56,033826,南電統一11購01,0,0,0,0,0,0,0,0,0,1167000,0,0,0,1881000,714000,1167000,1167000,2021-06-09
57,033662,欣興統一15購01,0,0,0,0,0,0,0,0,0,1164000,0,0,0,1264000,100000,1164000,1164000,2021-06-09
58,6116,彩晶,31649850,29138000,2511850,0,0,0,0,0,0,-1373000,2947584,2864584,83000,433000,1889000,-1456000,1138850,2021-06-09
59,034457,聯電群益11購02,0,0,0,0,0,0,0,0,0,1129000,0,0,0,1449000,320000,1129000,1129000,2021-06-09
60,032863,聯陽群益0A購03,0,0,0,0,0,0,0,0,0,1103000,0,0,0,1663000,560000,1103000,1103000,2021-06-09
61,084203,順德元大07購09,0,0,0,0,0,0,0,0,0,1102000,0,0,0,1126000,24000,1102000,1102000,2021-06-09
62,2308,台達電,3319000,3335215,-16215,0,0,0,1205000,1000,1204000,-90583,19417,101000,-81583,28000,37000,-9000,1097202,2021-06-09
63,07115P,臺股指麥證0B售05,0,0,0,1458000,382000,1076000,0,0,0,1076000,0,0,0,1458000,382000,1076000,1076000,2021-06-09
64,033341,友達永豐0B購02,0,0,0,0,0,0,0,0,0,1050000,0,0,0,1100000,50000,1050000,1050000,2021-06-09
65,084049,聯發科國票09購04,0,0,0,0,0,0,0,0,0,1049000,0,0,0,1121000,72000,1049000,1049000,2021-06-09
66,035100,大成鋼元大0B購13,0,0,0,0,0,0,0,0,0,1045000,0,0,0,1088000,43000,1045000,1045000,2021-06-09
67,089569,晶碩中信0B購01,0,0,0,0,0,0,0,0,0,1040000,0,0,0,1330000,290000,1040000,1040000,2021-06-09
68,086473,健策兆豐09購01,0,0,0,0,0,0,0,0,0,1035000,0,0,0,1326000,291000,1035000,1035000,2021-06-09
69,082500,台勝科統一0A購01,0,0,0,0,0,0,0,0,0,1029000,0,0,0,1033000,4000,1029000,1029000,2021-06-09
70,078333,聯電凱基08購02,0,0,0,0,0,0,0,0,0,1023000,0,0,0,1726000,703000,1023000,1023000,2021-06-09
71,035635,鴻海富邦13購03,0,0,0,0,0,0,0,0,0,1012000,0,0,0,1012000,0,1012000,1012000,2021-06-09
72,2484,希華,2278000,1297000,981000,0,0,0,0,0,0,30000,45000,15000,30000,0,0,0,1011000,2021-06-09
73,033663,欣興統一15購02,0,0,0,0,0,0,0,0,0,1008000,0,0,0,1027000,19000,1008000,1008000,2021-06-09
74,078420,深中小群益07購01,0,0,0,0,0,0,0,0,0,1002000,0,0,0,1002000,0,1002000,1002000,2021-06-09
75,083701,日月光元富07購06,0,0,0,0,0,0,0,0,0,998000,0,0,0,998000,0,998000,998000,2021-06-09
76,035725,健策元大0B購06,0,0,0,0,0,0,0,0,0,975000,0,0,0,1304000,329000,975000,975000,2021-06-09
77,034007,友達群益0B購06,0,0,0,0,0,0,0,0,0,968000,0,0,0,978000,10000,968000,968000,2021-06-09
78,033046,玉晶光兆豐0C購01,0,0,0,0,0,0,0,0,0,963000,0,0,0,994000,31000,963000,963000,2021-06-09
79,030951,奇鋐富邦0A購01,0,0,0,0,0,0,0,0,0,962000,0,0,0,982000,20000,962000,962000,2021-06-09
80,087594,世紀鋼元大0C購01,0,0,0,0,0,0,0,0,0,953000,0,0,0,953000,0,953000,953000,2021-06-09
81,06186P,臺股指國票08售07,0,0,0,0,0,0,0,0,0,943000,0,0,0,1217000,274000,943000,943000,2021-06-09
82,8081,致新,781000,285000,496000,0,0,0,376000,0,376000,71000,0,0,0,74000,3000,71000,943000,2021-06-09
83,035441,寶成元大0B購02,0,0,0,0,0,0,0,0,0,931000,0,0,0,958000,27000,931000,931000,2021-06-09
84,086401,友達統一0B購01,0,0,0,0,0,0,0,0,0,920000,0,0,0,1320000,400000,920000,920000,2021-06-09
85,06754P,台灣50凱基0C售03,0,0,0,0,0,0,0,0,0,919000,0,0,0,1240000,321000,919000,919000,2021-06-09
86,2601,益航,5006000,4093000,913000,0,0,0,0,0,0,0,0,0,0,0,0,0,913000,2021-06-09
87,033269,旺宏富邦13購01,0,0,0,0,0,0,0,0,0,912000,0,0,0,1121000,209000,912000,912000,2021-06-09
88,087104,台積電元大11購02,0,0,0,0,0,0,0,0,0,911000,0,0,0,2670000,1759000,911000,911000,2021-06-09
89,6202,盛群,1038000,464000,574000,0,0,0,161000,20000,141000,194967,967,0,967,200000,6000,194000,909967,2021-06-09
90,035708,台橡元大0B購03,0,0,0,0,0,0,0,0,0,905000,0,0,0,909000,4000,905000,905000,2021-06-09
91,076163,中石化元大08購01,0,0,0,0,0,0,0,0,0,904000,0,0,0,904000,0,904000,904000,2021-06-09
92,085545,A50正2群益09購01,0,0,0,0,0,0,0,0,0,893000,0,0,0,993000,100000,893000,893000,2021-06-09
93,036093,大立光元大12購01,0,0,0,0,0,0,0,0,0,893000,0,0,0,898000,5000,893000,893000,2021-06-09
94,086372,滬深2X國票0A購02,0,0,0,0,0,0,0,0,0,885000,0,0,0,895000,10000,885000,885000,2021-06-09
95,084734,台積電元大0B購01,0,0,0,0,0,0,0,0,0,883000,0,0,0,1506000,623000,883000,883000,2021-06-09
96,083938,南電中信07購01,0,0,0,0,0,0,0,0,0,879000,0,0,0,1546000,667000,879000,879000,2021-06-09
97,085674,南電統一0A購05,0,0,0,0,0,0,0,0,0,873000,0,0,0,873000,0,873000,873000,2021-06-09
98,033879,華新元富0B購03,0,0,0,0,0,0,0,0,0,872000,0,0,0,940000,68000,872000,872000,2021-06-09
99,033401,正隆中信0B購01,0,0,0,0,0,0,0,0,0,868000,0,0,0,940000,72000,868000,868000,2021-06-09
100,034579,國巨凱基0B購06,0,0,0,0,0,0,0,0,0,865000,0,0,0,1030000,165000,865000,865000,2021-06-09
101,034803,長榮凱基15購01,0,0,0,0,0,0,0,0,0,863000,0,0,0,1036000,173000,863000,863000,2021-06-09
102,2338,光罩,4237000,3393000,844000,0,0,0,0,16000,-16000,28737,297737,571000,-273263,394000,92000,302000,856737,2021-06-09
103,035963,台積電元大0C購14,0,0,0,0,0,0,0,0,0,850000,0,0,0,1090000,240000,850000,850000,2021-06-09
104,031549,長榮中信0C購03,0,0,0,0,0,0,0,0,0,829000,0,0,0,829000,0,829000,829000,2021-06-09
105,031185,群創永豐0A購06,0,0,0,0,0,0,0,0,0,816000,0,0,0,1223000,407000,816000,816000,2021-06-09
106,033411,聯成永豐0B購01,0,0,0,0,0,0,0,0,0,814000,0,0,0,814000,0,814000,814000,2021-06-09
107,00875,國泰網路資安,662000,12000,650000,0,0,0,0,0,0,163244,0,0,0,256244,93000,163244,813244,2021-06-09
108,035940,奇鋐凱基11購01,0,0,0,0,0,0,0,0,0,811000,0,0,0,839000,28000,811000,811000,2021-06-09
109,034623,超豐元富0B購01,0,0,0,0,0,0,0,0,0,806000,0,0,0,947000,141000,806000,806000,2021-06-09
110,071521,旺宏元富09購01,0,0,0,0,0,0,0,0,0,803000,0,0,0,803000,0,803000,803000,2021-06-09
111,035713,順德元大0B購01,0,0,0,0,0,0,0,0,0,802000,0,0,0,1098000,296000,802000,802000,2021-06-09
112,030374,亞翔群益0A購01,0,0,0,0,0,0,0,0,0,800000,0,0,0,800000,0,800000,800000,2021-06-09
113,06062P,臺股指麥證07售08,0,0,0,800000,0,800000,0,0,0,800000,0,0,0,800000,0,800000,800000,2021-06-09
114,033740,華新富邦0B購02,0,0,0,0,0,0,0,0,0,800000,0,0,0,823000,23000,800000,800000,2021-06-09
115,6269,台郡,877740,274000,603740,0,0,0,208000,0,208000,-15335,2000,4000,-2000,4665,18000,-13335,796405,2021-06-09
116,2402,毅嘉,900000,111000,789000,0,0,0,0,0,0,0,0,0,0,0,0,0,789000,2021-06-09
117,033345,欣興永豐0B購02,0,0,0,0,0,0,0,0,0,788000,0,0,0,892000,104000,788000,788000,2021-06-09
118,3006,晶豪科,4646564,3557836,1088728,0,0,0,0,242000,-242000,-59000,345000,421000,-76000,63000,46000,17000,787728,2021-06-09
119,035353,泰豐中信0B購01,0,0,0,0,0,0,0,0,0,786000,0,0,0,786000,0,786000,786000,2021-06-09
120,2337,旺宏,4294000,4464000,-170000,0,0,0,1400000,0,1400000,-444432,185000,239432,-54432,34000,424000,-390000,785568,2021-06-09
121,033024,矽創中信0B購01,0,0,0,0,0,0,0,0,0,780000,0,0,0,820000,40000,780000,780000,2021-06-09
122,033894,燁輝統一0B購02,0,0,0,0,0,0,0,0,0,775000,0,0,0,874000,99000,775000,775000,2021-06-09
123,2233,宇隆,475000,307000,168000,0,0,0,512000,0,512000,95000,114000,19000,95000,0,0,0,775000,2021-06-09
124,034948,大成鋼凱基15購01,0,0,0,0,0,0,0,0,0,773000,0,0,0,798000,25000,773000,773000,2021-06-09
125,087687,金像電元大09購02,0,0,0,0,0,0,0,0,0,766000,0,0,0,996000,230000,766000,766000,2021-06-09
126,086557,欣興元大11購01,0,0,0,0,0,0,0,0,0,765000,0,0,0,772000,7000,765000,765000,2021-06-09
127,086256,滬深2X兆豐0A購01,0,0,0,0,0,0,0,0,0,760000,0,0,0,800000,40000,760000,760000,2021-06-09
128,036095,晶相光元大0C購02,0,0,0,0,0,0,0,0,0,754000,0,0,0,801000,47000,754000,754000,2021-06-09
129,2313,華通,1471259,681000,790259,0,0,0,5000,0,5000,-54131,41000,45131,-4131,3000,53000,-50000,741128,2021-06-09
130,033259,群創元大0B購07,0,0,0,0,0,0,0,0,0,741000,0,0,0,1062000,321000,741000,741000,2021-06-09
131,079906,精英國泰08購01,0,0,0,0,0,0,0,0,0,734000,0,0,0,734000,0,734000,734000,2021-06-09
132,07173P,長榮航凱基0B售03,0,0,0,0,0,0,0,0,0,732000,0,0,0,1018000,286000,732000,732000,2021-06-09
133,036260,永豐餘群益12購01,0,0,0,0,0,0,0,0,0,723000,0,0,0,838000,115000,723000,723000,2021-06-09
134,030375,聚鼎群益0A購01,0,0,0,0,0,0,0,0,0,706000,0,0,0,1243000,537000,706000,706000,2021-06-09
135,036062,台光電群益11購01,0,0,0,0,0,0,0,0,0,705000,0,0,0,1093000,388000,705000,705000,2021-06-09
136,085625,SGBR2X凱基08購02,0,0,0,0,0,0,0,0,0,702000,0,0,0,907000,205000,702000,702000,2021-06-09
137,1301,台塑,4749607,2958886,1790721,0,0,0,0,65000,-65000,-1024000,33000,1028000,-995000,0,29000,-29000,701721,2021-06-09
138,030387,直得元大0A購02,0,0,0,0,0,0,0,0,0,700000,0,0,0,1060000,360000,700000,700000,2021-06-09
139,082596,台積電元大07購18,0,0,0,0,0,0,0,0,0,700000,0,0,0,700000,0,700000,700000,2021-06-09
140,2105,正新,2791000,2085400,705600,0,0,0,0,0,0,-12351,81000,101351,-20351,31000,23000,8000,693249,2021-06-09
141,3026,禾伸堂,801000,142000,659000,0,0,0,0,0,0,30000,2000,2000,0,36000,6000,30000,689000,2021-06-09
142,036088,長榮航元大0C購04,0,0,0,0,0,0,0,0,0,688000,0,0,0,877000,189000,688000,688000,2021-06-09
143,070273,玉晶光元富08購02,0,0,0,0,0,0,0,0,0,688000,0,0,0,708000,20000,688000,688000,2021-06-09
144,1309,台達化,1772000,1051000,721000,0,0,0,0,0,0,-33098,1000,4098,-3098,10000,40000,-30000,687902,2021-06-09
145,034506,台光電凱基0C購01,0,0,0,0,0,0,0,0,0,684000,0,0,0,739000,55000,684000,684000,2021-06-09
146,086324,滬深2X元大09購03,0,0,0,0,0,0,0,0,0,683000,0,0,0,1040000,357000,683000,683000,2021-06-09
147,036486,長榮航麥證0C購02,0,0,0,711000,30000,681000,0,0,0,681000,0,0,0,711000,30000,681000,681000,2021-06-09
148,035728,台表科元大0B購04,0,0,0,0,0,0,0,0,0,678000,0,0,0,731000,53000,678000,678000,2021-06-09
149,06629P,長榮航凱基09售03,0,0,0,0,0,0,0,0,0,676000,0,0,0,883000,207000,676000,676000,2021-06-09
150,2605,新興,3999000,3198000,801000,0,0,0,0,0,0,-127021,3023,16844,-13821,42000,155200,-113200,673979,2021-06-09
151,033067,矽統凱基0B購01,0,0,0,0,0,0,0,0,0,673000,0,0,0,753000,80000,673000,673000,2021-06-09
152,3041,揚智,962000,292000,670000,0,0,0,0,0,0,0,0,0,0,0,0,0,670000,2021-06-09
153,087103,台積電元大11購01,0,0,0,0,0,0,0,0,0,668000,0,0,0,1110000,442000,668000,668000,2021-06-09
154,082302,乙盛元大07購02,0,0,0,0,0,0,0,0,0,668000,0,0,0,668000,0,668000,668000,2021-06-09
155,034313,晶碩永豐0B購02,0,0,0,0,0,0,0,0,0,667000,0,0,0,684000,17000,667000,667000,2021-06-09
156,00634R,富邦上証反1,0,7000,-7000,0,0,0,0,0,0,669970,0,0,0,720000,50030,669970,662970,2021-06-09
157,1760,寶齡富錦,1147000,596000,551000,0,0,0,0,0,0,102000,0,0,0,116000,14000,102000,653000,2021-06-09
158,2415,錩新,875000,223000,652000,0,0,0,0,0,0,0,0,0,0,0,0,0,652000,2021-06-09
159,085326,上証2X群益09購01,0,0,0,0,0,0,0,0,0,649000,0,0,0,649000,0,649000,649000,2021-06-09
160,1605,華新,5112200,4179000,933200,0,0,0,0,0,0,-284834,219000,228834,-9834,24000,299000,-275000,648366,2021-06-09
161,00762,元大全球AI,30000,0,30000,0,0,0,0,0,0,618000,0,0,0,618000,0,618000,648000,2021-06-09
162,030669,啟碁永豐0A購01,0,0,0,0,0,0,0,0,0,646000,0,0,0,834000,188000,646000,646000,2021-06-09
163,3019,亞光,751000,144000,607000,0,0,0,0,0,0,37025,24027,2,24025,21000,8000,13000,644025,2021-06-09
164,084312,聯發科凱基09購04,0,0,0,0,0,0,0,0,0,643000,0,0,0,748000,105000,643000,643000,2021-06-09
165,6251,定穎,2182000,1543428,638572,0,0,0,0,0,0,1,1,0,1,0,0,0,638573,2021-06-09
166,084460,明基材永豐08購01,0,0,0,0,0,0,0,0,0,638000,0,0,0,638000,0,638000,638000,2021-06-09
167,031122,聯電統一0C購01,0,0,0,0,0,0,0,0,0,637000,0,0,0,720000,83000,637000,637000,2021-06-09
168,2454,聯發科,2031827,1479944,551883,0,0,0,153000,48000,105000,-21448,37799,64308,-26509,27061,22000,5061,635435,2021-06-09
169,032418,榮成元大0B購01,0,0,0,0,0,0,0,0,0,633000,0,0,0,633000,0,633000,633000,2021-06-09
170,6672,騰輝電子-KY,1367000,839000,528000,0,0,0,0,0,0,105000,105000,0,105000,0,0,0,633000,2021-06-09
171,088759,南茂統一0B購01,0,0,0,0,0,0,0,0,0,630000,0,0,0,655000,25000,630000,630000,2021-06-09
172,030401,威盛元大0A購01,0,0,0,0,0,0,0,0,0,625000,0,0,0,625000,0,625000,625000,2021-06-09
173,035818,奇鋐兆豐11購01,0,0,0,0,0,0,0,0,0,623000,0,0,0,732000,109000,623000,623000,2021-06-09
174,034905,台橡元大0B購02,0,0,0,0,0,0,0,0,0,623000,0,0,0,658000,35000,623000,623000,2021-06-09
175,2340,光磊,952000,481000,471000,0,0,0,0,0,0,151041,41,0,41,154000,3000,151000,622041,2021-06-09
176,035419,大成鋼元大0B購14,0,0,0,0,0,0,0,0,0,621000,0,0,0,667000,46000,621000,621000,2021-06-09
177,032050,威盛國票0B購01,0,0,0,0,0,0,0,0,0,619000,0,0,0,817000,198000,619000,619000,2021-06-09
178,1515,力山,836000,328000,508000,0,0,0,0,0,0,109000,0,0,0,110000,1000,109000,617000,2021-06-09
179,087798,GIS日盛0A購01,0,0,0,0,0,0,0,0,0,616000,0,0,0,616000,0,616000,616000,2021-06-09
180,087965,日月光中信09購01,0,0,0,0,0,0,0,0,0,615000,0,0,0,615000,0,615000,615000,2021-06-09
181,030406,超豐元大0A購01,0,0,0,0,0,0,0,0,0,614000,0,0,0,841000,227000,614000,614000,2021-06-09
182,07099P,長榮凱基0B售12,0,0,0,0,0,0,0,0,0,614000,0,0,0,682000,68000,614000,614000,2021-06-09
183,084277,台積電富邦09購07,0,0,0,0,0,0,0,0,0,609000,0,0,0,610000,1000,609000,609000,2021-06-09
184,4564,元翎,1472000,881000,591000,0,0,0,0,0,0,15000,0,0,0,15000,0,15000,606000,2021-06-09
185,035548,金像電統一12購01,0,0,0,0,0,0,0,0,0,603000,0,0,0,630000,27000,603000,603000,2021-06-09
186,032955,台橡元大0C購01,0,0,0,0,0,0,0,0,0,602000,0,0,0,614000,12000,602000,602000,2021-06-09
187,084738,圓剛元大08購01,0,0,0,0,0,0,0,0,0,600000,0,0,0,600000,0,600000,600000,2021-06-09
188,034987,金像電群益0C購01,0,0,0,0,0,0,0,0,0,600000,0,0,0,856000,256000,600000,600000,2021-06-09
189,3094,聯傑,815000,216000,599000,0,0,0,0,0,0,0,0,0,0,0,0,0,599000,2021-06-09
190,034689,聯電群益0C購02,0,0,0,0,0,0,0,0,0,594000,0,0,0,1183000,589000,594000,594000,2021-06-09
191,035877,長榮航群益12購01,0,0,0,0,0,0,0,0,0,593000,0,0,0,813000,220000,593000,593000,2021-06-09
192,3605,宏致,994000,402000,592000,0,0,0,0,0,0,0,0,0,0,0,0,0,592000,2021-06-09
193,031703,台橡永豐0A購02,0,0,0,0,0,0,0,0,0,591000,0,0,0,595000,4000,591000,591000,2021-06-09
194,06906P,臺股指中信12售03,0,0,0,0,0,0,0,0,0,582000,0,0,0,679000,97000,582000,582000,2021-06-09
195,082137,大立光統一0B購01,0,0,0,0,0,0,0,0,0,580000,0,0,0,580000,0,580000,580000,2021-06-09
196,081144,奇力新凱基09購01,0,0,0,0,0,0,0,0,0,579000,0,0,0,579000,0,579000,579000,2021-06-09
197,089264,南電統一0A購10,0,0,0,0,0,0,0,0,0,579000,0,0,0,579000,0,579000,579000,2021-06-09
198,034565,友達國泰13購01,0,0,0,0,0,0,0,0,0,578000,0,0,0,641000,63000,578000,578000,2021-06-09
199,3704,合勤控,1209000,634000,575000,0,0,0,0,0,0,2000,0,8000,-8000,10000,0,10000,577000,2021-06-09
200,032379,東鋼統一0C購05,0,0,0,0,0,0,0,0,0,575000,0,0,0,600000,25000,575000,575000,2021-06-09
201,034391,智原元大0B購04,0,0,0,0,0,0,0,0,0,574000,0,0,0,746000,172000,574000,574000,2021-06-09
202,085581,奇鋐兆豐08購01,0,1000,-1000,0,0,0,0,0,0,571000,0,0,0,665000,94000,571000,570000,2021-06-09
203,032777,台船元大0A購01,0,0,0,0,0,0,0,0,0,570000,0,0,0,580000,10000,570000,570000,2021-06-09
204,082601,億光元大07購03,0,0,0,0,0,0,0,0,0,568000,0,0,0,574000,6000,568000,568000,2021-06-09
205,030971,致茂元大0A購02,0,0,0,0,0,0,0,0,0,566000,0,0,0,592000,26000,566000,566000,2021-06-09
206,034085,金像電元大0C購01,0,0,0,0,0,0,0,0,0,565000,0,0,0,1169000,604000,565000,565000,2021-06-09
207,04774P,臺股指國票09售06,0,0,0,0,0,0,0,0,0,565000,0,0,0,565000,0,565000,565000,2021-06-09
208,087986,GIS凱基09購02,0,0,0,0,0,0,0,0,0,563000,0,0,0,563000,0,563000,563000,2021-06-09
209,07033P,健策元大0B售04,0,0,0,0,0,0,0,0,0,562000,0,0,0,809000,247000,562000,562000,2021-06-09
210,078069,世紀鋼元大07購05,0,0,0,0,0,0,0,0,0,562000,0,0,0,562000,0,562000,562000,2021-06-09
211,3530,晶相光,908000,29000,879000,0,0,0,0,450000,-450000,132000,18000,0,18000,284000,170000,114000,561000,2021-06-09
212,035844,奇鋐元大0B購04,0,0,0,0,0,0,0,0,0,560000,0,0,0,654000,94000,560000,560000,2021-06-09
213,083359,健和興永豐07購03,0,0,0,0,0,0,0,0,0,559000,0,0,0,559000,0,559000,559000,2021-06-09
214,3033,威健,910000,366000,544000,0,0,0,0,0,0,12000,0,0,0,14000,2000,12000,556000,2021-06-09
215,033427,晶碩永豐0B購01,0,0,0,0,0,0,0,0,0,555000,0,0,0,556000,1000,555000,555000,2021-06-09
216,07172P,大成鋼凱基0B售07,0,0,0,0,0,0,0,0,0,555000,0,0,0,560000,5000,555000,555000,2021-06-09
217,088935,玉晶光統一0C購01,0,0,0,0,0,0,0,0,0,554000,0,0,0,716000,162000,554000,554000,2021-06-09
218,034418,國巨統一11購02,0,0,0,0,0,0,0,0,0,549000,0,0,0,594000,45000,549000,549000,2021-06-09
219,085007,滬深2X元大08購09,0,0,0,0,0,0,0,0,0,548000,0,0,0,648000,100000,548000,548000,2021-06-09
220,034732,台積電元大0B購10,0,0,0,0,0,0,0,0,0,543000,0,0,0,581000,38000,543000,543000,2021-06-09
221,06543P,臺股指凱基0C售09,0,0,0,0,0,0,0,0,0,542000,0,0,0,590000,48000,542000,542000,2021-06-09
222,05894P,台灣50國票08售05,0,0,0,0,0,0,0,0,0,541000,0,0,0,546000,5000,541000,541000,2021-06-09
223,033325,欣興凱基0C購03,0,0,0,0,0,0,0,0,0,539000,0,0,0,797000,258000,539000,539000,2021-06-09
224,035262,安集凱基11購02,0,0,0,0,0,0,0,0,0,537000,0,0,0,537000,0,537000,537000,2021-06-09
225,035010,健策元大0B購05,0,0,0,0,0,0,0,0,0,535000,0,0,0,617000,82000,535000,535000,2021-06-09
226,030131,盟立凱基0A購01,0,0,0,0,0,0,0,0,0,532000,0,0,0,629000,97000,532000,532000,2021-06-09
227,06148P,臺股指麥證07售11,0,0,0,541000,10000,531000,0,0,0,531000,0,0,0,541000,10000,531000,531000,2021-06-09
228,087836,禾伸堂凱基09購02,0,0,0,0,0,0,0,0,0,530000,0,0,0,530000,0,530000,530000,2021-06-09
229,2455,全新,678000,432000,246000,0,0,0,169000,0,169000,114559,86000,33441,52559,73000,11000,62000,529559,2021-06-09
230,1455,集盛,865019,536000,329019,0,0,0,0,0,0,200000,0,0,0,200000,0,200000,529019,2021-06-09
231,033287,聯詠統一0C購04,0,0,0,0,0,0,0,0,0,529000,0,0,0,529000,0,529000,529000,2021-06-09
232,089925,中化永豐0A購01,0,0,0,0,0,0,0,0,0,529000,0,0,0,594000,65000,529000,529000,2021-06-09
233,032737,中鋼凱基0C購02,0,0,0,0,0,0,0,0,0,527000,0,0,0,587000,60000,527000,527000,2021-06-09
234,06361P,臺股指中信0C售05,0,0,0,0,0,0,0,0,0,527000,0,0,0,857000,330000,527000,527000,2021-06-09
235,034695,長榮群益0C購08,0,0,0,0,0,0,0,0,0,526000,0,0,0,684000,158000,526000,526000,2021-06-09
236,033820,友訊統一0C購01,0,0,0,0,0,0,0,0,0,522000,0,0,0,522000,0,522000,522000,2021-06-09
237,031669,長榮元大12購04,0,0,0,0,0,0,0,0,0,520000,0,0,0,520000,0,520000,520000,2021-06-09
238,035760,景碩元富13購01,0,0,0,0,0,0,0,0,0,520000,0,0,0,720000,200000,520000,520000,2021-06-09
239,036195,王品統一12購01,0,0,0,0,0,0,0,0,0,519000,0,0,0,661000,142000,519000,519000,2021-06-09
240,034904,中鋼元大11購03,0,0,0,0,0,0,0,0,0,519000,0,0,0,555000,36000,519000,519000,2021-06-09
241,031793,聯電國票0B購03,0,0,0,0,0,0,0,0,0,515000,0,0,0,522000,7000,515000,515000,2021-06-09
242,032589,聯電元大0A購14,0,0,0,0,0,0,0,0,0,513000,0,0,0,524000,11000,513000,513000,2021-06-09
243,080617,智邦元富09購04,0,0,0,0,0,0,0,0,0,512000,0,0,0,512000,0,512000,512000,2021-06-09
244,032041,東鋼國票0B購03,0,0,0,0,0,0,0,0,0,509000,0,0,0,530000,21000,509000,509000,2021-06-09
245,033084,矽創統一0A購02,0,0,0,0,0,0,0,0,0,506000,0,0,0,666000,160000,506000,506000,2021-06-09
246,035777,金像電富邦0B購01,0,0,0,0,0,0,0,0,0,506000,0,0,0,562000,56000,506000,506000,2021-06-09
247,088480,南茂國票0A購03,0,0,0,0,0,0,0,0,0,505000,0,0,0,619000,114000,505000,505000,2021-06-09
248,1303,南亞,5835000,3712900,2122100,0,0,0,0,1119000,-1119000,-502785,8000,451785,-443785,0,59000,-59000,500315,2021-06-09
249,087777,祥碩中信0A購02,0,0,0,0,0,0,0,0,0,500000,0,0,0,500000,0,500000,500000,2021-06-09
250,088784,安集國票0A購01,0,0,0,0,0,0,0,0,0,499000,0,0,0,499000,0,499000,499000,2021-06-09
251,084467,聯電凱基08購09,0,0,0,0,0,0,0,0,0,499000,0,0,0,520000,21000,499000,499000,2021-06-09
252,084217,京鼎元大07購02,0,0,0,0,0,0,0,0,0,499000,0,0,0,499000,0,499000,499000,2021-06-09
253,031540,鴻海永豐0A購04,0,0,0,0,0,0,0,0,0,499000,0,0,0,499000,0,499000,499000,2021-06-09
254,035687,玉晶光凱基0C購03,0,0,0,0,0,0,0,0,0,499000,0,0,0,500000,1000,499000,499000,2021-06-09
255,06266P,台灣50凱基09售04,0,0,0,0,0,0,0,0,0,499000,0,0,0,499000,0,499000,499000,2021-06-09
256,077890,瀚宇博國票07購01,0,0,0,0,0,0,0,0,0,499000,0,0,0,499000,0,499000,499000,2021-06-09
257,034144,國巨凱基15購01,0,0,0,0,0,0,0,0,0,497000,0,0,0,623000,126000,497000,497000,2021-06-09
258,084862,台光電元大08購02,0,0,0,0,0,0,0,0,0,494000,0,0,0,982000,488000,494000,494000,2021-06-09
259,080633,寶齡元大09購01,0,0,0,0,0,0,0,0,0,490000,0,0,0,490000,0,490000,490000,2021-06-09
260,034446,台橡國泰11購01,0,0,0,0,0,0,0,0,0,489000,0,0,0,517000,28000,489000,489000,2021-06-09
261,035396,奇鋐永豐0B購01,0,0,0,0,0,0,0,0,0,488000,0,0,0,488000,0,488000,488000,2021-06-09
262,035317,超豐元大0B購01,0,0,0,0,0,0,0,0,0,487000,0,0,0,655000,168000,487000,487000,2021-06-09
263,086816,欣興元富09購01,0,0,0,0,0,0,0,0,0,486000,0,0,0,1048000,562000,486000,486000,2021-06-09
264,031126,長榮統一0C購04,0,0,0,0,0,0,0,0,0,486000,0,0,0,496000,10000,486000,486000,2021-06-09
265,036230,超豐永豐0C購01,0,0,0,0,0,0,0,0,0,486000,0,0,0,486000,0,486000,486000,2021-06-09
266,084514,凌陽元大08購05,0,0,0,0,0,0,0,0,0,485000,0,0,0,1261000,776000,485000,485000,2021-06-09
267,034779,創意富邦0C購01,0,0,0,0,0,0,0,0,0,485000,0,0,0,810000,325000,485000,485000,2021-06-09
268,085971,玉晶光凱基08購11,0,0,0,0,0,0,0,0,0,484000,0,0,0,494000,10000,484000,484000,2021-06-09
269,087386,精英元大0B購01,0,0,0,0,0,0,0,0,0,483000,0,0,0,483000,0,483000,483000,2021-06-09
270,086817,欣興元富0B購02,0,0,0,0,0,0,0,0,0,482000,0,0,0,651000,169000,482000,482000,2021-06-09
271,033323,友達凱基11購01,0,0,0,0,0,0,0,0,0,482000,0,0,0,539000,57000,482000,482000,2021-06-09
272,086667,道瓊銀國泰0B購01,0,0,0,0,0,0,0,0,0,480000,0,0,0,500000,20000,480000,480000,2021-06-09
273,085514,中興電國泰0A購01,0,0,0,0,0,0,0,0,0,480000,0,0,0,482000,2000,480000,480000,2021-06-09
274,081446,欣興統一09購01,0,0,0,0,0,0,0,0,0,480000,0,0,0,480000,0,480000,480000,2021-06-09
275,087516,鴻海凱基11購01,0,0,0,0,0,0,0,0,0,477000,0,0,0,477000,0,477000,477000,2021-06-09
276,032318,南茂永豐0A購01,0,0,0,0,0,0,0,0,0,476000,0,0,0,476000,0,476000,476000,2021-06-09
277,036086,金像電元大0C購03,0,0,0,0,0,0,0,0,0,476000,0,0,0,639000,163000,476000,476000,2021-06-09
278,034609,創意統一0B購05,0,0,0,0,0,0,0,0,0,475000,0,0,0,582000,107000,475000,475000,2021-06-09
279,2031,新光鋼,2224000,1680000,544000,0,0,0,0,50000,-50000,-20000,0,0,0,15000,35000,-20000,474000,2021-06-09
280,086856,南茂元大0A購01,0,0,0,0,0,0,0,0,0,473000,0,0,0,502000,29000,473000,473000,2021-06-09
281,032916,大亞國票0B購01,0,0,0,0,0,0,0,0,0,473000,0,0,0,473000,0,473000,473000,2021-06-09
282,5471,松翰,988000,966000,22000,0,0,0,137000,0,137000,312337,1337,1000,337,316000,4000,312000,471337,2021-06-09
283,031553,滬深2X群益0A購03,0,0,0,0,0,0,0,0,0,470000,0,0,0,580000,110000,470000,470000,2021-06-09
284,035224,日月光國泰11購02,0,0,0,0,0,0,0,0,0,469000,0,0,0,513000,44000,469000,469000,2021-06-09
285,034528,聯電麥證0B購03,0,0,0,514000,45000,469000,0,0,0,468000,0,0,0,514000,46000,468000,468000,2021-06-09
286,035998,景碩永豐0C購01,0,0,0,0,0,0,0,0,0,466000,0,0,0,871000,405000,466000,466000,2021-06-09
287,035129,中鋼統一0B購05,0,0,0,0,0,0,0,0,0,465000,0,0,0,495000,30000,465000,465000,2021-06-09
288,9910,豐泰,687000,469474,217526,0,0,0,255000,0,255000,-8984,10070,19054,-8984,0,0,0,463542,2021-06-09
289,032930,聯陽國票0B購01,0,0,0,0,0,0,0,0,0,461000,0,0,0,1019000,558000,461000,461000,2021-06-09
290,036089,長榮航元大12購01,0,0,0,0,0,0,0,0,0,461000,0,0,0,749000,288000,461000,461000,2021-06-09
291,081217,順德統一09購02,0,0,0,0,0,0,0,0,0,460000,0,0,0,503000,43000,460000,460000,2021-06-09
292,084496,玉晶光凱基08購07,0,0,0,0,0,0,0,0,0,459000,0,0,0,459000,0,459000,459000,2021-06-09
293,032882,玉晶光凱基0A購04,0,0,0,0,0,0,0,0,0,459000,0,0,0,486000,27000,459000,459000,2021-06-09
294,05876P,臺股指凱基07售18,0,0,0,0,0,0,0,0,0,459000,0,0,0,569000,110000,459000,459000,2021-06-09
295,080163,恆大統一07購01,0,0,0,0,0,0,0,0,0,458000,0,0,0,458000,0,458000,458000,2021-06-09
296,083828,億光凱基0A購01,0,0,0,0,0,0,0,0,0,457000,0,0,0,500000,43000,457000,457000,2021-06-09
297,031272,欣興統一0B購04,0,0,0,0,0,0,0,0,0,457000,0,0,0,458000,1000,457000,457000,2021-06-09
298,2388,威盛,730000,285000,445000,0,0,0,0,0,0,7000,0,0,0,15000,8000,7000,452000,2021-06-09
299,036481,健策元大0C購01,0,0,0,0,0,0,0,0,0,450000,0,0,0,534000,84000,450000,450000,2021-06-09
300,079258,群創元大06購06,0,0,0,0,0,0,0,0,0,450000,0,0,0,450000,0,450000,450000,2021-06-09
301,081571,明基材永豐07購01,0,0,0,0,0,0,0,0,0,450000,0,0,0,450000,0,450000,450000,2021-06-09
302,070261,華通元富08購02,0,0,0,0,0,0,0,0,0,450000,0,0,0,450000,0,450000,450000,2021-06-09
303,034329,台橡群益0B購01,0,0,0,0,0,0,0,0,0,448000,0,0,0,454000,6000,448000,448000,2021-06-09
304,035032,台聚麥證0B購01,0,0,0,466000,20000,446000,0,0,0,446000,0,0,0,466000,20000,446000,446000,2021-06-09
305,032249,東聯元大0C購01,0,0,0,0,0,0,0,0,0,445000,0,0,0,465000,20000,445000,445000,2021-06-09
306,089344,台積電元大09購30,0,0,0,0,0,0,0,0,0,445000,0,0,0,490000,45000,445000,445000,2021-06-09
307,087384,台積電元大11購03,0,0,0,0,0,0,0,0,0,444000,0,0,0,811000,367000,444000,444000,2021-06-09
308,088862,長榮航永豐09購02,0,0,0,0,0,0,0,0,0,444000,0,0,0,454000,10000,444000,444000,2021-06-09
309,033018,長榮航麥證0B購01,0,0,0,702000,258000,444000,0,0,0,444000,0,0,0,702000,258000,444000,444000,2021-06-09
310,084746,健策元大08購04,0,5000,-5000,0,0,0,0,0,0,445000,0,0,0,455000,10000,445000,440000,2021-06-09
311,06833P,聯電凱基0A售09,0,0,0,0,0,0,0,0,0,439000,0,0,0,1110000,671000,439000,439000,2021-06-09
312,033326,玉晶光凱基0B購03,0,0,0,0,0,0,0,0,0,438000,0,0,0,448000,10000,438000,438000,2021-06-09
313,086689,東聯元富09購02,0,0,0,0,0,0,0,0,0,437000,0,0,0,467000,30000,437000,437000,2021-06-09
314,2642,宅配通,249000,2000,247000,0,0,0,0,0,0,190000,100000,0,100000,90000,0,90000,437000,2021-06-09
315,087083,華夏元富09購02,0,0,0,0,0,0,0,0,0,436000,0,0,0,446000,10000,436000,436000,2021-06-09
316,034478,新光鋼元大0C購02,0,0,0,0,0,0,0,0,0,436000,0,0,0,536000,100000,436000,436000,2021-06-09
317,3016,嘉晶,672000,237000,435000,0,0,0,0,0,0,1000,0,0,0,2000,1000,1000,436000,2021-06-09
318,035927,南電元富0C購01,0,0,0,0,0,0,0,0,0,434000,0,0,0,584000,150000,434000,434000,2021-06-09
319,03506B,臺股指元大0B熊15,0,0,0,0,0,0,0,0,0,433000,0,0,0,433000,0,433000,433000,2021-06-09
320,06945P,台灣50群益0A售07,0,0,0,0,0,0,0,0,0,433000,0,0,0,687000,254000,433000,433000,2021-06-09
321,035898,奇鋐國泰12購01,0,0,0,0,0,0,0,0,0,432000,0,0,0,842000,410000,432000,432000,2021-06-09
322,035316,金像電元大0B購03,0,0,0,0,0,0,0,0,0,430000,0,0,0,863000,433000,430000,430000,2021-06-09
323,032082,台聚永豐0A購04,0,0,0,0,0,0,0,0,0,429000,0,0,0,473000,44000,429000,429000,2021-06-09
324,030349,盟立群益0B購01,0,0,0,0,0,0,0,0,0,428000,0,0,0,470000,42000,428000,428000,2021-06-09
325,034186,大成鋼元大0B購10,0,0,0,0,0,0,0,0,0,426000,0,0,0,491000,65000,426000,426000,2021-06-09
326,035516,凌陽永豐0B購02,0,0,0,0,0,0,0,0,0,426000,0,0,0,814000,388000,426000,426000,2021-06-09
327,032617,鈺齊元大0A購02,0,0,0,0,0,0,0,0,0,425000,0,0,0,579000,154000,425000,425000,2021-06-09
328,079244,金像電元大07購03,0,0,0,0,0,0,0,0,0,425000,0,0,0,445000,20000,425000,425000,2021-06-09
329,1312,國喬,5347000,5229000,118000,0,0,0,0,0,0,306274,68000,3000,65000,550274,309000,241274,424274,2021-06-09
330,086269,台勝科永豐09購01,0,0,0,0,0,0,0,0,0,424000,0,0,0,980000,556000,424000,424000,2021-06-09
331,088526,智易國泰0B購01,0,0,0,0,0,0,0,0,0,423000,0,0,0,463000,40000,423000,423000,2021-06-09
332,032405,亞泥元大0B購01,0,0,0,0,0,0,0,0,0,421000,0,0,0,421000,0,421000,421000,2021-06-09
333,5531,鄉林,1322000,901000,421000,0,0,0,0,0,0,0,0,0,0,0,0,0,421000,2021-06-09
334,083837,鈺齊凱基09購01,0,0,0,0,0,0,0,0,0,420000,0,0,0,450000,30000,420000,420000,2021-06-09
335,031497,台揚元大0B購01,0,0,0,0,0,0,0,0,0,420000,0,0,0,420000,0,420000,420000,2021-06-09
336,033651,大成鋼統一15購01,0,0,0,0,0,0,0,0,0,420000,0,0,0,508000,88000,420000,420000,2021-06-09
337,034259,聯詠統一12購01,0,0,0,0,0,0,0,0,0,420000,0,0,0,470000,50000,420000,420000,2021-06-09
338,3588,通嘉,1184000,787000,397000,0,0,0,22000,0,22000,0,0,0,0,0,0,0,419000,2021-06-09
339,031134,力成統一0C購02,0,0,0,0,0,0,0,0,0,417000,0,0,0,432000,15000,417000,417000,2021-06-09
340,034825,群創富邦12購01,0,0,0,0,0,0,0,0,0,417000,0,0,0,502000,85000,417000,417000,2021-06-09
341,030942,申豐群益0A購01,0,0,0,0,0,0,0,0,0,416000,0,0,0,606000,190000,416000,416000,2021-06-09
342,05677P,臺股指中信0C售03,0,0,0,0,0,0,0,0,0,416000,0,0,0,929000,513000,416000,416000,2021-06-09
343,036350,正隆國票11購01,0,0,0,0,0,0,0,0,0,416000,0,0,0,516000,100000,416000,416000,2021-06-09
344,087391,金像電元大0B購01,0,0,0,0,0,0,0,0,0,415000,0,0,0,1163000,748000,415000,415000,2021-06-09
345,031717,百和永豐0A購01,0,0,0,0,0,0,0,0,0,414000,0,0,0,414000,0,414000,414000,2021-06-09
346,034633,中鋼元大0B購08,0,0,0,0,0,0,0,0,0,414000,0,0,0,695000,281000,414000,414000,2021-06-09
347,06860P,臺股指凱基11售06,0,0,0,0,0,0,0,0,0,414000,0,0,0,871000,457000,414000,414000,2021-06-09
348,034973,晶碩元大0C購02,0,0,0,0,0,0,0,0,0,413000,0,0,0,570000,157000,413000,413000,2021-06-09
349,082295,兆豐金元大07購01,0,0,0,0,0,0,0,0,0,412000,0,0,0,412000,0,412000,412000,2021-06-09
350,089566,美食統一0B購02,0,0,0,0,0,0,0,0,0,412000,0,0,0,440000,28000,412000,412000,2021-06-09
351,084503,滬深2X元大08購07,0,0,0,0,0,0,0,0,0,411000,0,0,0,411000,0,411000,411000,2021-06-09
352,036299,奇鋐元大0C購01,0,0,0,0,0,0,0,0,0,411000,0,0,0,515000,104000,411000,411000,2021-06-09
353,085370,聯電群益09購02,0,0,0,0,0,0,0,0,0,409000,0,0,0,410000,1000,409000,409000,2021-06-09
354,034527,奇鋐康和0B購01,0,0,0,0,0,0,0,0,0,407000,0,0,0,669000,262000,407000,407000,2021-06-09
355,036213,燁輝國泰12購01,0,0,0,0,0,0,0,0,0,406000,0,0,0,406000,0,406000,406000,2021-06-09
356,088250,南茂國票0A購02,0,0,0,0,0,0,0,0,0,404000,0,0,0,525000,121000,404000,404000,2021-06-09
357,032791,群創元大0A購18,0,0,0,0,0,0,0,0,0,404000,0,0,0,404000,0,404000,404000,2021-06-09
358,00852L,國泰美國道瓊正2,104000,6000,98000,0,0,0,0,0,0,305000,0,0,0,523000,218000,305000,403000,2021-06-09
359,032646,矽創統一11購01,0,0,0,0,0,0,0,0,0,402000,0,0,0,402000,0,402000,402000,2021-06-09
360,030861,矽統永豐0A購01,0,0,0,0,0,0,0,0,0,402000,0,0,0,601000,199000,402000,402000,2021-06-09
361,05946P,臺股指凱基07售24,0,0,0,0,0,0,0,0,0,402000,0,0,0,402000,0,402000,402000,2021-06-09
362,04354P,聯發科元富0A售03,0,0,0,0,0,0,0,0,0,401000,0,0,0,450000,49000,401000,401000,2021-06-09
363,084931,圓剛元大08購03,0,0,0,0,0,0,0,0,0,400000,0,0,0,400000,0,400000,400000,2021-06-09
364,031289,聯陽元富0C購02,0,0,0,0,0,0,0,0,0,400000,0,0,0,1046000,646000,400000,400000,2021-06-09
365,033166,聯電兆豐11購01,0,0,0,0,0,0,0,0,0,400000,0,0,0,400000,0,400000,400000,2021-06-09
366,031842,義隆兆豐0B購01,0,0,0,0,0,0,0,0,0,400000,0,0,0,551000,151000,400000,400000,2021-06-09
367,034230,聯詠康和0B購01,0,0,0,0,0,0,0,0,0,400000,0,0,0,450000,50000,400000,400000,2021-06-09
368,083090,精英元大07購03,0,0,0,0,0,0,0,0,0,399000,0,0,0,399000,0,399000,399000,2021-06-09
369,06513P,T50正2群益0B售01,0,0,0,0,0,0,0,0,0,399000,0,0,0,399000,0,399000,399000,2021-06-09
370,088188,鴻海群益0A購04,0,0,0,0,0,0,0,0,0,398000,0,0,0,398000,0,398000,398000,2021-06-09
371,031751,玉晶光凱基14購01,0,0,0,0,0,0,0,0,0,398000,0,0,0,411000,13000,398000,398000,2021-06-09
372,034992,新唐群益11購01,0,0,0,0,0,0,0,0,0,398000,0,0,0,400000,2000,398000,398000,2021-06-09
373,032855,光罩群益0A購03,0,0,0,0,0,0,0,0,0,397000,0,0,0,580000,183000,397000,397000,2021-06-09
374,033253,奇鋐元大11購01,0,0,0,0,0,0,0,0,0,396000,0,0,0,807000,411000,396000,396000,2021-06-09
375,04355P,聯發科元富0A售04,0,0,0,0,0,0,0,0,0,395000,0,0,0,400000,5000,395000,395000,2021-06-09
376,033743,鴻海富邦13購02,0,0,0,0,0,0,0,0,0,394000,0,0,0,707000,313000,394000,394000,2021-06-09
377,034511,晶碩凱基0B購01,0,0,0,0,0,0,0,0,0,392000,0,0,0,392000,0,392000,392000,2021-06-09
378,035793,台船永豐0B購01,0,0,0,0,0,0,0,0,0,392000,0,0,0,392000,0,392000,392000,2021-06-09
379,088791,華通群益0B購01,0,0,0,0,0,0,0,0,0,389000,0,0,0,399000,10000,389000,389000,2021-06-09
380,034447,聯發科國泰11購03,0,0,0,0,0,0,0,0,0,389000,0,0,0,449000,60000,389000,389000,2021-06-09
381,088455,聯陽統一0B購02,0,0,0,0,0,0,0,0,0,388000,0,0,0,498000,110000,388000,388000,2021-06-09
382,086723,南茂元大09購01,0,0,0,0,0,0,0,0,0,387000,0,0,0,441000,54000,387000,387000,2021-06-09
383,032059,景碩國票0B購02,0,0,0,0,0,0,0,0,0,383000,0,0,0,646000,263000,383000,383000,2021-06-09
384,1308,亞聚,2990000,2595000,395000,0,0,0,0,0,0,-13284,3001,16285,-13284,13000,13000,0,381716,2021-06-09
385,030012,聯發科元富11購07,0,0,0,0,0,0,0,0,0,381000,0,0,0,381000,0,381000,381000,2021-06-09
386,080184,世芯統一07購02,0,0,0,0,0,0,0,0,0,381000,0,0,0,530000,149000,381000,381000,2021-06-09
387,035451,金像電國票0C購01,0,0,0,0,0,0,0,0,0,380000,0,0,0,606000,226000,380000,380000,2021-06-09
388,036404,康控永豐0C購02,0,0,0,0,0,0,0,0,0,380000,0,0,0,640000,260000,380000,380000,2021-06-09
389,06400P,健策元大08售06,0,0,0,0,0,0,0,0,0,378000,0,0,0,378000,0,378000,378000,2021-06-09
390,006208,富邦台50,30157,80000,-49843,0,0,0,0,0,0,427606,0,0,0,962000,534394,427606,377763,2021-06-09
391,032124,華榮凱基0A購02,0,0,0,0,0,0,0,0,0,376000,0,0,0,427000,51000,376000,376000,2021-06-09
392,033700,亞聚國票0C購01,0,0,0,0,0,0,0,0,0,376000,0,0,0,386000,10000,376000,376000,2021-06-09
393,031307,億光富邦0C購01,0,0,0,0,0,0,0,0,0,375000,0,0,0,413000,38000,375000,375000,2021-06-09
394,06120P,台灣50元大0A售01,0,0,0,0,0,0,0,0,0,375000,0,0,0,411000,36000,375000,375000,2021-06-09
395,035062,矽創國泰11購01,0,0,0,0,0,0,0,0,0,375000,0,0,0,789000,414000,375000,375000,2021-06-09
396,3673,TPK-KY,724000,368000,356000,0,0,0,0,0,0,18967,500,355,145,54000,35178,18822,374967,2021-06-09
397,034483,聯發科元大0B購04,0,0,0,0,0,0,0,0,0,373000,0,0,0,449000,76000,373000,373000,2021-06-09
398,034657,長榮永豐0B購02,0,0,0,0,0,0,0,0,0,372000,0,0,0,372000,0,372000,372000,2021-06-09
399,034773,大成鋼富邦0C購04,0,0,0,0,0,0,0,0,0,371000,0,0,0,390000,19000,371000,371000,2021-06-09
400,035726,健策元大12購01,0,0,0,0,0,0,0,0,0,371000,0,0,0,591000,220000,371000,371000,2021-06-09
401,082986,奇鋐元大07購02,0,0,0,0,0,0,0,0,0,371000,0,0,0,381000,10000,371000,371000,2021-06-09
402,031009,致茂永豐0A購02,0,0,0,0,0,0,0,0,0,370000,0,0,0,370000,0,370000,370000,2021-06-09
403,034634,金像電元大0B購02,0,0,0,0,0,0,0,0,0,370000,0,0,0,642000,272000,370000,370000,2021-06-09
404,034468,中石化元大12購01,0,0,0,0,0,0,0,0,0,370000,0,0,0,400000,30000,370000,370000,2021-06-09
405,088402,台揚永豐09購01,0,0,0,0,0,0,0,0,0,369000,0,0,0,369000,0,369000,369000,2021-06-09
406,035494,金像電國泰12購01,0,0,0,0,0,0,0,0,0,369000,0,0,0,1495000,1126000,369000,369000,2021-06-09
407,070170,台新金中信06購01,0,0,0,0,0,0,0,0,0,369000,0,0,0,369000,0,369000,369000,2021-06-09
408,083784,聯發科中信0A購04,0,0,0,0,0,0,0,0,0,368000,0,0,0,3288000,2920000,368000,368000,2021-06-09
409,033898,允強統一0B購01,0,0,0,0,0,0,0,0,0,367000,0,0,0,392000,25000,367000,367000,2021-06-09
410,8261,富鼎,1727000,1361000,366000,0,0,0,0,0,0,1000,1000,0,1000,0,0,0,367000,2021-06-09
411,088832,南茂元大0C購01,0,0,0,0,0,0,0,0,0,366000,0,0,0,422000,56000,366000,366000,2021-06-09
412,3596,智易,437000,132000,305000,0,0,0,110000,0,110000,-50000,4000,19000,-15000,0,35000,-35000,365000,2021-06-09
413,088223,金像電元富11購01,0,0,0,0,0,0,0,0,0,361000,0,0,0,1692000,1331000,361000,361000,2021-06-09
414,073297,大立光中信06購01,0,0,0,0,0,0,0,0,0,361000,0,0,0,361000,0,361000,361000,2021-06-09
415,034213,台玻元富0C購01,0,0,0,0,0,0,0,0,0,355000,0,0,0,475000,120000,355000,355000,2021-06-09
416,034068,華新科富邦13購01,0,0,0,0,0,0,0,0,0,355000,0,0,0,385000,30000,355000,355000,2021-06-09
417,085018,奇鋐元大08購04,0,0,0,0,0,0,0,0,0,354000,0,0,0,498000,144000,354000,354000,2021-06-09
418,078847,亞德客統一08購01,0,0,0,0,0,0,0,0,0,354000,0,0,0,354000,0,354000,354000,2021-06-09
419,088892,群創凱基0C購03,0,0,0,0,0,0,0,0,0,352000,0,0,0,582000,230000,352000,352000,2021-06-09
420,031004,中石化永豐0A購01,0,0,0,0,0,0,0,0,0,351000,0,0,0,416000,65000,351000,351000,2021-06-09
421,034461,欣興群益11購01,0,0,0,0,0,0,0,0,0,351000,0,0,0,358000,7000,351000,351000,2021-06-09
422,087799,國喬麥證09購01,0,0,0,407000,57000,350000,0,0,0,350000,0,0,0,407000,57000,350000,350000,2021-06-09
423,086584,台化國票0A購01,0,0,0,0,0,0,0,0,0,350000,0,0,0,350000,0,350000,350000,2021-06-09
424,030244,致茂永豐0A購01,0,0,0,0,0,0,0,0,0,350000,0,0,0,370000,20000,350000,350000,2021-06-09
425,081903,英利凱基08購01,0,0,0,0,0,0,0,0,0,350000,0,0,0,370000,20000,350000,350000,2021-06-09
426,085280,國巨凱基08購11,0,0,0,0,0,0,0,0,0,349000,0,0,0,352000,3000,349000,349000,2021-06-09
427,088332,可成元大09購03,0,0,0,0,0,0,0,0,0,348000,0,0,0,398000,50000,348000,348000,2021-06-09
428,033289,欣興統一13購01,0,0,0,0,0,0,0,0,0,347000,0,0,0,2111000,1764000,347000,347000,2021-06-09
429,9911,櫻花,444000,199000,245000,0,0,0,50000,0,50000,50000,50000,0,50000,0,0,0,345000,2021-06-09
430,084370,南電康和07購02,0,0,0,0,0,0,0,0,0,344000,0,0,0,364000,20000,344000,344000,2021-06-09
431,06289P,臺股指國票08售09,0,0,0,0,0,0,0,0,0,342000,0,0,0,354000,12000,342000,342000,2021-06-09
432,083603,台達電中信09購01,0,0,0,0,0,0,0,0,0,341000,0,0,0,341000,0,341000,341000,2021-06-09
433,081868,台達電麥證07購01,0,0,0,340000,0,340000,0,0,0,340000,0,0,0,340000,0,340000,340000,2021-06-09
434,080932,玉晶光國票0A購05,0,0,0,0,0,0,0,0,0,340000,0,0,0,340000,0,340000,340000,2021-06-09
435,079018,和大元大08購01,0,0,0,0,0,0,0,0,0,340000,0,0,0,340000,0,340000,340000,2021-06-09
436,083744,奇鋐國票08購02,0,0,0,0,0,0,0,0,0,339000,0,0,0,389000,50000,339000,339000,2021-06-09
437,078331,亞德客凱基07購01,0,0,0,0,0,0,0,0,0,338000,0,0,0,338000,0,338000,338000,2021-06-09
438,034403,中鋼國票0C購03,0,0,0,0,0,0,0,0,0,336000,0,0,0,336000,0,336000,336000,2021-06-09
439,035157,中鋼國票0C購05,0,0,0,0,0,0,0,0,0,336000,0,0,0,406000,70000,336000,336000,2021-06-09
440,088080,日月光統一13購01,0,0,0,0,0,0,0,0,0,334000,0,0,0,420000,86000,334000,334000,2021-06-09
441,06908P,T50正2群益0A售02,2000,0,2000,0,0,0,0,0,0,330000,0,0,0,403000,73000,330000,332000,2021-06-09
442,4927,泰鼎-KY,490000,158000,332000,0,0,0,0,0,0,0,0,0,0,0,0,0,332000,2021-06-09
443,05808P,T50正2國票08售07,0,0,0,0,0,0,0,0,0,331000,0,0,0,381000,50000,331000,331000,2021-06-09
444,036142,金像電富邦11購01,0,0,0,0,0,0,0,0,0,331000,0,0,0,478000,147000,331000,331000,2021-06-09
445,088183,滬深2X群益09購08,0,0,0,0,0,0,0,0,0,330000,0,0,0,727000,397000,330000,330000,2021-06-09
446,087570,大立光國泰11購01,0,0,0,0,0,0,0,0,0,330000,0,0,0,500000,170000,330000,330000,2021-06-09
447,085028,玉晶光統一0A購03,0,0,0,0,0,0,0,0,0,330000,0,0,0,330000,0,330000,330000,2021-06-09
448,035061,中信金國泰11購02,0,0,0,0,0,0,0,0,0,330000,0,0,0,330000,0,330000,330000,2021-06-09
449,00655L,國泰中國A50正2,23000,54000,-31000,0,0,0,0,0,0,360000,0,0,0,968000,608000,360000,329000,2021-06-09
450,032456,鈺齊元大0B購01,0,0,0,0,0,0,0,0,0,328000,0,0,0,328000,0,328000,328000,2021-06-09
451,032631,台達電統一0B購02,0,0,0,0,0,0,0,0,0,328000,0,0,0,328000,0,328000,328000,2021-06-09
452,034605,裕民統一0B購03,0,0,0,0,0,0,0,0,0,324000,0,0,0,955000,631000,324000,324000,2021-06-09
453,081951,強茂統一09購02,0,0,0,0,0,0,0,0,0,324000,0,0,0,610000,286000,324000,324000,2021-06-09
454,035723,群創元大0B購20,0,0,0,0,0,0,0,0,0,323000,0,0,0,343000,20000,323000,323000,2021-06-09
455,033562,燁輝永豐0B購02,0,0,0,0,0,0,0,0,0,322000,0,0,0,389000,67000,322000,322000,2021-06-09
456,032858,矽統群益0B購03,0,0,0,0,0,0,0,0,0,322000,0,0,0,520000,198000,322000,322000,2021-06-09
457,00635U,期元大S&P黃金,40000,7000,33000,0,0,0,0,0,0,289000,0,0,0,296000,7000,289000,322000,2021-06-09
458,085815,旺宏群益09購03,0,0,0,0,0,0,0,0,0,321000,0,0,0,350000,29000,321000,321000,2021-06-09
459,035851,新光鋼統一0B購03,0,0,0,0,0,0,0,0,0,321000,0,0,0,336000,15000,321000,321000,2021-06-09
460,080424,國巨富邦08購03,0,0,0,0,0,0,0,0,0,320000,0,0,0,718000,398000,320000,320000,2021-06-09
461,084412,精英國泰09購01,0,0,0,0,0,0,0,0,0,318000,0,0,0,338000,20000,318000,318000,2021-06-09
462,084294,可成群益09購03,0,0,0,0,0,0,0,0,0,318000,0,0,0,318000,0,318000,318000,2021-06-09
463,033617,奇鋐群益0B購01,0,0,0,0,0,0,0,0,0,317000,0,0,0,484000,167000,317000,317000,2021-06-09
464,079621,榮成永豐06購02,0,0,0,0,0,0,0,0,0,316000,0,0,0,316000,0,316000,316000,2021-06-09
465,06096P,臺股指日盛09售03,0,0,0,0,0,0,0,0,0,315000,0,0,0,315000,0,315000,315000,2021-06-09
466,07091P,中鋼元大0B售09,0,0,0,0,0,0,0,0,0,314000,0,0,0,401000,87000,314000,314000,2021-06-09
467,05361P,長榮國票07售06,0,0,0,0,0,0,0,0,0,313000,0,0,0,313000,0,313000,313000,2021-06-09
468,033284,長榮統一12購03,0,0,0,0,0,0,0,0,0,312000,0,0,0,638000,326000,312000,312000,2021-06-09
469,1325,恆大,405000,101000,304000,0,0,0,0,0,0,7000,0,0,0,9000,2000,7000,311000,2021-06-09
470,035435,欣興元大0B購04,0,0,0,0,0,0,0,0,0,310000,0,0,0,320000,10000,310000,310000,2021-06-09
471,035555,欣興統一0B購06,0,0,0,0,0,0,0,0,0,310000,0,0,0,1233000,923000,310000,310000,2021-06-09
472,084563,國巨國票08購10,0,0,0,0,0,0,0,0,0,309000,0,0,0,409000,100000,309000,309000,2021-06-09
473,084697,宏碁統一0A購02,0,0,0,0,0,0,0,0,0,309000,0,0,0,360000,51000,309000,309000,2021-06-09
474,089013,聯陽元大09購03,0,0,0,0,0,0,0,0,0,309000,0,0,0,390000,81000,309000,309000,2021-06-09
475,033212,欣興群益0C購01,0,0,0,0,0,0,0,0,0,309000,0,0,0,323000,14000,309000,309000,2021-06-09
476,035346,群創元富0B購09,0,0,0,0,0,0,0,0,0,309000,0,0,0,310000,1000,309000,309000,2021-06-09
477,084076,鴻海元大07購31,0,0,0,0,0,0,0,0,0,306000,0,0,0,306000,0,306000,306000,2021-06-09
478,030741,強茂元大0C購01,0,0,0,0,0,0,0,0,0,306000,0,0,0,307000,1000,306000,306000,2021-06-09
479,031546,和桐中信0A購01,0,1000,-1000,0,0,0,0,0,0,307000,0,0,0,339000,32000,307000,306000,2021-06-09
480,00708L,期元大S&P黃金正2,79000,0,79000,0,0,0,0,0,0,226000,0,0,0,319000,93000,226000,305000,2021-06-09
481,034667,中鋼凱基0B購05,0,0,0,0,0,0,0,0,0,305000,0,0,0,420000,115000,305000,305000,2021-06-09
482,083562,聯電群益0A購01,0,0,0,0,0,0,0,0,0,304000,0,0,0,470000,166000,304000,304000,2021-06-09
483,032037,聯成國票0B購01,0,0,0,0,0,0,0,0,0,303000,0,0,0,348000,45000,303000,303000,2021-06-09
484,078589,強茂元大07購02,0,0,0,0,0,0,0,0,0,303000,0,0,0,303000,0,303000,303000,2021-06-09
485,035653,大亞國泰12購01,0,2000,-2000,0,0,0,0,0,0,304000,0,0,0,314000,10000,304000,302000,2021-06-09
486,2547,日勝生,555000,254000,301000,0,0,0,0,0,0,0,0,0,0,0,0,0,301000,2021-06-09
487,086352,緯創元大09購01,0,0,0,0,0,0,0,0,0,300000,0,0,0,300000,0,300000,300000,2021-06-09
488,031290,群創元富0A購10,0,0,0,0,0,0,0,0,0,300000,0,0,0,300000,0,300000,300000,2021-06-09
489,031179,台橡永豐0A購01,0,0,0,0,0,0,0,0,0,300000,0,0,0,363000,63000,300000,300000,2021-06-09
490,080654,潤泰全元大09購01,0,0,0,0,0,0,0,0,0,300000,0,0,0,300000,0,300000,300000,2021-06-09
491,081775,祥碩元大09購01,0,0,0,0,0,0,0,0,0,300000,0,0,0,300000,0,300000,300000,2021-06-09
492,6669,緯穎,497873,215100,282773,0,0,0,0,0,0,17000,0,2000,-2000,20000,1000,19000,299773,2021-06-09
493,084065,A50正2元大07購03,0,0,0,0,0,0,0,0,0,299000,0,0,0,299000,0,299000,299000,2021-06-09
494,032240,華夏元大0C購01,0,0,0,0,0,0,0,0,0,299000,0,0,0,299000,0,299000,299000,2021-06-09
495,077645,京鼎國票07購01,0,0,0,0,0,0,0,0,0,299000,0,0,0,299000,0,299000,299000,2021-06-09
496,077248,旺宏元大06購02,0,0,0,0,0,0,0,0,0,299000,0,0,0,299000,0,299000,299000,2021-06-09
497,030370,國光生群益0A購01,0,0,0,0,0,0,0,0,0,298000,0,0,0,520000,222000,298000,298000,2021-06-09
498,00639,富邦深100,326000,17000,309000,0,0,0,0,0,0,-12000,0,0,0,390000,402000,-12000,297000,2021-06-09
499,089965,台積電元大0A購03,0,0,0,0,0,0,0,0,0,297000,0,0,0,458000,161000,297000,297000,2021-06-09
500,084476,精英凱基09購02,0,0,0,0,0,0,0,0,0,296000,0,0,0,296000,0,296000,296000,2021-06-09
501,030937,群創群益0B購07,1000,0,1000,0,0,0,0,0,0,295000,0,0,0,408000,113000,295000,296000,2021-06-09
502,035331,台表科元大0B購02,0,0,0,0,0,0,0,0,0,296000,0,0,0,386000,90000,296000,296000,2021-06-09
503,085377,晶技群益08購03,0,0,0,0,0,0,0,0,0,295000,0,0,0,310000,15000,295000,295000,2021-06-09
504,031930,正隆元富0A購01,0,0,0,0,0,0,0,0,0,295000,0,0,0,334000,39000,295000,295000,2021-06-09
505,07137P,京元電凱基0B售02,0,0,0,0,0,0,0,0,0,295000,0,0,0,507000,212000,295000,295000,2021-06-09
506,033880,燁輝元富0B購01,0,0,0,0,0,0,0,0,0,294000,0,0,0,294000,0,294000,294000,2021-06-09
507,079023,聯電元大08購03,0,0,0,0,0,0,0,0,0,294000,0,0,0,463000,169000,294000,294000,2021-06-09
508,2608,嘉里大榮,1143000,849000,294000,0,0,0,0,0,0,-105,0,105,-105,0,0,0,293895,2021-06-09
509,089071,強茂凱基09購01,0,0,0,0,0,0,0,0,0,293000,0,0,0,306000,13000,293000,293000,2021-06-09
510,06097P,台灣50凱基07售16,0,0,0,0,0,0,0,0,0,293000,0,0,0,509000,216000,293000,293000,2021-06-09
511,033149,炎洲元大0B購01,0,0,0,0,0,0,0,0,0,291000,0,0,0,459000,168000,291000,291000,2021-06-09
512,032457,巨大元大0A購02,0,0,0,0,0,0,0,0,0,290000,0,0,0,290000,0,290000,290000,2021-06-09
513,033643,華新統一0B購02,0,0,0,0,0,0,0,0,0,290000,0,0,0,290000,0,290000,290000,2021-06-09
514,087779,南亞永豐09購01,0,0,0,0,0,0,0,0,0,289000,0,0,0,340000,51000,289000,289000,2021-06-09
515,087879,台積電元大09購23,0,0,0,0,0,0,0,0,0,289000,0,0,0,701000,412000,289000,289000,2021-06-09
516,030990,申豐元大0B購01,0,0,0,0,0,0,0,0,0,289000,0,0,0,289000,0,289000,289000,2021-06-09
517,034568,群創國泰11購02,0,0,0,0,0,0,0,0,0,289000,0,0,0,445000,156000,289000,289000,2021-06-09
518,083286,億光元大07購04,0,0,0,0,0,0,0,0,0,289000,0,0,0,289000,0,289000,289000,2021-06-09
519,079323,智伸科兆豐07購01,0,0,0,0,0,0,0,0,0,289000,0,0,0,299000,10000,289000,289000,2021-06-09
520,084868,可成元大08購02,0,0,0,0,0,0,0,0,0,287000,0,0,0,287000,0,287000,287000,2021-06-09
521,030425,健鼎元大0B購01,0,0,0,0,0,0,0,0,0,287000,0,0,0,287000,0,287000,287000,2021-06-09
522,035742,晶碩國票0C購02,0,0,0,0,0,0,0,0,0,287000,0,0,0,355000,68000,287000,287000,2021-06-09
523,034086,金像電元大11購01,0,1000,-1000,0,0,0,0,0,0,287000,0,0,0,646000,359000,287000,286000,2021-06-09
524,076244,健策中信07購01,0,0,0,0,0,0,0,0,0,285000,0,0,0,285000,0,285000,285000,2021-06-09
525,06707P,臺股指元大09售16,0,0,0,0,0,0,0,0,0,285000,0,0,0,410000,125000,285000,285000,2021-06-09
526,085424,乙盛元大08購03,0,0,0,0,0,0,0,0,0,284000,0,0,0,304000,20000,284000,284000,2021-06-09
527,05234P,T50正2中信0C售01,0,0,0,0,0,0,0,0,0,284000,0,0,0,285000,1000,284000,284000,2021-06-09
528,083135,聯發科凱基08購10,0,0,0,0,0,0,0,0,0,284000,0,0,0,624000,340000,284000,284000,2021-06-09
529,089535,訊芯元大09購03,0,0,0,0,0,0,0,0,0,284000,0,0,0,284000,0,284000,284000,2021-06-09
530,035987,東森國票11購01,0,0,0,0,0,0,0,0,0,283000,0,0,0,286000,3000,283000,283000,2021-06-09
531,06316P,臺股指群益08售12,0,0,0,0,0,0,0,0,0,283000,0,0,0,298000,15000,283000,283000,2021-06-09
532,9914,美利達,629000,354928,274072,0,0,0,12000,1000,11000,-3000,0,2000,-2000,0,1000,-1000,282072,2021-06-09
533,086971,日月光統一0B購03,0,0,0,0,0,0,0,0,0,282000,0,0,0,298000,16000,282000,282000,2021-06-09
534,080074,精英元大07購01,0,0,0,0,0,0,0,0,0,282000,0,0,0,282000,0,282000,282000,2021-06-09
535,081315,群創元大07購07,0,0,0,0,0,0,0,0,0,281000,0,0,0,281000,0,281000,281000,2021-06-09
536,072129,茂林元富09購01,0,0,0,0,0,0,0,0,0,281000,0,0,0,290000,9000,281000,281000,2021-06-09
537,085034,T50反1元富12購01,0,0,0,0,0,0,0,0,0,280000,0,0,0,300000,20000,280000,280000,2021-06-09
538,032798,南茂元大11購01,0,0,0,0,0,0,0,0,0,280000,0,0,0,446000,166000,280000,280000,2021-06-09
539,034164,友達永豐0B購03,0,0,0,0,0,0,0,0,0,280000,0,0,0,280000,0,280000,280000,2021-06-09
540,075618,國巨富邦07購01,0,0,0,0,0,0,0,0,0,280000,0,0,0,280000,0,280000,280000,2021-06-09
541,034660,國光生永豐0B購01,0,0,0,0,0,0,0,0,0,279000,0,0,0,335000,56000,279000,279000,2021-06-09
542,030033,滬深2X元大0B購02,0,0,0,0,0,0,0,0,0,278000,0,0,0,298000,20000,278000,278000,2021-06-09
543,032590,中環元大0A購01,0,90000,-90000,0,0,0,0,0,0,368000,0,0,0,368000,0,368000,278000,2021-06-09
544,035517,超豐永豐0B購01,0,0,0,0,0,0,0,0,0,278000,0,0,0,377000,99000,278000,278000,2021-06-09
545,035603,奇鋐元大0B購02,0,0,0,0,0,0,0,0,0,277000,0,0,0,457000,180000,277000,277000,2021-06-09
546,03510B,臺股指元大0B熊31,0,0,0,0,0,0,0,0,0,277000,0,0,0,298000,21000,277000,277000,2021-06-09
547,032368,群創凱基0A購06,0,0,0,0,0,0,0,0,0,275000,0,0,0,315000,40000,275000,275000,2021-06-09
548,032354,中鋼凱基12購03,0,0,0,0,0,0,0,0,0,275000,0,0,0,309000,34000,275000,275000,2021-06-09
549,030153,義隆富邦0B購01,0,0,0,0,0,0,0,0,0,275000,0,0,0,366000,91000,275000,275000,2021-06-09
550,033251,聯陽元大11購01,0,0,0,0,0,0,0,0,0,274000,0,0,0,1481000,1207000,274000,274000,2021-06-09
551,080986,永光永豐07購01,0,0,0,0,0,0,0,0,0,274000,0,0,0,274000,0,274000,274000,2021-06-09
552,8163,達方,645000,375000,270000,0,0,0,0,0,0,3000,0,0,0,5000,2000,3000,273000,2021-06-09
553,2025,千興,273000,0,273000,0,0,0,0,0,0,0,0,0,0,0,0,0,273000,2021-06-09
554,033378,正隆元大11購01,0,10000,-10000,0,0,0,0,0,0,282000,0,0,0,378000,96000,282000,272000,2021-06-09
555,085091,國巨凱基08購10,0,0,0,0,0,0,0,0,0,271000,0,0,0,271000,0,271000,271000,2021-06-09
556,033178,欣興永豐0B購01,0,0,0,0,0,0,0,0,0,271000,0,0,0,355000,84000,271000,271000,2021-06-09
557,081799,中化凱基07購01,0,0,0,0,0,0,0,0,0,270000,0,0,0,270000,0,270000,270000,2021-06-09
558,088471,聯陽元富0C購01,0,0,0,0,0,0,0,0,0,269000,0,0,0,269000,0,269000,269000,2021-06-09
559,088259,中興電兆豐0A購01,0,0,0,0,0,0,0,0,0,267000,0,0,0,297000,30000,267000,267000,2021-06-09
560,086441,金像電永豐09購01,0,0,0,0,0,0,0,0,0,267000,0,0,0,280000,13000,267000,267000,2021-06-09
561,033071,長榮凱基0C購02,0,0,0,0,0,0,0,0,0,266000,0,0,0,266000,0,266000,266000,2021-06-09
562,035850,燁輝統一0B購04,0,0,0,0,0,0,0,0,0,266000,0,0,0,266000,0,266000,266000,2021-06-09
563,084690,鴻海統一0A購12,0,0,0,0,0,0,0,0,0,265000,0,0,0,300000,35000,265000,265000,2021-06-09
564,035910,中鋼永豐0C購01,0,0,0,0,0,0,0,0,0,265000,0,0,0,265000,0,265000,265000,2021-06-09
565,034685,中鋼群益0B購13,0,0,0,0,0,0,0,0,0,265000,0,0,0,394000,129000,265000,265000,2021-06-09
566,083018,奇鋐凱基0A購01,0,0,0,0,0,0,0,0,0,265000,0,0,0,365000,100000,265000,265000,2021-06-09
567,083852,奇鋐群益08購03,0,0,0,0,0,0,0,0,0,264000,0,0,0,434000,170000,264000,264000,2021-06-09
568,032738,正新凱基0A購01,0,0,0,0,0,0,0,0,0,264000,0,0,0,274000,10000,264000,264000,2021-06-09
569,036146,大成鋼元大0C購06,0,0,0,0,0,0,0,0,0,264000,0,0,0,264000,0,264000,264000,2021-06-09
570,074465,智易元富08購02,0,0,0,0,0,0,0,0,0,264000,0,0,0,264000,0,264000,264000,2021-06-09
571,2029,盛餘,1105000,841000,264000,0,0,0,0,0,0,0,0,0,0,0,0,0,264000,2021-06-09
572,084737,台光電元大08購01,0,0,0,0,0,0,0,0,0,263000,0,0,0,722000,459000,263000,263000,2021-06-09
573,032983,國喬元富0B購02,0,0,0,0,0,0,0,0,0,261000,0,0,0,451000,190000,261000,261000,2021-06-09
574,034810,台灣50群益0B購03,0,0,0,0,0,0,0,0,0,261000,0,0,0,688000,427000,261000,261000,2021-06-09
575,4952,凌通,369000,108000,261000,0,0,0,0,0,0,0,0,0,0,0,0,0,261000,2021-06-09
576,035895,允強國泰12購01,0,0,0,0,0,0,0,0,0,259000,0,0,0,263000,4000,259000,259000,2021-06-09
577,035206,矽創元富0C購05,0,0,0,0,0,0,0,0,0,259000,0,0,0,443000,184000,259000,259000,2021-06-09
578,034947,中鋼凱基11購02,0,0,0,0,0,0,0,0,0,259000,0,0,0,259000,0,259000,259000,2021-06-09
579,031010,億光永豐0A購01,0,0,0,0,0,0,0,0,0,258000,0,0,0,258000,0,258000,258000,2021-06-09
580,034215,大成鋼元富12購02,0,0,0,0,0,0,0,0,0,258000,0,0,0,1060000,802000,258000,258000,2021-06-09
581,035421,新光鋼元大0C購03,0,0,0,0,0,0,0,0,0,258000,0,0,0,271000,13000,258000,258000,2021-06-09
582,088849,台苯永豐09購01,0,0,0,0,0,0,0,0,0,257000,0,0,0,300000,43000,257000,257000,2021-06-09
583,05321P,嘉晶群益07售02,0,0,0,0,0,0,0,0,0,257000,0,0,0,310000,53000,257000,257000,2021-06-09
584,085238,和碩元大09購01,0,0,0,0,0,0,0,0,0,256000,0,0,0,256000,0,256000,256000,2021-06-09
585,034041,友訊元富0B購01,0,0,0,0,0,0,0,0,0,256000,0,0,0,256000,0,256000,256000,2021-06-09
586,079105,聯電凱基06購09,0,0,0,0,0,0,0,0,0,255000,0,0,0,255000,0,255000,255000,2021-06-09
587,032256,長榮元大0A購21,0,0,0,0,0,0,0,0,0,253000,0,0,0,253000,0,253000,253000,2021-06-09
588,034081,台橡元大11購01,0,0,0,0,0,0,0,0,0,253000,0,0,0,353000,100000,253000,253000,2021-06-09
589,034262,大成鋼國票0C購02,0,0,0,0,0,0,0,0,0,253000,0,0,0,256000,3000,253000,253000,2021-06-09
590,035191,金像電元富12購01,0,0,0,0,0,0,0,0,0,252000,0,0,0,319000,67000,252000,252000,2021-06-09
591,079970,金像電群益07購01,0,0,0,0,0,0,0,0,0,252000,0,0,0,431000,179000,252000,252000,2021-06-09
592,05853P,華邦電凱基07售06,0,0,0,0,0,0,0,0,0,251000,0,0,0,251000,0,251000,251000,2021-06-09
593,077274,和大統一07購01,0,0,0,0,0,0,0,0,0,251000,0,0,0,251000,0,251000,251000,2021-06-09
594,089092,友達統一0B購04,0,0,0,0,0,0,0,0,0,251000,0,0,0,952000,701000,251000,251000,2021-06-09
595,00636,國泰中國A50,20000,12000,8000,0,0,0,0,0,0,242485,0,0,0,1020485,778000,242485,250485,2021-06-09
596,084255,華新科元富07購09,0,0,0,0,0,0,0,0,0,250000,0,0,0,250000,0,250000,250000,2021-06-09
597,034654,台積電中信0B購15,0,0,0,0,0,0,0,0,0,250000,0,0,0,250000,0,250000,250000,2021-06-09
598,06142P,臺股指中信0A售06,0,0,0,0,0,0,0,0,0,250000,0,0,0,300000,50000,250000,250000,2021-06-09
599,077444,元石油國票06購01,0,0,0,0,0,0,0,0,0,250000,0,0,0,250000,0,250000,250000,2021-06-09
600,074190,可成國泰06購01,0,0,0,0,0,0,0,0,0,250000,0,0,0,250000,0,250000,250000,2021-06-09
601,075844,恆大國泰07購01,0,0,0,0,0,0,0,0,0,250000,0,0,0,250000,0,250000,250000,2021-06-09
602,07246P,鴻海凱基0B售12,0,0,0,0,0,0,0,0,0,250000,0,0,0,250000,0,250000,250000,2021-06-09
603,080529,強茂群益06購02,0,0,0,0,0,0,0,0,0,250000,0,0,0,250000,0,250000,250000,2021-06-09
604,080862,華邦電統一07購03,0,0,0,0,0,0,0,0,0,250000,0,0,0,255000,5000,250000,250000,2021-06-09
605,089423,奇力新永豐09購01,0,0,0,0,0,0,0,0,0,250000,0,0,0,250000,0,250000,250000,2021-06-09
606,3034,聯詠,1361498,1346640,14858,0,0,0,198000,49000,149000,86000,38000,20000,18000,117000,49000,68000,249858,2021-06-09
607,032741,長榮凱基0A購19,0,0,0,0,0,0,0,0,0,249000,0,0,0,249000,0,249000,249000,2021-06-09
608,086855,南電元大0A購01,0,0,0,0,0,0,0,0,0,248000,0,0,0,557000,309000,248000,248000,2021-06-09
609,036207,南電統一12購01,0,0,0,0,0,0,0,0,0,248000,0,0,0,501000,253000,248000,248000,2021-06-09
610,034305,允強永豐0B購01,0,0,0,0,0,0,0,0,0,248000,0,0,0,252000,4000,248000,248000,2021-06-09
611,089989,達運元大0A購01,0,0,0,0,0,0,0,0,0,248000,0,0,0,340000,92000,248000,248000,2021-06-09
612,033054,光罩永豐0A購03,0,0,0,0,0,0,0,0,0,247000,0,0,0,525000,278000,247000,247000,2021-06-09
613,035586,中鋼元大0B購13,0,0,0,0,0,0,0,0,0,247000,0,0,0,267000,20000,247000,247000,2021-06-09
614,087428,聯電元富09購03,0,0,0,0,0,0,0,0,0,246000,0,0,0,360000,114000,246000,246000,2021-06-09
615,083781,T50反1中信11購02,0,0,0,0,0,0,0,0,0,246000,0,0,0,251000,5000,246000,246000,2021-06-09
616,032329,東鋼群益0A購01,0,0,0,0,0,0,0,0,0,246000,0,0,0,418000,172000,246000,246000,2021-06-09
617,085803,日月光元大08購03,0,0,0,0,0,0,0,0,0,245000,0,0,0,250000,5000,245000,245000,2021-06-09
618,035803,台橡凱基0B購01,0,0,0,0,0,0,0,0,0,245000,0,0,0,248000,3000,245000,245000,2021-06-09
619,033815,燁輝統一0C購03,0,0,0,0,0,0,0,0,0,244000,0,0,0,386000,142000,244000,244000,2021-06-09
620,4989,榮科,584000,340000,244000,0,0,0,0,0,0,0,0,0,0,0,0,0,244000,2021-06-09
621,6282,康舒,328000,88000,240000,0,0,0,0,0,0,2900,1000,100,900,2000,0,2000,242900,2021-06-09
622,031861,亞泥凱基11購01,0,0,0,0,0,0,0,0,0,241000,0,0,0,241000,0,241000,241000,2021-06-09
623,06169P,鴻海元大08售07,0,0,0,0,0,0,0,0,0,241000,0,0,0,266000,25000,241000,241000,2021-06-09
624,082033,上証2X凱基0A購02,0,0,0,0,0,0,0,0,0,241000,0,0,0,416000,175000,241000,241000,2021-06-09
625,071526,奇鋐元富09購01,0,0,0,0,0,0,0,0,0,241000,0,0,0,544000,303000,241000,241000,2021-06-09
626,085540,台勝科永豐08購01,0,20000,-20000,0,0,0,0,0,0,260000,0,0,0,503000,243000,260000,240000,2021-06-09
627,9919,康那香,452000,209000,243000,0,0,0,0,0,0,-3000,0,0,0,0,3000,-3000,240000,2021-06-09
628,085117,聯發科元大08購10,0,0,0,0,0,0,0,0,0,239000,0,0,0,305000,66000,239000,239000,2021-06-09
629,089012,大立光元大11購01,0,0,0,0,0,0,0,0,0,239000,0,0,0,360000,121000,239000,239000,2021-06-09
630,033060,開發金永豐0A購01,0,0,0,0,0,0,0,0,0,239000,0,0,0,239000,0,239000,239000,2021-06-09
631,031117,南茂群益0A購01,0,0,0,0,0,0,0,0,0,239000,0,0,0,326000,87000,239000,239000,2021-06-09
632,06819P,長榮凱基0B售07,0,0,0,0,0,0,0,0,0,239000,0,0,0,1715000,1476000,239000,239000,2021-06-09
633,089919,美利達凱基0B購01,0,0,0,0,0,0,0,0,0,239000,0,0,0,256000,17000,239000,239000,2021-06-09
634,083469,億光統一09購03,0,0,0,0,0,0,0,0,0,238000,0,0,0,258000,20000,238000,238000,2021-06-09
635,1810,和成,377000,139000,238000,0,0,0,0,0,0,0,0,0,0,0,0,0,238000,2021-06-09
636,031447,A50正2元富11購01,0,0,0,0,0,0,0,0,0,237000,0,0,0,264000,27000,237000,237000,2021-06-09
637,082270,聯電元大07購08,0,0,0,0,0,0,0,0,0,237000,0,0,0,237000,0,237000,237000,2021-06-09
638,083157,金像電群益07購04,0,0,0,0,0,0,0,0,0,237000,0,0,0,237000,0,237000,237000,2021-06-09
639,00676R,富邦臺灣加權反1,90000,59000,31000,0,0,0,0,0,0,205000,0,0,0,823000,618000,205000,236000,2021-06-09
640,034102,聚陽群益0C購01,0,0,0,0,0,0,0,0,0,236000,0,0,0,274000,38000,236000,236000,2021-06-09
641,2342,茂矽,492000,256000,236000,0,0,0,0,0,0,0,0,0,0,0,0,0,236000,2021-06-09
642,085255,和大國泰0A購01,0,0,0,0,0,0,0,0,0,235000,0,0,0,235000,0,235000,235000,2021-06-09
643,07240P,儒鴻元大0B售02,0,0,0,0,0,0,0,0,0,235000,0,0,0,245000,10000,235000,235000,2021-06-09
644,030730,台積電元大11購08,0,0,0,0,0,0,0,0,0,234000,0,0,0,320000,86000,234000,234000,2021-06-09
645,085746,王品永豐08購01,0,0,0,0,0,0,0,0,0,233000,0,0,0,233000,0,233000,233000,2021-06-09
646,087080,TPK統一0B購02,0,0,0,0,0,0,0,0,0,233000,0,0,0,243000,10000,233000,233000,2021-06-09
647,033184,T50反1凱基12購01,0,0,0,0,0,0,0,0,0,233000,0,0,0,233000,0,233000,233000,2021-06-09
648,033656,順德統一0C購02,0,0,0,0,0,0,0,0,0,233000,0,0,0,261000,28000,233000,233000,2021-06-09
649,033968,中鋼凱基0C購03,0,0,0,0,0,0,0,0,0,232000,0,0,0,252000,20000,232000,232000,2021-06-09
650,06506P,台積電元富0C售12,0,0,0,0,0,0,0,0,0,232000,0,0,0,232000,0,232000,232000,2021-06-09
651,2201,裕隆,912000,672000,240000,0,0,0,0,0,0,-9249,760,4009,-3249,1000,7000,-6000,230751,2021-06-09
652,031236,正隆群益0A購01,0,0,0,0,0,0,0,0,0,230000,0,0,0,232000,2000,230000,230000,2021-06-09
653,035812,長榮航凱基0B購04,0,0,0,0,0,0,0,0,0,230000,0,0,0,351000,121000,230000,230000,2021-06-09
654,035920,順德統一11購01,0,0,0,0,0,0,0,0,0,230000,0,0,0,314000,84000,230000,230000,2021-06-09
655,034843,T50反1元大11購07,0,0,0,0,0,0,0,0,0,230000,0,0,0,230000,0,230000,230000,2021-06-09
656,078876,國巨元大07購05,0,0,0,0,0,0,0,0,0,230000,0,0,0,230000,0,230000,230000,2021-06-09
657,036405,永豐餘群益12購02,0,0,0,0,0,0,0,0,0,229000,0,0,0,249000,20000,229000,229000,2021-06-09
658,068416,致茂中信07購01,0,0,0,0,0,0,0,0,0,229000,0,0,0,229000,0,229000,229000,2021-06-09
659,082963,聯電元大08購05,0,0,0,0,0,0,0,0,0,229000,0,0,0,230000,1000,229000,229000,2021-06-09
660,2332,友訊,676000,355000,321000,0,0,0,0,0,0,-92056,0,16000,-16000,6,76062,-76056,228944,2021-06-09
661,033875,臺股指群益0B購01,0,0,0,0,0,0,0,0,0,228000,0,0,0,303000,75000,228000,228000,2021-06-09
662,034713,國喬康和0C購01,0,0,0,0,0,0,0,0,0,228000,0,0,0,408000,180000,228000,228000,2021-06-09
663,081436,台達電統一09購01,0,0,0,0,0,0,0,0,0,228000,0,0,0,260000,32000,228000,228000,2021-06-09
664,088298,南茂麥證0A購01,0,0,0,236000,0,236000,0,0,0,227000,0,0,0,236000,9000,227000,227000,2021-06-09
665,034636,玉晶光元大0C購04,0,0,0,0,0,0,0,0,0,227000,0,0,0,278000,51000,227000,227000,2021-06-09
666,035584,中石化元大0B購05,0,0,0,0,0,0,0,0,0,227000,0,0,0,236000,9000,227000,227000,2021-06-09
667,034870,矽創元大0B購06,0,0,0,0,0,0,0,0,0,227000,0,0,0,423000,196000,227000,227000,2021-06-09
668,089933,盟立永豐0A購01,0,0,0,0,0,0,0,0,0,227000,0,0,0,227000,0,227000,227000,2021-06-09
669,089422,聯發科永豐0C購01,0,0,0,0,0,0,0,0,0,227000,0,0,0,250000,23000,227000,227000,2021-06-09
670,035399,寶成永豐0B購01,0,0,0,0,0,0,0,0,0,225000,0,0,0,225000,0,225000,225000,2021-06-09
671,034997,燁輝元大0C購03,0,0,0,0,0,0,0,0,0,225000,0,0,0,228000,3000,225000,225000,2021-06-09
672,034077,大成鋼元大0B購09,0,0,0,0,0,0,0,0,0,223000,0,0,0,274000,51000,223000,223000,2021-06-09
673,089505,鴻海元大0B購09,0,0,0,0,0,0,0,0,0,223000,0,0,0,271000,48000,223000,223000,2021-06-09
674,087394,華新科元大11購03,0,0,0,0,0,0,0,0,0,222000,0,0,0,240000,18000,222000,222000,2021-06-09
675,086916,S&P反1中信0B購01,0,0,0,0,0,0,0,0,0,222000,0,0,0,241000,19000,222000,222000,2021-06-09
676,035790,威鋒電國泰12購01,0,0,0,0,0,0,0,0,0,222000,0,0,0,367000,145000,222000,222000,2021-06-09
677,086099,欣興永豐08購02,0,0,0,0,0,0,0,0,0,221000,0,0,0,221000,0,221000,221000,2021-06-09
678,082699,華邦電凱基08購03,0,0,0,0,0,0,0,0,0,221000,0,0,0,230000,9000,221000,221000,2021-06-09
679,084354,可成元大07購07,0,0,0,0,0,0,0,0,0,220000,0,0,0,220000,0,220000,220000,2021-06-09
680,031208,燁輝凱基0A購01,0,0,0,0,0,0,0,0,0,220000,0,0,0,220000,0,220000,220000,2021-06-09
681,033049,美時永豐0A購01,0,0,0,0,0,0,0,0,0,220000,0,0,0,252000,32000,220000,220000,2021-06-09
682,035843,奇鋐元大0B購03,0,0,0,0,0,0,0,0,0,220000,0,0,0,561000,341000,220000,220000,2021-06-09
683,035066,祥碩中信0B購02,0,0,0,0,0,0,0,0,0,220000,0,0,0,240000,20000,220000,220000,2021-06-09
684,082412,鴻海麥證0C購01,0,0,0,220000,0,220000,0,0,0,220000,0,0,0,220000,0,220000,220000,2021-06-09
685,089575,力鵬永豐09購01,0,0,0,0,0,0,0,0,0,220000,0,0,0,221000,1000,220000,220000,2021-06-09
686,031740,華榮凱基12購02,0,0,0,0,0,0,0,0,0,219000,0,0,0,219000,0,219000,219000,2021-06-09
687,033916,台聚元大0B購03,0,0,0,0,0,0,0,0,0,219000,0,0,0,565000,346000,219000,219000,2021-06-09
688,087720,GIS統一0B購01,0,0,0,0,0,0,0,0,0,218000,0,0,0,218000,0,218000,218000,2021-06-09
689,035994,智原國泰12購01,0,0,0,0,0,0,0,0,0,218000,0,0,0,233000,15000,218000,218000,2021-06-09
690,035144,長榮統一0C購17,0,0,0,0,0,0,0,0,0,218000,0,0,0,239000,21000,218000,218000,2021-06-09
691,033849,台橡永豐0B購02,0,0,0,0,0,0,0,0,0,218000,0,0,0,218000,0,218000,218000,2021-06-09
692,034437,允強凱基0B購01,0,0,0,0,0,0,0,0,0,218000,0,0,0,306000,88000,218000,218000,2021-06-09
693,06267P,台灣50凱基0A售01,0,0,0,0,0,0,0,0,0,218000,0,0,0,318000,100000,218000,218000,2021-06-09
694,081859,欣興中信08購02,0,0,0,0,0,0,0,0,0,218000,0,0,0,1160000,942000,218000,218000,2021-06-09
695,1736,喬山,304000,114000,190000,0,0,0,0,0,0,28000,0,0,0,28000,0,28000,218000,2021-06-09
696,086506,義隆麥證09購01,0,0,0,234000,17000,217000,0,0,0,217000,0,0,0,234000,17000,217000,217000,2021-06-09
697,032235,T50反1元大0A購10,0,0,0,0,0,0,0,0,0,217000,0,0,0,277000,60000,217000,217000,2021-06-09
698,033605,燁輝群益0C購01,0,0,0,0,0,0,0,0,0,217000,0,0,0,219000,2000,217000,217000,2021-06-09
699,035020,大亞凱基0B購03,0,0,0,0,0,0,0,0,0,217000,0,0,0,217000,0,217000,217000,2021-06-09
700,032667,順德富邦0C購01,0,0,0,0,0,0,0,0,0,216000,0,0,0,218000,2000,216000,216000,2021-06-09
701,031639,正隆元大0A購02,0,0,0,0,0,0,0,0,0,216000,0,0,0,608000,392000,216000,216000,2021-06-09
702,034861,嘉晶元大0C購04,0,0,0,0,0,0,0,0,0,216000,0,0,0,250000,34000,216000,216000,2021-06-09
703,5285,界霖,401000,183000,218000,0,0,0,0,0,0,-2000,0,0,0,0,2000,-2000,216000,2021-06-09
704,088631,南茂永豐09購02,0,0,0,0,0,0,0,0,0,215000,0,0,0,319000,104000,215000,215000,2021-06-09
705,033391,玉晶光元大12購02,0,0,0,0,0,0,0,0,0,215000,0,0,0,215000,0,215000,215000,2021-06-09
706,033070,長榮凱基0A購21,0,0,0,0,0,0,0,0,0,215000,0,0,0,215000,0,215000,215000,2021-06-09
707,084465,和大凱基09購02,0,0,0,0,0,0,0,0,0,214000,0,0,0,214000,0,214000,214000,2021-06-09
708,05452P,臺股指國票0A售04,0,0,0,0,0,0,0,0,0,214000,0,0,0,279000,65000,214000,214000,2021-06-09
709,080190,國喬元富08購02,0,0,0,0,0,0,0,0,0,214000,0,0,0,214000,0,214000,214000,2021-06-09
710,2028,威致,246000,32000,214000,0,0,0,0,0,0,0,0,0,0,0,0,0,214000,2021-06-09
711,032871,國喬凱基0B購02,0,0,0,0,0,0,0,0,0,213000,0,0,0,310000,97000,213000,213000,2021-06-09
712,082631,台光電國泰09購01,0,0,0,0,0,0,0,0,0,213000,0,0,0,749000,536000,213000,213000,2021-06-09
713,06752P,臺股指中信0A售08,0,0,0,0,0,0,0,0,0,213000,0,0,0,253000,40000,213000,213000,2021-06-09
714,033152,彩晶元大0B購06,0,0,0,0,0,0,0,0,0,212000,0,0,0,381000,169000,212000,212000,2021-06-09
715,031379,大亞統一0B購02,0,0,0,0,0,0,0,0,0,212000,0,0,0,212000,0,212000,212000,2021-06-09
716,034627,國光生元富12購02,0,0,0,0,0,0,0,0,0,212000,0,0,0,260000,48000,212000,212000,2021-06-09
717,06437P,旺宏群益0B售03,0,0,0,0,0,0,0,0,0,212000,0,0,0,227000,15000,212000,212000,2021-06-09
718,088697,南茂元富0A購01,0,0,0,0,0,0,0,0,0,211000,0,0,0,444000,233000,211000,211000,2021-06-09
719,034080,台橡元大0C購02,0,0,0,0,0,0,0,0,0,211000,0,0,0,211000,0,211000,211000,2021-06-09
720,033625,矽統元富0B購01,0,0,0,0,0,0,0,0,0,211000,0,0,0,378000,167000,211000,211000,2021-06-09
721,06775P,臺股指群益0A售06,0,0,0,0,0,0,0,0,0,211000,0,0,0,251000,40000,211000,211000,2021-06-09
722,034033,燁輝元富0B購02,0,0,0,0,0,0,0,0,0,210000,0,0,0,297000,87000,210000,210000,2021-06-09
723,034641,矽創元大0B購05,0,0,0,0,0,0,0,0,0,210000,0,0,0,384000,174000,210000,210000,2021-06-09
724,033949,國巨國票0B購04,0,0,0,0,0,0,0,0,0,210000,0,0,0,210000,0,210000,210000,2021-06-09
725,06416P,臺股指元大0B售08,0,0,0,0,0,0,0,0,0,210000,0,0,0,211000,1000,210000,210000,2021-06-09
726,2465,麗臺,211500,2000,209500,0,0,0,0,0,0,0,0,0,0,0,0,0,209500,2021-06-09
727,006205,富邦上証,5000,6000,-1000,0,0,0,0,0,0,210124,0,0,0,471124,261000,210124,209124,2021-06-09
728,086768,佳世達凱基0C購01,0,0,0,0,0,0,0,0,0,209000,0,0,0,209000,0,209000,209000,2021-06-09
729,07199P,臺股指中信13售04,0,0,0,0,0,0,0,0,0,209000,0,0,0,236000,27000,209000,209000,2021-06-09
730,030062,南茂元大0B購01,0,0,0,0,0,0,0,0,0,208000,0,0,0,701000,493000,208000,208000,2021-06-09
731,031826,百和元大0B購01,0,0,0,0,0,0,0,0,0,208000,0,0,0,255000,47000,208000,208000,2021-06-09
732,06114P,滬深2X元富07售03,0,0,0,0,0,0,0,0,0,208000,0,0,0,210000,2000,208000,208000,2021-06-09
733,086047,聯發科元富12購01,0,0,0,0,0,0,0,0,0,207000,0,0,0,207000,0,207000,207000,2021-06-09
734,034585,美德醫凱基0B購01,0,0,0,0,0,0,0,0,0,207000,0,0,0,248000,41000,207000,207000,2021-06-09
735,036108,中鋼國泰12購01,0,0,0,0,0,0,0,0,0,207000,0,0,0,212000,5000,207000,207000,2021-06-09
736,082505,國喬兆豐07購01,0,0,0,0,0,0,0,0,0,207000,0,0,0,207000,0,207000,207000,2021-06-09
737,088848,台泥永豐09購01,0,0,0,0,0,0,0,0,0,206000,0,0,0,340000,134000,206000,206000,2021-06-09
738,030008,長興元富0B購01,0,0,0,0,0,0,0,0,0,206000,0,0,0,611000,405000,206000,206000,2021-06-09
739,031120,大成鋼統一0C購01,0,0,0,0,0,0,0,0,0,206000,0,0,0,206000,0,206000,206000,2021-06-09
740,030850,群創兆豐0A購02,0,0,0,0,0,0,0,0,0,206000,0,0,0,262000,56000,206000,206000,2021-06-09
741,035126,華新統一0C購04,0,0,0,0,0,0,0,0,0,206000,0,0,0,297000,91000,206000,206000,2021-06-09
742,035307,永豐餘元大0B購02,0,0,0,0,0,0,0,0,0,206000,0,0,0,206000,0,206000,206000,2021-06-09
743,033690,台新金元大0C購01,0,0,0,0,0,0,0,0,0,206000,0,0,0,236000,30000,206000,206000,2021-06-09
744,6288,聯嘉,310000,104000,206000,0,0,0,0,0,0,0,0,0,0,0,0,0,206000,2021-06-09
745,032145,長榮凱基11購02,0,0,0,0,0,0,0,0,0,205000,0,0,0,205000,0,205000,205000,2021-06-09
746,04588P,大立光元大08售01,0,0,0,0,0,0,0,0,0,205000,0,0,0,205000,0,205000,205000,2021-06-09
747,086491,A50正2元富09購02,0,0,0,0,0,0,0,0,0,204000,0,0,0,214000,10000,204000,204000,2021-06-09
748,035373,南紡凱基0B購02,0,0,0,0,0,0,0,0,0,204000,0,0,0,205000,1000,204000,204000,2021-06-09
749,034968,國產元大0C購02,0,0,0,0,0,0,0,0,0,203000,0,0,0,203000,0,203000,203000,2021-06-09
750,086567,圓展元大0A購01,0,0,0,0,0,0,0,0,0,202000,0,0,0,213000,11000,202000,202000,2021-06-09
751,07226P,萬海國票0C售05,0,0,0,0,0,0,0,0,0,202000,0,0,0,255000,53000,202000,202000,2021-06-09
752,087076,友達統一0A購05,0,0,0,0,0,0,0,0,0,201000,0,0,0,201000,0,201000,201000,2021-06-09
753,087716,元大金統一0B購01,0,0,0,0,0,0,0,0,0,201000,0,0,0,203000,2000,201000,201000,2021-06-09
754,05304P,旺宏元富09售04,0,0,0,0,0,0,0,0,0,201000,0,0,0,232000,31000,201000,201000,2021-06-09
755,6706,惠特,226000,74000,152000,0,0,0,20000,0,20000,28049,12000,18000,-6000,40049,6000,34049,200049,2021-06-09
756,086055,旺宏統一0A購05,0,0,0,0,0,0,0,0,0,200000,0,0,0,200000,0,200000,200000,2021-06-09
757,084477,精英凱基0B購01,0,0,0,0,0,0,0,0,0,200000,0,0,0,200000,0,200000,200000,2021-06-09
758,084147,奇力新永豐07購02,0,0,0,0,0,0,0,0,0,200000,0,0,0,200000,0,200000,200000,2021-06-09
759,031899,聯成永豐0A購03,0,0,0,0,0,0,0,0,0,200000,0,0,0,200000,0,200000,200000,2021-06-09
760,031747,華碩凱基11購02,0,0,0,0,0,0,0,0,0,200000,0,0,0,220000,20000,200000,200000,2021-06-09
761,033505,欣興統一11購02,0,0,0,0,0,0,0,0,0,200000,0,0,0,398000,198000,200000,200000,2021-06-09
762,030579,致茂元富11購01,0,0,0,0,0,0,0,0,0,200000,0,0,0,273000,73000,200000,200000,2021-06-09
763,036085,金像電元大0C購02,0,0,0,0,0,0,0,0,0,200000,0,0,0,491000,291000,200000,200000,2021-06-09
764,04276P,玉晶光國票06售04,0,0,0,0,0,0,0,0,0,200000,0,0,0,200000,0,200000,200000,2021-06-09
765,035327,聯詠元大0B購03,0,0,0,0,0,0,0,0,0,200000,0,0,0,310000,110000,200000,200000,2021-06-09
766,035049,國巨富邦12購01,0,0,0,0,0,0,0,0,0,200000,0,0,0,200000,0,200000,200000,2021-06-09
767,034847,道瓊反元大13購01,0,0,0,0,0,0,0,0,0,200000,0,0,0,200000,0,200000,200000,2021-06-09
768,035607,玉晶光元大0C購05,0,0,0,0,0,0,0,0,0,200000,0,0,0,200000,0,200000,200000,2021-06-09
769,033727,新光金國票11購01,0,0,0,0,0,0,0,0,0,200000,0,0,0,200000,0,200000,200000,2021-06-09
770,033746,友達中信0B購04,0,0,0,0,0,0,0,0,0,200000,0,0,0,200000,0,200000,200000,2021-06-09
771,034454,聯成群益0B購06,0,0,0,0,0,0,0,0,0,200000,0,0,0,214000,14000,200000,200000,2021-06-09
772,034076,燁輝元大11購02,0,0,0,0,0,0,0,0,0,200000,0,0,0,227000,27000,200000,200000,2021-06-09
773,071823,新光金元大06購01,0,0,0,0,0,0,0,0,0,200000,0,0,0,200000,0,200000,200000,2021-06-09
774,071896,漢唐元富07購03,0,0,0,0,0,0,0,0,0,200000,0,0,0,200000,0,200000,200000,2021-06-09
775,078935,群創永豐06購03,0,0,0,0,0,0,0,0,0,200000,0,0,0,200000,0,200000,200000,2021-06-09
776,077065,祥碩統一09購01,0,0,0,0,0,0,0,0,0,200000,0,0,0,200000,0,200000,200000,2021-06-09
777,077334,為升中信08購01,0,0,0,0,0,0,0,0,0,200000,0,0,0,220000,20000,200000,200000,2021-06-09
778,06539P,臺股指凱基09售25,0,0,0,0,0,0,0,0,0,200000,0,0,0,220000,20000,200000,200000,2021-06-09
779,083137,華新科凱基08購03,0,0,0,0,0,0,0,0,0,200000,0,0,0,200000,0,200000,200000,2021-06-09
780,083067,台積電康和07購02,0,0,0,0,0,0,0,0,0,200000,0,0,0,200000,0,200000,200000,2021-06-09
781,080305,台光電群益06購01,0,0,0,0,0,0,0,0,0,200000,0,0,0,200000,0,200000,200000,2021-06-09
782,080981,牧德元大07購01,0,0,0,0,0,0,0,0,0,200000,0,0,0,200000,0,200000,200000,2021-06-09
783,085371,聯電群益0B購01,0,0,0,0,0,0,0,0,0,199000,0,0,0,250000,51000,199000,199000,2021-06-09
784,087254,億光國票09購01,0,0,0,0,0,0,0,0,0,199000,0,0,0,207000,8000,199000,199000,2021-06-09
785,087395,華新科元大11購04,0,0,0,0,0,0,0,0,0,199000,0,0,0,216000,17000,199000,199000,2021-06-09
786,033165,義隆中信0B購01,0,0,0,0,0,0,0,0,0,199000,0,0,0,200000,1000,199000,199000,2021-06-09
787,034653,台積電中信0B購14,0,0,0,0,0,0,0,0,0,199000,0,0,0,199000,0,199000,199000,2021-06-09
788,035199,長榮元富12購02,0,0,0,0,0,0,0,0,0,199000,0,0,0,885000,686000,199000,199000,2021-06-09
789,074182,智易元富08購01,0,0,0,0,0,0,0,0,0,199000,0,0,0,199000,0,199000,199000,2021-06-09
790,087585,華新科元大0B購02,0,0,0,0,0,0,0,0,0,198000,0,0,0,210000,12000,198000,198000,2021-06-09
791,032522,彩晶永豐0A購04,0,0,0,0,0,0,0,0,0,198000,0,0,0,236000,38000,198000,198000,2021-06-09
792,078108,勝一元富0C購01,0,0,0,0,0,0,0,0,0,198000,0,0,0,198000,0,198000,198000,2021-06-09
793,083009,金像電凱基09購01,0,0,0,0,0,0,0,0,0,198000,0,0,0,312000,114000,198000,198000,2021-06-09
794,2038,海光,513000,315000,198000,0,0,0,0,0,0,0,0,0,0,0,0,0,198000,2021-06-09
795,030639,聯發科中信12購01,0,0,0,0,0,0,0,0,0,197000,0,0,0,230000,33000,197000,197000,2021-06-09
796,035417,東鋼元大0B購04,0,0,0,0,0,0,0,0,0,197000,0,0,0,201000,4000,197000,197000,2021-06-09
797,082845,奇鋐國票08購01,0,0,0,0,0,0,0,0,0,197000,0,0,0,307000,110000,197000,197000,2021-06-09
798,088514,訊芯元大09購01,0,0,0,0,0,0,0,0,0,196000,0,0,0,196000,0,196000,196000,2021-06-09
799,030383,大成元大0A購01,0,0,0,0,0,0,0,0,0,196000,0,0,0,225000,29000,196000,196000,2021-06-09
800,033318,中石化凱基11購02,0,0,0,0,0,0,0,0,0,196000,0,0,0,236000,40000,196000,196000,2021-06-09
801,088964,立積國票0A購01,0,0,0,0,0,0,0,0,0,195000,0,0,0,200000,5000,195000,195000,2021-06-09
802,085620,T50反1凱基0B購03,0,0,0,0,0,0,0,0,0,195000,0,0,0,215000,20000,195000,195000,2021-06-09
803,032212,中鋼統一0C購06,0,0,0,0,0,0,0,0,0,195000,0,0,0,195000,0,195000,195000,2021-06-09
804,032549,彩晶凱基0A購05,0,0,0,0,0,0,0,0,0,195000,0,0,0,348000,153000,195000,195000,2021-06-09
805,035523,中石化群益0C購02,0,0,0,0,0,0,0,0,0,195000,0,0,0,450000,255000,195000,195000,2021-06-09
806,2421,建準,353000,158000,195000,0,0,0,0,0,0,0,0,0,0,0,0,0,195000,2021-06-09
807,1611,中電,252000,57000,195000,0,0,0,0,0,0,0,0,0,0,0,0,0,195000,2021-06-09
808,033214,岱宇元富0C購01,0,0,0,0,0,0,0,0,0,194000,0,0,0,221000,27000,194000,194000,2021-06-09
809,034964,大成鋼元大0C購04,0,0,0,0,0,0,0,0,0,194000,0,0,0,205000,11000,194000,194000,2021-06-09
810,034375,東聯元大0B購02,0,0,0,0,0,0,0,0,0,194000,0,0,0,194000,0,194000,194000,2021-06-09
811,083917,矽格元大07購03,0,0,0,0,0,0,0,0,0,193000,0,0,0,200000,7000,193000,193000,2021-06-09
812,081196,華邦電元大07購09,0,0,0,0,0,0,0,0,0,193000,0,0,0,193000,0,193000,193000,2021-06-09
813,086312,友達凱基0B購03,0,0,0,0,0,0,0,0,0,192000,0,0,0,242000,50000,192000,192000,2021-06-09
814,031700,和桐永豐0A購01,0,0,0,0,0,0,0,0,0,192000,0,0,0,340000,148000,192000,192000,2021-06-09
815,033583,大成鋼凱基13購03,0,0,0,0,0,0,0,0,0,192000,0,0,0,207000,15000,192000,192000,2021-06-09
816,04473P,欣興元富07售04,0,0,0,0,0,0,0,0,0,191000,0,0,0,300000,109000,191000,191000,2021-06-09
817,089438,南亞科群益09購03,0,0,0,0,0,0,0,0,0,191000,0,0,0,205000,14000,191000,191000,2021-06-09
818,085983,國巨元大09購02,0,0,0,0,0,0,0,0,0,190000,0,0,0,190000,0,190000,190000,2021-06-09
819,085462,聯電麥證0C購02,0,0,0,190000,0,190000,0,0,0,190000,0,0,0,190000,0,190000,190000,2021-06-09
820,088943,立積統一11購02,0,0,0,0,0,0,0,0,0,190000,0,0,0,200000,10000,190000,190000,2021-06-09
821,087975,旺宏凱基09購02,0,0,0,0,0,0,0,0,0,190000,0,0,0,300000,110000,190000,190000,2021-06-09
822,086598,南茂國票0A購01,0,0,0,0,0,0,0,0,0,190000,0,0,0,201000,11000,190000,190000,2021-06-09
823,032275,鴻海富邦13購01,0,0,0,0,0,0,0,0,0,190000,0,0,0,200000,10000,190000,190000,2021-06-09
824,030753,彩晶元大0C購02,0,0,0,0,0,0,0,0,0,190000,0,0,0,199000,9000,190000,190000,2021-06-09
825,030540,盟立凱基0B購01,0,0,0,0,0,0,0,0,0,190000,0,0,0,200000,10000,190000,190000,2021-06-09
826,035035,廣達麥證0B購01,0,0,0,229000,10000,219000,0,0,0,190000,0,0,0,229000,39000,190000,190000,2021-06-09
827,034671,華新科凱基0B購01,0,0,0,0,0,0,0,0,0,190000,0,0,0,198000,8000,190000,190000,2021-06-09
828,035606,玉晶光元大0B購05,0,0,0,0,0,0,0,0,0,190000,0,0,0,200000,10000,190000,190000,2021-06-09
829,034758,長榮統一0B購11,0,0,0,0,0,0,0,0,0,190000,0,0,0,200000,10000,190000,190000,2021-06-09
830,06597P,旺宏中信0A售01,0,0,0,0,0,0,0,0,0,190000,0,0,0,410000,220000,190000,190000,2021-06-09
831,084954,聯發科凱基0B購03,0,0,0,0,0,0,0,0,0,189000,0,0,0,396000,207000,189000,189000,2021-06-09
832,032580,華新元大0A購02,0,0,0,0,0,0,0,0,0,189000,0,0,0,253000,64000,189000,189000,2021-06-09
833,087578,中興電元大11購01,0,0,0,0,0,0,0,0,0,188000,0,0,0,942000,754000,188000,188000,2021-06-09
834,032361,南亞科凱基0B購01,0,0,0,0,0,0,0,0,0,188000,0,0,0,198000,10000,188000,188000,2021-06-09
835,033553,技嘉中信0B購01,0,0,0,0,0,0,0,0,0,188000,0,0,0,241000,53000,188000,188000,2021-06-09
836,034187,新光鋼元大0B購03,0,0,0,0,0,0,0,0,0,188000,0,0,0,203000,15000,188000,188000,2021-06-09
837,081032,A50正2富邦09購01,0,0,0,0,0,0,0,0,0,188000,0,0,0,188000,0,188000,188000,2021-06-09
838,030091,泰豐永豐0A購01,0,0,0,0,0,0,0,0,0,187000,0,0,0,209000,22000,187000,187000,2021-06-09
839,035069,大亞群益0B購05,0,0,0,0,0,0,0,0,0,187000,0,0,0,187000,0,187000,187000,2021-06-09
840,088338,美食元大09購03,0,0,0,0,0,0,0,0,0,185000,0,0,0,185000,0,185000,185000,2021-06-09
841,00693U,期街口S&P黃豆,85000,2000,83000,0,0,0,0,0,0,102000,0,0,0,119000,17000,102000,185000,2021-06-09
842,033291,群創統一15購01,0,0,0,0,0,0,0,0,0,184000,0,0,0,191000,7000,184000,184000,2021-06-09
843,035380,萬海凱基0B購05,0,0,0,0,0,0,0,0,0,184000,0,0,0,204000,20000,184000,184000,2021-06-09
844,035807,國巨凱基0B購10,0,0,0,0,0,0,0,0,0,184000,0,0,0,198000,14000,184000,184000,2021-06-09
845,07003P,欣興元大0B售02,0,0,0,0,0,0,0,0,0,184000,0,0,0,1085000,901000,184000,184000,2021-06-09
846,6414,樺漢,231000,43000,188000,0,0,0,0,0,0,-4000,5000,20000,-15000,11000,0,11000,184000,2021-06-09
847,031588,玉晶光凱基0A購02,0,0,0,0,0,0,0,0,0,183000,0,0,0,193000,10000,183000,183000,2021-06-09
848,033954,國泰金國票0C購02,0,0,0,0,0,0,0,0,0,183000,0,0,0,200000,17000,183000,183000,2021-06-09
849,07305P,聯發科元大0C售15,0,0,0,0,0,0,0,0,0,183000,0,0,0,200000,17000,183000,183000,2021-06-09
850,087862,大立光富邦0B購02,0,0,0,0,0,0,0,0,0,182000,0,0,0,200000,18000,182000,182000,2021-06-09
851,035588,東鋼元大0C購03,0,2000,-2000,0,0,0,0,0,0,184000,0,0,0,184000,0,184000,182000,2021-06-09
852,06212P,台灣50元富08售05,0,0,0,0,0,0,0,0,0,182000,0,0,0,234000,52000,182000,182000,2021-06-09
853,3413,京鼎,175000,55000,120000,0,0,0,61000,0,61000,1000,0,2000,-2000,7000,4000,3000,182000,2021-06-09
854,00643,群益深証中小,131000,7000,124000,0,0,0,0,0,0,57944,0,0,0,142944,85000,57944,181944,2021-06-09
855,5469,瀚宇博,522000,364975,157025,0,0,0,0,0,0,24000,0,0,0,25000,1000,24000,181025,2021-06-09
856,036169,國喬麥證11購01,0,0,0,229000,48000,181000,0,0,0,181000,0,0,0,229000,48000,181000,181000,2021-06-09
857,034672,長榮凱基0B購10,0,0,0,0,0,0,0,0,0,181000,0,0,0,181000,0,181000,181000,2021-06-09
858,036066,華新科群益11購01,0,0,0,0,0,0,0,0,0,181000,0,0,0,188000,7000,181000,181000,2021-06-09
859,06984P,智邦元大0A售03,0,0,0,0,0,0,0,0,0,181000,0,0,0,232000,51000,181000,181000,2021-06-09
860,06921P,彩晶中信0A售04,0,0,0,0,0,0,0,0,0,181000,0,0,0,214000,33000,181000,181000,2021-06-09
861,079754,國巨元富07購26,0,0,0,0,0,0,0,0,0,181000,0,0,0,181000,0,181000,181000,2021-06-09
862,084562,國巨國票08購09,0,0,0,0,0,0,0,0,0,180000,0,0,0,200000,20000,180000,180000,2021-06-09
863,083684,玉晶光統一08購05,0,0,0,0,0,0,0,0,0,180000,0,0,0,180000,0,180000,180000,2021-06-09
864,085615,玉晶光元大0C購01,0,0,0,0,0,0,0,0,0,180000,0,0,0,201000,21000,180000,180000,2021-06-09
865,033404,聯發科中信0B購05,0,0,0,0,0,0,0,0,0,180000,0,0,0,200000,20000,180000,180000,2021-06-09
866,036101,台表科元大0C購02,0,0,0,0,0,0,0,0,0,180000,0,0,0,202000,22000,180000,180000,2021-06-09
867,034440,超豐凱基0B購01,0,0,0,0,0,0,0,0,0,180000,0,0,0,312000,132000,180000,180000,2021-06-09
868,082068,喬山元大07購01,0,0,0,0,0,0,0,0,0,180000,0,0,0,200000,20000,180000,180000,2021-06-09
869,2634,漢翔,296000,109000,187000,0,0,0,0,0,0,-7000,0,4000,-4000,0,3000,-3000,180000,2021-06-09
870,089612,聯詠群益09購07,0,0,0,0,0,0,0,0,0,180000,0,0,0,190000,10000,180000,180000,2021-06-09
871,033453,偉詮電群益11購01,0,0,0,0,0,0,0,0,0,179000,0,0,0,212000,33000,179000,179000,2021-06-09
872,031342,群創元大0A購11,0,0,0,0,0,0,0,0,0,179000,0,0,0,179000,0,179000,179000,2021-06-09
873,033773,南電群益0B購03,0,0,0,0,0,0,0,0,0,179000,0,0,0,407000,228000,179000,179000,2021-06-09
874,06895P,台聚元大0A售07,0,0,0,0,0,0,0,0,0,179000,0,0,0,189000,10000,179000,179000,2021-06-09
875,8404,百和興業-KY,401000,222000,179000,0,0,0,0,0,0,0,0,0,0,0,0,0,179000,2021-06-09
876,6533,晶心科,348000,170000,178000,0,0,0,0,0,0,122,1122,1000,122,0,0,0,178122,2021-06-09
877,030786,南帝凱基0C購01,0,0,0,0,0,0,0,0,0,178000,0,0,0,286000,108000,178000,178000,2021-06-09
878,033672,華新元大0B購03,0,0,0,0,0,0,0,0,0,178000,0,0,0,191000,13000,178000,178000,2021-06-09
879,4106,雃博,1645000,1467000,178000,0,0,0,0,0,0,0,0,0,0,0,0,0,178000,2021-06-09
880,085373,技嘉群益09購02,0,0,0,0,0,0,0,0,0,177000,0,0,0,315000,138000,177000,177000,2021-06-09
881,087641,申豐凱基0B購01,0,0,0,0,0,0,0,0,0,177000,0,0,0,177000,0,177000,177000,2021-06-09
882,036259,正隆群益0C購01,0,0,0,0,0,0,0,0,0,177000,0,0,0,202000,25000,177000,177000,2021-06-09
883,080775,貿聯元大06購01,0,0,0,0,0,0,0,0,0,177000,0,0,0,287000,110000,177000,177000,2021-06-09
884,1527,鑽全,422000,245000,177000,0,0,0,0,0,0,0,0,0,0,0,0,0,177000,2021-06-09
885,6598,ABC-KY,418000,241000,177000,0,0,0,0,0,0,0,0,0,0,0,0,0,177000,2021-06-09
886,031484,聯成元大0A購02,0,0,0,0,0,0,0,0,0,175000,0,0,0,249000,74000,175000,175000,2021-06-09
887,082840,日月光富邦07購02,0,0,0,0,0,0,0,0,0,175000,0,0,0,185000,10000,175000,175000,2021-06-09
888,089667,聚陽元大09購05,0,0,0,0,0,0,0,0,0,175000,0,0,0,225000,50000,175000,175000,2021-06-09
889,3047,訊舟,246000,71000,175000,0,0,0,0,0,0,0,0,0,0,0,0,0,175000,2021-06-09
890,087443,A50正2群益09購02,0,0,0,0,0,0,0,0,0,174000,0,0,0,239000,65000,174000,174000,2021-06-09
891,030235,大成永豐0A購01,0,0,0,0,0,0,0,0,0,174000,0,0,0,209000,35000,174000,174000,2021-06-09
892,034951,華新科凱基0B購02,0,0,0,0,0,0,0,0,0,174000,0,0,0,188000,14000,174000,174000,2021-06-09
893,034963,榮成元大0B購02,0,0,0,0,0,0,0,0,0,174000,0,0,0,235000,61000,174000,174000,2021-06-09
894,082844,富邦金國票08購01,0,0,0,0,0,0,0,0,0,174000,0,0,0,174000,0,174000,174000,2021-06-09
895,06864P,上銀元大0A售01,0,0,0,0,0,0,0,0,0,174000,0,0,0,184000,10000,174000,174000,2021-06-09
896,3515,華擎,352000,226000,126000,0,0,0,0,0,0,48000,0,0,0,50000,2000,48000,174000,2021-06-09
897,5522,遠雄,332508,47000,285508,0,0,0,0,94000,-94000,-18000,10000,88000,-78000,60000,0,60000,173508,2021-06-09
898,030838,正隆兆豐0A購01,0,0,0,0,0,0,0,0,0,173000,0,0,0,414000,241000,173000,173000,2021-06-09
899,033578,宏泰凱基12購01,0,0,0,0,0,0,0,0,0,173000,0,0,0,173000,0,173000,173000,2021-06-09
900,034555,聯電富邦11購01,0,0,0,0,0,0,0,0,0,173000,0,0,0,206000,33000,173000,173000,2021-06-09
901,07126P,臺股指元大0C售25,0,0,0,0,0,0,0,0,0,172000,0,0,0,274000,102000,172000,172000,2021-06-09
902,082680,奇鋐麥證07購01,0,0,0,357000,185000,172000,0,0,0,172000,0,0,0,357000,185000,172000,172000,2021-06-09
903,081330,台苯群益08購01,0,0,0,0,0,0,0,0,0,172000,0,0,0,172000,0,172000,172000,2021-06-09
904,081234,大聯大統一0A購01,0,0,0,0,0,0,0,0,0,172000,0,0,0,203000,31000,172000,172000,2021-06-09
905,087706,聯電統一0B購04,0,0,0,0,0,0,0,0,0,171000,0,0,0,182000,11000,171000,171000,2021-06-09
906,033167,新纖永豐0B購01,0,0,0,0,0,0,0,0,0,171000,0,0,0,250000,79000,171000,171000,2021-06-09
907,087297,瑞儀元大09購01,0,0,0,0,0,0,0,0,0,170000,0,0,0,170000,0,170000,170000,2021-06-09
908,033842,玉晶光兆豐0B購03,0,0,0,0,0,0,0,0,0,170000,0,0,0,178000,8000,170000,170000,2021-06-09
909,073623,友訊元富0A購01,0,0,0,0,0,0,0,0,0,170000,0,0,0,170000,0,170000,170000,2021-06-09
910,07198P,臺股指中信12售04,0,0,0,0,0,0,0,0,0,170000,0,0,0,170000,0,170000,170000,2021-06-09
911,030386,直得元大0A購01,0,0,0,0,0,0,0,0,0,169000,0,0,0,170000,1000,169000,169000,2021-06-09
912,07233P,聯詠凱基0B售06,0,0,0,0,0,0,0,0,0,169000,0,0,0,169000,0,169000,169000,2021-06-09
913,087741,元石油國票09購02,0,0,0,0,0,0,0,0,0,168000,0,0,0,181000,13000,168000,168000,2021-06-09
914,06545P,聯詠富邦0B售02,0,0,0,0,0,0,0,0,0,168000,0,0,0,182000,14000,168000,168000,2021-06-09
915,3031,佰鴻,225000,57000,168000,0,0,0,0,0,0,0,0,0,0,0,0,0,168000,2021-06-09
916,2393,億光,1502000,1200447,301553,0,0,0,0,0,0,-133822,115,396,-281,29950,163491,-133541,167731,2021-06-09
917,034746,群創元大0B購11,0,0,0,0,0,0,0,0,0,167000,0,0,0,218000,51000,167000,167000,2021-06-09
918,033584,台橡凱基12購02,0,0,0,0,0,0,0,0,0,166000,0,0,0,166000,0,166000,166000,2021-06-09
919,034873,中鋼中信0B購05,0,0,0,0,0,0,0,0,0,166000,0,0,0,219000,53000,166000,166000,2021-06-09
920,035461,奇鋐國票0C購01,0,0,0,0,0,0,0,0,0,166000,0,0,0,171000,5000,166000,166000,2021-06-09
921,076067,和大元富0B購01,0,0,0,0,0,0,0,0,0,166000,0,0,0,176000,10000,166000,166000,2021-06-09
922,087088,友達元富09購07,0,0,0,0,0,0,0,0,0,165000,0,0,0,165000,0,165000,165000,2021-06-09
923,00656R,國泰中國A50反1,0,0,0,0,0,0,0,0,0,165000,0,0,0,165000,0,165000,165000,2021-06-09
924,030617,東森元大0A購01,10000,0,10000,0,0,0,0,0,0,155000,0,0,0,155000,0,155000,165000,2021-06-09
925,035515,金像電永豐0B購01,0,0,0,0,0,0,0,0,0,165000,0,0,0,188000,23000,165000,165000,2021-06-09
926,06575P,儒鴻元大09售02,0,0,0,0,0,0,0,0,0,165000,0,0,0,241000,76000,165000,165000,2021-06-09
927,079091,美食統一08購01,0,0,0,0,0,0,0,0,0,165000,0,0,0,165000,0,165000,165000,2021-06-09
928,086058,光罩統一0A購02,0,0,0,0,0,0,0,0,0,164000,0,0,0,164000,0,164000,164000,2021-06-09
929,031909,宏碁永豐0A購01,0,0,0,0,0,0,0,0,0,164000,0,0,0,334000,170000,164000,164000,2021-06-09
930,036449,聯陽元富13購01,0,0,0,0,0,0,0,0,0,164000,0,0,0,370000,206000,164000,164000,2021-06-09
931,086405,義隆統一0B購01,0,0,0,0,0,0,0,0,0,163000,0,0,0,163000,0,163000,163000,2021-06-09
932,03489B,臺股指元大06熊19,0,0,0,0,0,0,0,0,0,163000,0,0,0,174000,11000,163000,163000,2021-06-09
933,083045,鴻海日盛0A購02,0,0,0,0,0,0,0,0,0,163000,0,0,0,300000,137000,163000,163000,2021-06-09
934,083410,華泰永豐07購02,0,0,0,0,0,0,0,0,0,163000,0,0,0,178000,15000,163000,163000,2021-06-09
935,089508,台積電元大0A購02,0,0,0,0,0,0,0,0,0,163000,0,0,0,200000,37000,163000,163000,2021-06-09
936,089395,聯電凱基0A購05,0,0,0,0,0,0,0,0,0,163000,0,0,0,322000,159000,163000,163000,2021-06-09
937,085751,玉晶光永豐08購04,0,0,0,0,0,0,0,0,0,162000,0,0,0,170000,8000,162000,162000,2021-06-09
938,088809,華碩元大09購04,0,0,0,0,0,0,0,0,0,162000,0,0,0,209000,47000,162000,162000,2021-06-09
939,033260,嘉澤元大12購01,0,0,0,0,0,0,0,0,0,162000,0,0,0,364000,202000,162000,162000,2021-06-09
940,035495,友達國泰12購01,0,0,0,0,0,0,0,0,0,162000,0,0,0,182000,20000,162000,162000,2021-06-09
941,080949,東森群益07購01,0,0,0,0,0,0,0,0,0,162000,0,0,0,249000,87000,162000,162000,2021-06-09
942,072582,智易元富07購02,0,0,0,0,0,0,0,0,0,162000,0,0,0,162000,0,162000,162000,2021-06-09
943,086458,義隆群益0B購01,0,0,0,0,0,0,0,0,0,161000,0,0,0,172000,11000,161000,161000,2021-06-09
944,035976,惠特元大0C購01,0,0,0,0,0,0,0,0,0,161000,0,0,0,194000,33000,161000,161000,2021-06-09
945,035351,榮運國泰11購01,0,0,0,0,0,0,0,0,0,161000,0,0,0,241000,80000,161000,161000,2021-06-09
946,082632,同欣電國泰09購01,0,0,0,0,0,0,0,0,0,161000,0,0,0,289000,128000,161000,161000,2021-06-09
947,085833,玉晶光群益09購02,0,0,0,0,0,0,0,0,0,160000,0,0,0,168000,8000,160000,160000,2021-06-09
948,086274,南茂永豐09購01,0,0,0,0,0,0,0,0,0,160000,0,0,0,402000,242000,160000,160000,2021-06-09
949,032126,中鋼凱基12購02,0,0,0,0,0,0,0,0,0,160000,0,0,0,205000,45000,160000,160000,2021-06-09
950,036190,友達統一0C購09,0,0,0,0,0,0,0,0,0,160000,0,0,0,160000,0,160000,160000,2021-06-09
951,031312,A50正2元大0A購04,0,0,0,0,0,0,0,0,0,160000,0,0,0,160000,0,160000,160000,2021-06-09
952,034686,允強群益0B購01,0,0,0,0,0,0,0,0,0,160000,0,0,0,165000,5000,160000,160000,2021-06-09
953,031567,中鋼凱基0A購03,0,0,0,0,0,0,0,0,0,159000,0,0,0,660000,501000,159000,159000,2021-06-09
954,030187,上証2X凱基12購01,0,0,0,0,0,0,0,0,0,159000,0,0,0,179000,20000,159000,159000,2021-06-09
955,032144,長榮凱基0B購09,0,0,0,0,0,0,0,0,0,159000,0,0,0,159000,0,159000,159000,2021-06-09
956,033946,台橡國票0C購02,0,0,0,0,0,0,0,0,0,159000,0,0,0,159000,0,159000,159000,2021-06-09
957,089664,國喬元大09購05,0,0,0,0,0,0,0,0,0,159000,0,0,0,159000,0,159000,159000,2021-06-09
958,087724,滬深2X元富0C購01,0,0,0,0,0,0,0,0,0,158000,0,0,0,158000,0,158000,158000,2021-06-09
959,031695,中石化永豐0A購02,0,0,0,0,0,0,0,0,0,158000,0,0,0,204000,46000,158000,158000,2021-06-09
960,035736,精英國票0C購01,0,0,0,0,0,0,0,0,0,158000,0,0,0,158000,0,158000,158000,2021-06-09
961,089513,圓剛元大09購01,0,0,0,0,0,0,0,0,0,158000,0,0,0,163000,5000,158000,158000,2021-06-09
962,087758,國巨富邦0A購01,0,0,0,0,0,0,0,0,0,157000,0,0,0,279000,122000,157000,157000,2021-06-09
963,087093,華夏元大09購03,0,0,0,0,0,0,0,0,0,157000,0,0,0,164000,7000,157000,157000,2021-06-09
964,087229,南電凱基09購08,0,0,0,0,0,0,0,0,0,157000,0,0,0,157000,0,157000,157000,2021-06-09
965,035469,日月光國票0C購02,0,0,0,0,0,0,0,0,0,157000,0,0,0,167000,10000,157000,157000,2021-06-09
966,079263,和碩元大06購03,0,0,0,0,0,0,0,0,0,157000,0,0,0,297000,140000,157000,157000,2021-06-09
967,088618,創意永豐09購02,0,0,0,0,0,0,0,0,0,156000,0,0,0,182000,26000,156000,156000,2021-06-09
968,033493,京元電統一11購01,0,0,0,0,0,0,0,0,0,156000,0,0,0,384000,228000,156000,156000,2021-06-09
969,035634,中鋼富邦13購03,0,0,0,0,0,0,0,0,0,156000,0,0,0,308000,152000,156000,156000,2021-06-09
970,1809,中釉,772000,616000,156000,0,0,0,0,0,0,0,0,0,0,0,0,0,156000,2021-06-09
971,4934,太極,213000,57000,156000,0,0,0,0,0,0,0,0,0,0,0,0,0,156000,2021-06-09
972,087035,大成鋼凱基13購01,0,0,0,0,0,0,0,0,0,155000,0,0,0,155000,0,155000,155000,2021-06-09
973,033586,榮運凱基12購01,0,0,0,0,0,0,0,0,0,155000,0,0,0,287000,132000,155000,155000,2021-06-09
974,032459,世紀鋼元大0C購03,0,0,0,0,0,0,0,0,0,155000,0,0,0,155000,0,155000,155000,2021-06-09
975,035681,上証2X凱基12購02,0,0,0,0,0,0,0,0,0,155000,0,0,0,170000,15000,155000,155000,2021-06-09
976,033936,訊芯元大0C購01,0,0,0,0,0,0,0,0,0,155000,0,0,0,165000,10000,155000,155000,2021-06-09
977,034374,大亞元大12購01,0,0,0,0,0,0,0,0,0,155000,0,0,0,155000,0,155000,155000,2021-06-09
978,080906,聯電凱基0B購01,0,0,0,0,0,0,0,0,0,155000,0,0,0,200000,45000,155000,155000,2021-06-09
979,078904,同欣電元大07購02,0,0,0,0,0,0,0,0,0,155000,0,0,0,155000,0,155000,155000,2021-06-09
980,033151,彩晶元大0B購05,0,0,0,0,0,0,0,0,0,154000,0,0,0,569000,415000,154000,154000,2021-06-09
981,036478,長榮航元大0C購06,0,0,0,0,0,0,0,0,0,154000,0,0,0,174000,20000,154000,154000,2021-06-09
982,035430,萬海元大0C購09,0,0,0,0,0,0,0,0,0,154000,0,0,0,204000,50000,154000,154000,2021-06-09
983,087279,岱宇元大09購01,0,0,0,0,0,0,0,0,0,153000,0,0,0,302000,149000,153000,153000,2021-06-09
984,087446,國喬群益09購02,0,0,0,0,0,0,0,0,0,153000,0,0,0,219000,66000,153000,153000,2021-06-09
985,033561,中纖永豐0B購02,0,0,0,0,0,0,0,0,0,153000,0,0,0,153000,0,153000,153000,2021-06-09
986,05845P,臺股指元大0A售12,0,0,0,0,0,0,0,0,0,153000,0,0,0,153000,0,153000,153000,2021-06-09
987,089151,南茂元大09購03,0,0,0,0,0,0,0,0,0,153000,0,0,0,217000,64000,153000,153000,2021-06-09
988,087404,緯創元大09購03,0,0,0,0,0,0,0,0,0,152000,0,0,0,167000,15000,152000,152000,2021-06-09
989,086439,南電中信0A購03,0,0,0,0,0,0,0,0,0,152000,0,0,0,187000,35000,152000,152000,2021-06-09
990,088857,矽統永豐09購02,0,0,0,0,0,0,0,0,0,152000,0,0,0,160000,8000,152000,152000,2021-06-09
991,086385,玉晶光國票0A購06,0,0,0,0,0,0,0,0,0,152000,0,0,0,152000,0,152000,152000,2021-06-09
992,031155,世紀鋼兆豐0B購01,0,0,0,0,0,0,0,0,0,152000,0,0,0,152000,0,152000,152000,2021-06-09
993,081907,金像電凱基08購01,0,0,0,0,0,0,0,0,0,152000,0,0,0,275000,123000,152000,152000,2021-06-09
994,8011,台通,280000,128000,152000,0,0,0,0,0,0,0,0,0,0,0,0,0,152000,2021-06-09
995,084870,奇鋐元大08購03,0,0,0,0,0,0,0,0,0,151000,0,0,0,164000,13000,151000,151000,2021-06-09
996,032874,國巨凱基0A購05,0,0,0,0,0,0,0,0,0,151000,0,0,0,166000,15000,151000,151000,2021-06-09
997,034776,國巨富邦0C購04,0,0,0,0,0,0,0,0,0,151000,0,0,0,161000,10000,151000,151000,2021-06-09
998,07104P,臺股指凱基0B售18,0,0,0,0,0,0,0,0,0,151000,0,0,0,166000,15000,151000,151000,2021-06-09
999,089917,晶碩凱基0C購01,0,0,0,0,0,0,0,0,0,151000,0,0,0,199000,48000,151000,151000,2021-06-09
1000,083473,大立光統一09購09,0,0,0,0,0,0,0,0,0,150000,0,0,0,150000,0,150000,150000,2021-06-09
1001,085224,聯電元大0C購01,0,0,0,0,0,0,0,0,0,150000,0,0,0,150000,0,150000,150000,2021-06-09
1002,087314,東聯永豐09購01,0,0,0,0,0,0,0,0,0,150000,0,0,0,150000,0,150000,150000,2021-06-09
1003,05651P,健策群益07售01,0,0,0,0,0,0,0,0,0,150000,0,0,0,150000,0,150000,150000,2021-06-09
1004,030991,申豐元大0C購01,0,0,0,0,0,0,0,0,0,150000,0,0,0,150000,0,150000,150000,2021-06-09
1005,031365,南亞永豐0A購01,0,0,0,0,0,0,0,0,0,150000,0,0,0,200000,50000,150000,150000,2021-06-09
1006,033691,玉晶光元大13購02,0,0,0,0,0,0,0,0,0,150000,0,0,0,200000,50000,150000,150000,2021-06-09
1007,034995,中鋼元大0B購11,0,0,0,0,0,0,0,0,0,150000,0,0,0,150000,0,150000,150000,2021-06-09
1008,034184,中鋼元大0C購02,0,0,0,0,0,0,0,0,0,150000,0,0,0,150000,0,150000,150000,2021-06-09
1009,034677,玉晶光凱基0B購04,0,0,0,0,0,0,0,0,0,150000,0,0,0,339000,189000,150000,150000,2021-06-09
1010,036094,創意元大11購01,0,0,0,0,0,0,0,0,0,150000,0,0,0,188000,38000,150000,150000,2021-06-09
1011,034325,中鋼群益0C購06,0,0,0,0,0,0,0,0,0,150000,0,0,0,150000,0,150000,150000,2021-06-09
1012,07141P,鴻海群益0B售13,0,0,0,0,0,0,0,0,0,150000,0,0,0,250000,100000,150000,150000,2021-06-09
1013,076849,滬深2X凱基06購03,0,0,0,0,0,0,0,0,0,150000,0,0,0,150000,0,150000,150000,2021-06-09
1014,081798,華榮凱基07購01,0,0,0,0,0,0,0,0,0,150000,0,0,0,150000,0,150000,150000,2021-06-09
1015,082448,恆大元大07購02,0,0,0,0,0,0,0,0,0,150000,0,0,0,150000,0,150000,150000,2021-06-09
1016,082989,嘉澤元大07購03,0,0,0,0,0,0,0,0,0,150000,0,0,0,160000,10000,150000,150000,2021-06-09
1017,083309,欣興元大07購13,0,0,0,0,0,0,0,0,0,150000,0,0,0,150000,0,150000,150000,2021-06-09
1018,080563,訊芯富邦07購01,0,0,0,0,0,0,0,0,0,150000,0,0,0,150000,0,150000,150000,2021-06-09
1019,080568,旺宏永豐06購03,0,0,0,0,0,0,0,0,0,150000,0,0,0,150000,0,150000,150000,2021-06-09
1020,089996,立積國泰11購01,0,0,0,0,0,0,0,0,0,150000,0,0,0,160000,10000,150000,150000,2021-06-09
1021,089967,宏碁元大0A購01,0,0,0,0,0,0,0,0,0,150000,0,0,0,150000,0,150000,150000,2021-06-09
1022,087029,日月光麥證0A購01,0,0,0,149000,0,149000,0,0,0,149000,0,0,0,149000,0,149000,149000,2021-06-09
1023,084288,凱美永豐07購05,0,0,0,0,0,0,0,0,0,149000,0,0,0,149000,0,149000,149000,2021-06-09
1024,030063,A50正2群益0A購01,0,0,0,0,0,0,0,0,0,149000,0,0,0,160000,11000,149000,149000,2021-06-09
1025,080396,群光元大09購01,0,0,0,0,0,0,0,0,0,149000,0,0,0,261000,112000,149000,149000,2021-06-09
1026,088864,玉晶光永豐09購03,0,0,0,0,0,0,0,0,0,148000,0,0,0,158000,10000,148000,148000,2021-06-09
1027,030275,申豐統一0C購01,0,0,0,0,0,0,0,0,0,148000,0,0,0,190000,42000,148000,148000,2021-06-09
1028,034698,群創群益0B購10,0,0,0,0,0,0,0,0,0,148000,0,0,0,201000,53000,148000,148000,2021-06-09
1029,2495,普安,845000,698000,147000,0,0,0,0,0,0,8,22,14,8,0,0,0,147008,2021-06-09
1030,036164,寶成元大11購01,0,0,0,0,0,0,0,0,0,147000,0,0,0,167000,20000,147000,147000,2021-06-09
1031,5519,隆大,206000,59000,147000,0,0,0,0,0,0,0,0,0,0,0,0,0,147000,2021-06-09
1032,00670L,富邦NASDAQ正2,155000,2000,153000,0,0,0,0,0,0,-6948,0,0,0,46052,53000,-6948,146052,2021-06-09
1033,05170P,嘉晶元富0C售02,0,0,0,0,0,0,0,0,0,146000,0,0,0,150000,4000,146000,146000,2021-06-09
1034,1732,毛寶,1005000,859000,146000,0,0,0,0,0,0,0,0,0,0,0,0,0,146000,2021-06-09
1035,089406,聯發科凱基09購10,0,0,0,0,0,0,0,0,0,146000,0,0,0,258000,112000,146000,146000,2021-06-09
1036,087258,強茂國票09購01,0,0,0,0,0,0,0,0,0,145000,0,0,0,145000,0,145000,145000,2021-06-09
1037,05762P,台積電凱基0A售05,0,0,0,0,0,0,0,0,0,145000,0,0,0,150000,5000,145000,145000,2021-06-09
1038,079086,新光金群益06購01,0,0,0,0,0,0,0,0,0,145000,0,0,0,145000,0,145000,145000,2021-06-09
1039,082867,日月光中信07購02,0,0,0,0,0,0,0,0,0,145000,0,0,0,145000,0,145000,145000,2021-06-09
1040,06592P,臺股指凱基0C售14,0,0,0,0,0,0,0,0,0,145000,0,0,0,150000,5000,145000,145000,2021-06-09
1041,083908,冠德元大07購01,0,0,0,0,0,0,0,0,0,144000,0,0,0,150000,6000,144000,144000,2021-06-09
1042,033076,健策凱基0A購01,0,0,0,0,0,0,0,0,0,144000,0,0,0,206000,62000,144000,144000,2021-06-09
1043,035426,京元電元大11購02,0,0,0,0,0,0,0,0,0,144000,0,0,0,144000,0,144000,144000,2021-06-09
1044,06147P,臺股指麥證07售10,0,0,0,174000,30000,144000,0,0,0,144000,0,0,0,174000,30000,144000,144000,2021-06-09
1045,07120P,愛普元大0B售01,0,0,0,0,0,0,0,0,0,144000,0,0,0,377000,233000,144000,144000,2021-06-09
1046,076563,國巨富邦07購02,0,0,0,0,0,0,0,0,0,144000,0,0,0,576000,432000,144000,144000,2021-06-09
1047,080739,長榮國票07購11,0,0,0,0,0,0,0,0,0,144000,0,0,0,153000,9000,144000,144000,2021-06-09
1048,081138,聯電凱基09購03,0,0,0,0,0,0,0,0,0,144000,0,0,0,244000,100000,144000,144000,2021-06-09
1049,086467,義隆兆豐09購01,0,0,0,0,0,0,0,0,0,143000,0,0,0,167000,24000,143000,143000,2021-06-09
1050,035747,滬深2X元富13購01,0,0,0,0,0,0,0,0,0,143000,0,0,0,353000,210000,143000,143000,2021-06-09
1051,035983,燁輝國票11購01,0,0,0,0,0,0,0,0,0,143000,0,0,0,143000,0,143000,143000,2021-06-09
1052,07100P,長榮凱基0B售13,0,0,0,0,0,0,0,0,0,143000,0,0,0,143000,0,143000,143000,2021-06-09
1053,2412,中華電,1319103,1148100,171003,0,0,0,0,7000,-7000,-22000,0,22000,-22000,0,0,0,142003,2021-06-09
1054,032915,大亞國票0A購01,0,0,0,0,0,0,0,0,0,142000,0,0,0,282000,140000,142000,142000,2021-06-09
1055,075944,台積電富邦06購03,0,0,0,0,0,0,0,0,0,142000,0,0,0,142000,0,142000,142000,2021-06-09
1056,087445,華夏群益0A購01,0,0,0,0,0,0,0,0,0,141000,0,0,0,141000,0,141000,141000,2021-06-09
1057,088548,智易群益09購01,0,0,0,0,0,0,0,0,0,141000,0,0,0,164000,23000,141000,141000,2021-06-09
1058,05947P,臺股指凱基07售25,0,0,0,0,0,0,0,0,0,141000,0,0,0,141000,0,141000,141000,2021-06-09
1059,034593,中鋼統一0C購13,0,0,0,0,0,0,0,0,0,141000,0,0,0,141000,0,141000,141000,2021-06-09
1060,078925,全新永豐06購01,0,0,0,0,0,0,0,0,0,141000,0,0,0,141000,0,141000,141000,2021-06-09
1061,084858,台積電元大08購15,0,0,0,0,0,0,0,0,0,140000,0,0,0,140000,0,140000,140000,2021-06-09
1062,086427,強茂富邦0B購01,0,0,0,0,0,0,0,0,0,140000,0,0,0,140000,0,140000,140000,2021-06-09
1063,085897,日月光國票0A購02,0,0,0,0,0,0,0,0,0,140000,0,0,0,145000,5000,140000,140000,2021-06-09
1064,034780,群創富邦0C購01,0,0,0,0,0,0,0,0,0,140000,0,0,0,140000,0,140000,140000,2021-06-09
1065,036045,新唐元富0C購01,0,0,0,0,0,0,0,0,0,140000,0,0,0,201000,61000,140000,140000,2021-06-09
1066,081714,億光統一09購01,0,0,0,0,0,0,0,0,0,140000,0,0,0,224000,84000,140000,140000,2021-06-09
1067,5388,中磊,229000,93000,136000,0,0,0,0,0,0,4000,0,0,0,4000,0,4000,140000,2021-06-09
1068,086146,華泰元大09購01,0,0,0,0,0,0,0,0,0,139000,0,0,0,187000,48000,139000,139000,2021-06-09
1069,088722,瑞軒凱基0A購01,0,0,0,0,0,0,0,0,0,139000,0,0,0,189000,50000,139000,139000,2021-06-09
1070,087949,台積電元富09購07,0,0,0,0,0,0,0,0,0,139000,0,0,0,142000,3000,139000,139000,2021-06-09
1071,2451,創見,708000,567000,141000,0,0,0,0,0,0,-2000,0,2000,-2000,0,0,0,139000,2021-06-09
1072,036246,金像電凱基0C購03,0,0,0,0,0,0,0,0,0,138000,0,0,0,161000,23000,138000,138000,2021-06-09
1073,079679,創意元大06購04,0,0,0,0,0,0,0,0,0,138000,0,0,0,138000,0,138000,138000,2021-06-09
1074,088382,臺股指國票0A購12,0,0,0,0,0,0,0,0,0,137000,0,0,0,159000,22000,137000,137000,2021-06-09
1075,035233,國巨永豐0B購01,0,0,0,0,0,0,0,0,0,137000,0,0,0,137000,0,137000,137000,2021-06-09
1076,033944,中鋼國票0C購01,0,0,0,0,0,0,0,0,0,137000,0,0,0,168000,31000,137000,137000,2021-06-09
1077,2049,上銀,904000,909530,-5530,0,0,0,140000,0,140000,2395,1395,2000,-605,4000,1000,3000,136865,2021-06-09
1078,088588,瑞軒統一09購01,0,0,0,0,0,0,0,0,0,136000,0,0,0,216000,80000,136000,136000,2021-06-09
1079,084410,台郡國票09購01,0,0,0,0,0,0,0,0,0,136000,0,0,0,136000,0,136000,136000,2021-06-09
1080,032193,可成群益0C購01,0,0,0,0,0,0,0,0,0,136000,0,0,0,204000,68000,136000,136000,2021-06-09
1081,035415,大亞元大0B購06,0,0,0,0,0,0,0,0,0,136000,0,0,0,136000,0,136000,136000,2021-06-09
1082,034381,允強元大0C購02,0,0,0,0,0,0,0,0,0,136000,0,0,0,151000,15000,136000,136000,2021-06-09
1083,033768,大成鋼群益0C購04,0,0,0,0,0,0,0,0,0,136000,0,0,0,181000,45000,136000,136000,2021-06-09
1084,06999P,華邦電元大0B售02,0,0,0,0,0,0,0,0,0,136000,0,0,0,169000,33000,136000,136000,2021-06-09
1085,036229,台橡永豐0C購01,0,0,0,0,0,0,0,0,0,135000,0,0,0,135000,0,135000,135000,2021-06-09
1086,036241,永豐餘凱基11購01,0,0,0,0,0,0,0,0,0,135000,0,0,0,366000,231000,135000,135000,2021-06-09
1087,032299,正新永豐0A購02,0,0,0,0,0,0,0,0,0,135000,0,0,0,135000,0,135000,135000,2021-06-09
1088,032698,彩晶永豐0A購05,0,0,0,0,0,0,0,0,0,135000,0,0,0,135000,0,135000,135000,2021-06-09
1089,034149,華新科凱基0C購01,0,0,0,0,0,0,0,0,0,135000,0,0,0,140000,5000,135000,135000,2021-06-09
1090,035533,金像電兆豐0C購02,0,0,0,0,0,0,0,0,0,135000,0,0,0,208000,73000,135000,135000,2021-06-09
1091,035831,聯電元大0B購07,0,0,0,0,0,0,0,0,0,135000,0,0,0,151000,16000,135000,135000,2021-06-09
1092,076184,創意統一07購03,0,0,0,0,0,0,0,0,0,135000,0,0,0,235000,100000,135000,135000,2021-06-09
1093,2371,大同,1239000,1097000,142000,0,0,0,0,0,0,-7459,541,8000,-7459,0,0,0,134541,2021-06-09
1094,085902,國巨富邦09購02,0,0,0,0,0,0,0,0,0,134000,0,0,0,134000,0,134000,134000,2021-06-09
1095,035215,聯電第一15購03,0,0,0,0,0,0,0,0,0,134000,0,0,0,204000,70000,134000,134000,2021-06-09
1096,035083,華新凱基11購01,0,0,0,0,0,0,0,0,0,134000,0,0,0,145000,11000,134000,134000,2021-06-09
1097,033619,國喬元富0B購03,0,0,0,0,0,0,0,0,0,134000,0,0,0,134000,0,134000,134000,2021-06-09
1098,088961,長榮航國票0B購03,0,0,0,0,0,0,0,0,0,133000,0,0,0,314000,181000,133000,133000,2021-06-09
1099,031046,元石油元大0B購04,0,0,0,0,0,0,0,0,0,133000,0,0,0,140000,7000,133000,133000,2021-06-09
1100,034620,宏碁元富12購01,0,0,0,0,0,0,0,0,0,133000,0,0,0,133000,0,133000,133000,2021-06-09
1101,084818,乙盛國票09購01,0,0,0,0,0,0,0,0,0,132000,0,0,0,132000,0,132000,132000,2021-06-09
1102,034594,燁輝統一0B購03,0,0,0,0,0,0,0,0,0,132000,0,0,0,132000,0,132000,132000,2021-06-09
1103,034925,聯發科富邦0C購07,0,0,0,0,0,0,0,0,0,132000,0,0,0,145000,13000,132000,132000,2021-06-09
1104,035366,萬海統一11購05,0,0,0,0,0,0,0,0,0,132000,0,0,0,287000,155000,132000,132000,2021-06-09
1105,078394,同欣電富邦07購01,0,0,0,0,0,0,0,0,0,132000,0,0,0,132000,0,132000,132000,2021-06-09
1106,082977,億光元大08購01,0,0,0,0,0,0,0,0,0,132000,0,0,0,139000,7000,132000,132000,2021-06-09
1107,089584,晶碩永豐09購05,0,0,0,0,0,0,0,0,0,132000,0,0,0,132000,0,132000,132000,2021-06-09
1108,2439,美律,195000,60000,135000,0,0,0,0,0,0,-3859,0,859,-859,0,3000,-3000,131141,2021-06-09
1109,088404,國巨永豐09購04,0,0,0,0,0,0,0,0,0,131000,0,0,0,131000,0,131000,131000,2021-06-09
1110,087729,榮成元富09購01,0,0,0,0,0,0,0,0,0,131000,0,0,0,131000,0,131000,131000,2021-06-09
1111,030607,致茂元大0A購01,0,0,0,0,0,0,0,0,0,131000,0,0,0,201000,70000,131000,131000,2021-06-09
1112,031561,T50反1凱基11購03,10000,0,10000,0,0,0,0,0,0,121000,0,0,0,141000,20000,121000,131000,2021-06-09
1113,035689,群創凱基13購02,0,0,0,0,0,0,0,0,0,131000,0,0,0,131000,0,131000,131000,2021-06-09
1114,034112,聯發科群益0B購08,0,0,0,0,0,0,0,0,0,131000,0,0,0,181000,50000,131000,131000,2021-06-09
1115,1773,勝一,300000,238000,62000,0,0,0,0,0,0,69000,74000,0,74000,23000,28000,-5000,131000,2021-06-09
1116,088867,立積永豐09購01,0,0,0,0,0,0,0,0,0,130000,0,0,0,130000,0,130000,130000,2021-06-09
1117,086466,聯發科兆豐09購01,0,0,0,0,0,0,0,0,0,130000,0,0,0,130000,0,130000,130000,2021-06-09
1118,084281,全新中信08購02,0,0,0,0,0,0,0,0,0,130000,0,0,0,130000,0,130000,130000,2021-06-09
1119,085810,元石油群益08購02,0,0,0,0,0,0,0,0,0,130000,0,0,0,130000,0,130000,130000,2021-06-09
1120,030711,貿聯群益0A購01,0,0,0,0,0,0,0,0,0,130000,0,0,0,367000,237000,130000,130000,2021-06-09
1121,030040,光寶科元大0A購01,0,0,0,0,0,0,0,0,0,130000,0,0,0,130000,0,130000,130000,2021-06-09
1122,035564,愛普統一14購01,0,0,0,0,0,0,0,0,0,130000,0,0,0,150000,20000,130000,130000,2021-06-09
1123,036084,燁輝元大12購02,0,0,0,0,0,0,0,0,0,130000,0,0,0,130000,0,130000,130000,2021-06-09
1124,081873,健策麥證07購01,0,0,0,233000,105000,128000,0,0,0,130000,0,0,0,236000,106000,130000,130000,2021-06-09
1125,081953,正文統一09購01,0,0,0,0,0,0,0,0,0,130000,0,0,0,130000,0,130000,130000,2021-06-09
1126,080459,群光凱基09購01,0,0,0,0,0,0,0,0,0,130000,0,0,0,140000,10000,130000,130000,2021-06-09
1127,078501,彩晶國票08購03,0,0,0,0,0,0,0,0,0,130000,0,0,0,130000,0,130000,130000,2021-06-09
1128,06870P,臺股指凱基0A售13,0,0,0,0,0,0,0,0,0,130000,0,0,0,165000,35000,130000,130000,2021-06-09
1129,066966,國巨元富07購07,0,0,0,0,0,0,0,0,0,130000,0,0,0,130000,0,130000,130000,2021-06-09
1130,087358,滬深2X兆豐0B購01,0,0,0,0,0,0,0,0,0,129000,0,0,0,141000,12000,129000,129000,2021-06-09
1131,087810,新光金兆豐09購01,0,0,0,0,0,0,0,0,0,129000,0,0,0,129000,0,129000,129000,2021-06-09
1132,05417P,臺股指國票0B售02,0,0,0,0,0,0,0,0,0,129000,0,0,0,159000,30000,129000,129000,2021-06-09
1133,035707,大成鋼元大0B購16,0,0,0,0,0,0,0,0,0,129000,0,0,0,143000,14000,129000,129000,2021-06-09
1134,035996,燁輝永豐0C購01,0,0,0,0,0,0,0,0,0,129000,0,0,0,129000,0,129000,129000,2021-06-09
1135,033620,華新元富0B購01,0,0,0,0,0,0,0,0,0,129000,0,0,0,129000,0,129000,129000,2021-06-09
1136,3092,鴻碩,217000,75000,142000,0,0,0,0,0,0,-13000,0,0,0,6000,19000,-13000,129000,2021-06-09
1137,034737,長榮元大0B購12,0,0,0,0,0,0,0,0,0,128000,0,0,0,128000,0,128000,128000,2021-06-09
1138,035804,台船凱基12購01,0,0,0,0,0,0,0,0,0,128000,0,0,0,138000,10000,128000,128000,2021-06-09
1139,036400,榮成永豐0C購01,0,0,0,0,0,0,0,0,0,128000,0,0,0,128000,0,128000,128000,2021-06-09
1140,07250P,愛普國票0B售03,0,0,0,0,0,0,0,0,0,128000,0,0,0,193000,65000,128000,128000,2021-06-09
1141,083297,強茂元大07購04,0,0,0,0,0,0,0,0,0,128000,0,0,0,130000,2000,128000,128000,2021-06-09
1142,6168,宏齊,1638000,1510000,128000,0,0,0,0,0,0,0,0,0,0,0,0,0,128000,2021-06-09
1143,087782,國巨永豐09購03,0,0,0,0,0,0,0,0,0,127000,0,0,0,127000,0,127000,127000,2021-06-09
1144,030940,智易群益0B購01,0,0,0,0,0,0,0,0,0,127000,0,0,0,127000,0,127000,127000,2021-06-09
1145,034183,中鋼元大0B購05,0,0,0,0,0,0,0,0,0,127000,0,0,0,127000,0,127000,127000,2021-06-09
1146,07077P,台灣50凱基0C售07,0,0,0,0,0,0,0,0,0,127000,0,0,0,152000,25000,127000,127000,2021-06-09
1147,088253,中工富邦0A購01,0,0,0,0,0,0,0,0,0,126000,0,0,0,126000,0,126000,126000,2021-06-09
1148,086857,美德醫元大0A購01,0,0,0,0,0,0,0,0,0,126000,0,0,0,126000,0,126000,126000,2021-06-09
1149,085297,臺股指凱基08購15,0,0,0,0,0,0,0,0,0,126000,0,0,0,126000,0,126000,126000,2021-06-09
1150,032869,臺指反凱基13購02,0,0,0,0,0,0,0,0,0,126000,0,0,0,132000,6000,126000,126000,2021-06-09
1151,034647,國喬國泰11購01,0,0,0,0,0,0,0,0,0,126000,0,0,0,336000,210000,126000,126000,2021-06-09
1152,06069P,臺股指凱基07售31,0,0,0,0,0,0,0,0,0,126000,0,0,0,164000,38000,126000,126000,2021-06-09
1153,07035P,台積電凱基0B售12,0,0,0,0,0,0,0,0,0,126000,0,0,0,126000,0,126000,126000,2021-06-09
1154,071523,金像電元富09購01,0,0,0,0,0,0,0,0,0,126000,0,0,0,132000,6000,126000,126000,2021-06-09
1155,074783,和大統一06購02,0,0,0,0,0,0,0,0,0,126000,0,0,0,126000,0,126000,126000,2021-06-09
1156,088814,瑞軒元大0A購01,0,0,0,0,0,0,0,0,0,125000,0,0,0,125000,0,125000,125000,2021-06-09
1157,036284,國巨元大0C購15,0,0,0,0,0,0,0,0,0,125000,0,0,0,252000,127000,125000,125000,2021-06-09
1158,035416,大亞元大0B購07,0,0,0,0,0,0,0,0,0,125000,0,0,0,125000,0,125000,125000,2021-06-09
1159,035287,華碩國票0B購01,0,0,0,0,0,0,0,0,0,125000,0,0,0,126000,1000,125000,125000,2021-06-09
1160,035872,台郡元富13購01,0,0,0,0,0,0,0,0,0,125000,0,0,0,135000,10000,125000,125000,2021-06-09
1161,033897,大成鋼統一13購01,0,0,0,0,0,0,0,0,0,125000,0,0,0,533000,408000,125000,125000,2021-06-09
1162,06748P,立積元大0A售03,0,0,0,0,0,0,0,0,0,125000,0,0,0,125000,0,125000,125000,2021-06-09
1163,032605,嘉晶元大0C購03,0,0,0,0,0,0,0,0,0,124000,0,0,0,150000,26000,124000,124000,2021-06-09
1164,035905,奇鋐群益0C購01,0,0,0,0,0,0,0,0,0,124000,0,0,0,273000,149000,124000,124000,2021-06-09
1165,034907,廣達元大11購01,0,0,0,0,0,0,0,0,0,124000,0,0,0,218000,94000,124000,124000,2021-06-09
1166,080141,中石化凱基07購02,0,0,0,0,0,0,0,0,0,124000,0,0,0,126000,2000,124000,124000,2021-06-09
1167,086516,元石油凱基0B購01,0,0,0,0,0,0,0,0,0,123000,0,0,0,130000,7000,123000,123000,2021-06-09
1168,030121,正隆凱基12購01,0,0,0,0,0,0,0,0,0,123000,0,0,0,127000,4000,123000,123000,2021-06-09
1169,036331,和大元富13購01,0,0,0,0,0,0,0,0,0,123000,0,0,0,133000,10000,123000,123000,2021-06-09
1170,033980,群創凱基11購03,0,0,0,0,0,0,0,0,0,123000,0,0,0,123000,0,123000,123000,2021-06-09
1171,080850,德律元富07購01,0,0,0,0,0,0,0,0,0,123000,0,0,0,123000,0,123000,123000,2021-06-09
1172,077815,滬深2X元大07購04,0,0,0,0,0,0,0,0,0,123000,0,0,0,123000,0,123000,123000,2021-06-09
1173,089703,台積電元富0C購24,0,0,0,0,0,0,0,0,0,123000,0,0,0,123000,0,123000,123000,2021-06-09
1174,00651R,FH香港反1,0,0,0,0,0,0,0,0,0,122000,0,0,0,212000,90000,122000,122000,2021-06-09
1175,032723,開發金元富11購01,0,0,0,0,0,0,0,0,0,122000,0,0,0,122000,0,122000,122000,2021-06-09
1176,033461,日月光群益0B購01,0,0,0,0,0,0,0,0,0,122000,0,0,0,122000,0,122000,122000,2021-06-09
1177,2855,統一證,1320000,1198000,122000,0,0,0,0,0,0,0,0,0,0,0,0,0,122000,2021-06-09
1178,030324,華新科麥證11購01,0,0,0,121000,0,121000,0,0,0,121000,0,0,0,121000,0,121000,121000,2021-06-09
1179,075706,華新科元富07購03,0,0,0,0,0,0,0,0,0,121000,0,0,0,121000,0,121000,121000,2021-06-09
1180,06672P,台灣50群益09售10,0,0,0,0,0,0,0,0,0,121000,0,0,0,285000,164000,121000,121000,2021-06-09
1181,07020P,臺股指國票0B售12,0,0,0,0,0,0,0,0,0,121000,0,0,0,122000,1000,121000,121000,2021-06-09
1182,070152,創意元富08購01,0,0,0,0,0,0,0,0,0,121000,0,0,0,180000,59000,121000,121000,2021-06-09
1183,080479,中興電元大09購01,0,0,0,0,0,0,0,0,0,121000,0,0,0,146000,25000,121000,121000,2021-06-09
1184,083038,可成中信07購02,0,0,0,0,0,0,0,0,0,121000,0,0,0,121000,0,121000,121000,2021-06-09
1185,086541,滬深2X元大09購05,0,0,0,0,0,0,0,0,0,120000,0,0,0,120000,0,120000,120000,2021-06-09
1186,086468,大立光兆豐09購01,0,0,0,0,0,0,0,0,0,120000,0,0,0,120000,0,120000,120000,2021-06-09
1187,085216,華通國票09購01,0,0,0,0,0,0,0,0,0,120000,0,0,0,120000,0,120000,120000,2021-06-09
1188,086176,日月光元大0C購02,0,0,0,0,0,0,0,0,0,120000,0,0,0,174000,54000,120000,120000,2021-06-09
1189,083456,台積電麥證0B購03,0,0,0,130000,10000,120000,0,0,0,120000,0,0,0,130000,10000,120000,120000,2021-06-09
1190,031218,萬海凱基0A購02,0,0,0,0,0,0,0,0,0,120000,0,0,0,120000,0,120000,120000,2021-06-09
1191,030909,長榮凱基13購02,0,0,0,0,0,0,0,0,0,120000,0,0,0,120000,0,120000,120000,2021-06-09
1192,030813,聯詠富邦0C購01,0,0,0,0,0,0,0,0,0,120000,0,0,0,120000,0,120000,120000,2021-06-09
1193,033115,T50反1元大12購02,0,0,0,0,0,0,0,0,0,120000,0,0,0,260000,140000,120000,120000,2021-06-09
1194,031797,金像電國票0B購01,0,0,0,0,0,0,0,0,0,120000,0,0,0,130000,10000,120000,120000,2021-06-09
1195,035288,華碩國票0C購01,0,0,0,0,0,0,0,0,0,120000,0,0,0,120000,0,120000,120000,2021-06-09
1196,05775P,台積電富邦09售05,0,0,0,0,0,0,0,0,0,120000,0,0,0,120000,0,120000,120000,2021-06-09
1197,035025,國巨凱基0B購09,0,0,0,0,0,0,0,0,0,120000,0,0,0,257000,137000,120000,120000,2021-06-09
1198,036030,順德統一12購01,0,0,0,0,0,0,0,0,0,120000,0,0,0,167000,47000,120000,120000,2021-06-09
1199,033676,燁輝元大11購01,0,0,0,0,0,0,0,0,0,120000,0,0,0,120000,0,120000,120000,2021-06-09
1200,034169,信邦永豐0B購01,0,0,0,0,0,0,0,0,0,120000,0,0,0,120000,0,120000,120000,2021-06-09
1201,034269,晶碩國票0C購01,0,0,0,0,0,0,0,0,0,120000,0,0,0,234000,114000,120000,120000,2021-06-09
1202,066969,可成元富07購01,0,0,0,0,0,0,0,0,0,120000,0,0,0,120000,0,120000,120000,2021-06-09
1203,06530P,臺股指群益09售05,0,0,0,0,0,0,0,0,0,120000,0,0,0,120000,0,120000,120000,2021-06-09
1204,075355,元石油國票08購01,0,0,0,0,0,0,0,0,0,120000,0,0,0,120000,0,120000,120000,2021-06-09
1205,073866,玉晶光國票06購06,0,0,0,0,0,0,0,0,0,120000,0,0,0,120000,0,120000,120000,2021-06-09
1206,078121,玉山金元富0C購01,0,0,0,0,0,0,0,0,0,120000,0,0,0,120000,0,120000,120000,2021-06-09
1207,087545,華夏元富0C購01,0,0,0,0,0,0,0,0,0,119000,0,0,0,164000,45000,119000,119000,2021-06-09
1208,030141,台勝科凱基14購01,0,0,0,0,0,0,0,0,0,119000,0,0,0,209000,90000,119000,119000,2021-06-09
1209,034116,聯詠群益11購01,0,0,0,0,0,0,0,0,0,119000,0,0,0,274000,155000,119000,119000,2021-06-09
1210,034665,中石化凱基0B購01,0,0,0,0,0,0,0,0,0,119000,0,0,0,119000,0,119000,119000,2021-06-09
1211,089472,美食國票0A購01,0,0,0,0,0,0,0,0,0,119000,0,0,0,119000,0,119000,119000,2021-06-09
1212,030918,南紡群益0A購03,0,0,0,0,0,0,0,0,0,118000,0,0,0,122000,4000,118000,118000,2021-06-09
1213,030921,春源群益0A購02,0,0,0,0,0,0,0,0,0,118000,0,0,0,118000,0,118000,118000,2021-06-09
1214,034982,大亞群益0B購04,0,0,0,0,0,0,0,0,0,118000,0,0,0,118000,0,118000,118000,2021-06-09
1215,033895,大成鋼統一0B購06,0,0,0,0,0,0,0,0,0,118000,0,0,0,131000,13000,118000,118000,2021-06-09
1216,033903,華新科統一11購02,0,0,0,0,0,0,0,0,0,118000,0,0,0,232000,114000,118000,118000,2021-06-09
1217,035624,凌陽國票0C購02,0,0,0,0,0,0,0,0,0,118000,0,0,0,246000,128000,118000,118000,2021-06-09
1218,034308,長榮航永豐0B購02,0,0,0,0,0,0,0,0,0,118000,0,0,0,145000,27000,118000,118000,2021-06-09
1219,07057P,友達元大0C售11,0,0,0,0,0,0,0,0,0,118000,0,0,0,189000,71000,118000,118000,2021-06-09
1220,089572,新纖永豐09購02,0,0,0,0,0,0,0,0,0,118000,0,0,0,118000,0,118000,118000,2021-06-09
1221,086581,欣興康和09購01,0,0,0,0,0,0,0,0,0,117000,0,0,0,117000,0,117000,117000,2021-06-09
1222,089003,國巨元大09購04,0,0,0,0,0,0,0,0,0,117000,0,0,0,117000,0,117000,117000,2021-06-09
1223,084499,台表科凱基0B購01,0,0,0,0,0,0,0,0,0,117000,0,0,0,161000,44000,117000,117000,2021-06-09
1224,085079,聯詠永豐08購01,0,0,0,0,0,0,0,0,0,117000,0,0,0,127000,10000,117000,117000,2021-06-09
1225,034323,台玻群益11購01,0,0,0,0,0,0,0,0,0,117000,0,0,0,151000,34000,117000,117000,2021-06-09
1226,036473,順德元大0C購01,0,0,0,0,0,0,0,0,0,117000,0,0,0,132000,15000,117000,117000,2021-06-09
1227,06940P,宏達電元大0A售04,0,0,0,0,0,0,0,0,0,117000,0,0,0,120000,3000,117000,117000,2021-06-09
1228,2301,光寶科,1704282,1709800,-5518,0,0,0,0,209000,-209000,330998,215000,8002,206998,134000,10000,124000,116480,2021-06-09
1229,030964,中鴻元大0A購04,0,0,0,0,0,0,0,0,0,116000,0,0,0,116000,0,116000,116000,2021-06-09
1230,032556,台船群益0B購01,0,0,0,0,0,0,0,0,0,116000,0,0,0,119000,3000,116000,116000,2021-06-09
1231,034557,國巨群益0B購03,0,0,0,0,0,0,0,0,0,116000,0,0,0,152000,36000,116000,116000,2021-06-09
1232,034267,健策國票0C購01,0,0,0,0,0,0,0,0,0,116000,0,0,0,238000,122000,116000,116000,2021-06-09
1233,07085P,臺股指凱基0B售12,0,0,0,0,0,0,0,0,0,116000,0,0,0,121000,5000,116000,116000,2021-06-09
1234,06768P,臺股指元大11售03,0,0,0,0,0,0,0,0,0,116000,0,0,0,119000,3000,116000,116000,2021-06-09
1235,4155,訊映,131000,15000,116000,0,0,0,0,0,0,0,0,0,0,0,0,0,116000,2021-06-09
1236,00882,中信中國高股息,190000,20000,170000,0,0,0,0,0,0,-54344,0,0,0,282000,336344,-54344,115656,2021-06-09
1237,032630,正新統一12購01,0,0,0,0,0,0,0,0,0,115000,0,0,0,115000,0,115000,115000,2021-06-09
1238,035796,長榮航永豐0B購03,0,0,0,0,0,0,0,0,0,115000,0,0,0,144000,29000,115000,115000,2021-06-09
1239,078976,聯電日盛06購01,0,0,0,0,0,0,0,0,0,115000,0,0,0,115000,0,115000,115000,2021-06-09
1240,078854,京鼎統一07購01,0,0,0,0,0,0,0,0,0,115000,0,0,0,115000,0,115000,115000,2021-06-09
1241,084930,圓剛元大08購02,0,0,0,0,0,0,0,0,0,114000,0,0,0,119000,5000,114000,114000,2021-06-09
1242,088694,智易元富0C購01,0,0,0,0,0,0,0,0,0,114000,0,0,0,114000,0,114000,114000,2021-06-09
1243,031887,東森凱基0A購01,0,0,0,0,0,0,0,0,0,114000,0,0,0,139000,25000,114000,114000,2021-06-09
1244,032773,燁輝元大0C購02,0,0,0,0,0,0,0,0,0,114000,0,0,0,118000,4000,114000,114000,2021-06-09
1245,034152,玉晶光凱基0C購02,0,0,0,0,0,0,0,0,0,114000,0,0,0,216000,102000,114000,114000,2021-06-09
1246,076696,SP黃豆富邦08購02,0,0,0,0,0,0,0,0,0,114000,0,0,0,114000,0,114000,114000,2021-06-09
1247,082459,億光元大07購02,0,0,0,0,0,0,0,0,0,114000,0,0,0,114000,0,114000,114000,2021-06-09
1248,080902,恆大凱基0A購01,0,0,0,0,0,0,0,0,0,114000,0,0,0,162000,48000,114000,114000,2021-06-09
1249,081091,智易中信0B購01,0,0,0,0,0,0,0,0,0,114000,0,0,0,114000,0,114000,114000,2021-06-09
1250,2458,義隆,316111,455000,-138889,0,0,0,272000,40000,232000,20000,12000,7000,5000,38000,23000,15000,113111,2021-06-09
1251,085698,台郡國泰0A購01,0,0,0,0,0,0,0,0,0,113000,0,0,0,138000,25000,113000,113000,2021-06-09
1252,031577,台光電凱基0A購01,0,0,0,0,0,0,0,0,0,113000,0,0,0,133000,20000,113000,113000,2021-06-09
1253,1414,東和,405000,292000,113000,0,0,0,0,0,0,0,0,0,0,0,0,0,113000,2021-06-09
1254,088069,南亞統一0B購01,0,0,0,0,0,0,0,0,0,112000,0,0,0,152000,40000,112000,112000,2021-06-09
1255,00653L,富邦印度正2,10000,3000,7000,0,0,0,0,0,0,105000,0,0,0,185000,80000,105000,112000,2021-06-09
1256,032254,台船元大0B購01,0,0,0,0,0,0,0,0,0,112000,0,0,0,112000,0,112000,112000,2021-06-09
1257,036335,燁輝元富0C購02,0,0,0,0,0,0,0,0,0,112000,0,0,0,112000,0,112000,112000,2021-06-09
1258,034173,嘉聯益永豐0B購01,0,0,0,0,0,0,0,0,0,112000,0,0,0,112000,0,112000,112000,2021-06-09
1259,034714,中鋼康和11購01,0,0,0,0,0,0,0,0,0,112000,0,0,0,177000,65000,112000,112000,2021-06-09
1260,082340,世紀鋼統一09購03,0,0,0,0,0,0,0,0,0,112000,0,0,0,112000,0,112000,112000,2021-06-09
1261,078161,聯電凱基08購01,0,0,0,0,0,0,0,0,0,112000,0,0,0,124000,12000,112000,112000,2021-06-09
1262,089706,申豐元富09購01,0,0,0,0,0,0,0,0,0,112000,0,0,0,112000,0,112000,112000,2021-06-09
1263,089230,智邦永豐09購01,0,0,0,0,0,0,0,0,0,112000,0,0,0,112000,0,112000,112000,2021-06-09
1264,4133,亞諾法,1977000,1901200,75800,0,0,0,0,0,0,36000,0,0,0,36000,0,36000,111800,2021-06-09
1265,088747,晶碩永豐09購04,0,0,0,0,0,0,0,0,0,111000,0,0,0,111000,0,111000,111000,2021-06-09
1266,032557,金像電群益0B購01,0,0,0,0,0,0,0,0,0,111000,0,0,0,254000,143000,111000,111000,2021-06-09
1267,033144,玉晶光元大0A購05,0,0,0,0,0,0,0,0,0,111000,0,0,0,123000,12000,111000,111000,2021-06-09
1268,034731,國巨元大0B購13,0,0,0,0,0,0,0,0,0,111000,0,0,0,187000,76000,111000,111000,2021-06-09
1269,073111,勝一元富08購01,0,0,0,0,0,0,0,0,0,111000,0,0,0,141000,30000,111000,111000,2021-06-09
1270,6670,復盛應用,257000,195000,62000,0,0,0,37000,0,37000,11980,13000,1000,12000,0,20,-20,110980,2021-06-09
1271,087357,臺股指麥證0C購03,0,0,0,174000,64000,110000,0,0,0,110000,0,0,0,174000,64000,110000,110000,2021-06-09
1272,031079,復盛元大0A購02,0,0,0,0,0,0,0,0,0,110000,0,0,0,265000,155000,110000,110000,2021-06-09
1273,032483,國巨兆豐0B購01,0,0,0,0,0,0,0,0,0,110000,0,0,0,110000,0,110000,110000,2021-06-09
1274,033258,玉晶光元大0B購03,0,0,0,0,0,0,0,0,0,110000,0,0,0,327000,217000,110000,110000,2021-06-09
1275,032977,TPK元大0A購01,0,0,0,0,0,0,0,0,0,110000,0,0,0,110000,0,110000,110000,2021-06-09
1276,06144P,友達群益07售04,0,0,0,0,0,0,0,0,0,110000,0,0,0,110000,0,110000,110000,2021-06-09
1277,033633,群創元富0B購06,0,0,0,0,0,0,0,0,0,110000,0,0,0,202000,92000,110000,110000,2021-06-09
1278,033610,鴻準群益0B購01,0,0,0,0,0,0,0,0,0,110000,0,0,0,110000,0,110000,110000,2021-06-09
1279,076111,潤泰新富邦06購01,0,0,0,0,0,0,0,0,0,110000,0,0,0,110000,0,110000,110000,2021-06-09
1280,06863P,台灣50麥證0C售02,0,0,0,110000,0,110000,0,0,0,110000,0,0,0,110000,0,110000,110000,2021-06-09
1281,081577,統一元大07購01,0,0,0,0,0,0,0,0,0,110000,0,0,0,110000,0,110000,110000,2021-06-09
1282,080415,聯茂元大06購01,0,0,0,0,0,0,0,0,0,110000,0,0,0,110000,0,110000,110000,2021-06-09
1283,4977,眾達-KY,154000,54000,100000,0,0,0,0,0,0,10000,0,0,0,10000,0,10000,110000,2021-06-09
1284,089520,景碩元大12購01,0,0,0,0,0,0,0,0,0,110000,0,0,0,110000,0,110000,110000,2021-06-09
1285,2360,致茂,780000,640000,140000,0,0,0,2000,13000,-11000,-19275,726,3001,-2275,5000,22000,-17000,109725,2021-06-09
1286,086727,華邦電康和09購01,0,0,0,0,0,0,0,0,0,109000,0,0,0,119000,10000,109000,109000,2021-06-09
1287,030172,國光生國泰0C購01,0,0,0,0,0,0,0,0,0,109000,0,0,0,109000,0,109000,109000,2021-06-09
1288,080032,長榮航富邦06購01,0,0,0,0,0,0,0,0,0,109000,0,0,0,109000,0,109000,109000,2021-06-09
1289,081006,材料永豐07購01,0,0,0,0,0,0,0,0,0,109000,0,0,0,109000,0,109000,109000,2021-06-09
1290,06457P,緯穎凱基09售01,0,0,0,0,0,0,0,0,0,109000,0,0,0,239000,130000,109000,109000,2021-06-09
1291,089522,緯創元大0C購01,0,0,0,0,0,0,0,0,0,109000,0,0,0,120000,11000,109000,109000,2021-06-09
1292,086672,華夏統一0B購01,0,0,0,0,0,0,0,0,0,108000,0,0,0,118000,10000,108000,108000,2021-06-09
1293,030266,致新永豐0A購01,0,0,0,0,0,0,0,0,0,108000,0,0,0,108000,0,108000,108000,2021-06-09
1294,033016,華新科麥證0A購02,0,0,0,108000,0,108000,0,0,0,108000,0,0,0,108000,0,108000,108000,2021-06-09
1295,032367,群創凱基0A購05,0,0,0,0,0,0,0,0,0,108000,0,0,0,550000,442000,108000,108000,2021-06-09
1296,036265,金像電群益13購01,0,0,0,0,0,0,0,0,0,108000,0,0,0,120000,12000,108000,108000,2021-06-09
1297,036000,康控永豐0C購01,0,0,0,0,0,0,0,0,0,108000,0,0,0,235000,127000,108000,108000,2021-06-09
1298,035145,長榮統一0C購18,0,0,0,0,0,0,0,0,0,108000,0,0,0,473000,365000,108000,108000,2021-06-09
1299,082623,滬深2X國票0A購01,0,0,0,0,0,0,0,0,0,108000,0,0,0,110000,2000,108000,108000,2021-06-09
1300,083631,聯發科凱基0A購02,0,0,0,0,0,0,0,0,0,107000,0,0,0,121000,14000,107000,107000,2021-06-09
1301,035592,聯電元大0C購10,0,0,0,0,0,0,0,0,0,107000,0,0,0,130000,23000,107000,107000,2021-06-09
1302,034263,台橡國票0C購03,0,0,0,0,0,0,0,0,0,107000,0,0,0,107000,0,107000,107000,2021-06-09
1303,06350P,聯詠凱基08售06,0,0,0,0,0,0,0,0,0,107000,0,0,0,107000,0,107000,107000,2021-06-09
1304,1466,聚隆,547000,441000,106000,0,0,0,0,0,0,1,1,0,1,0,0,0,106001,2021-06-09
1305,084482,金像電凱基08購02,0,0,0,0,0,0,0,0,0,106000,0,0,0,214000,108000,106000,106000,2021-06-09
1306,085369,聯電群益08購07,0,0,0,0,0,0,0,0,0,106000,0,0,0,127000,21000,106000,106000,2021-06-09
1307,036185,燁輝統一12購01,0,0,0,0,0,0,0,0,0,106000,0,0,0,117000,11000,106000,106000,2021-06-09
1308,034335,富邦金群益11購03,0,0,0,0,0,0,0,0,0,106000,0,0,0,106000,0,106000,106000,2021-06-09
1309,082410,愛普凱基07購03,0,0,0,0,0,0,0,0,0,106000,0,0,0,106000,0,106000,106000,2021-06-09
1310,079926,滬深2X富邦08購01,0,0,0,0,0,0,0,0,0,106000,0,0,0,177000,71000,106000,106000,2021-06-09
1311,1409,新纖,2370000,1825000,545000,0,0,0,0,0,0,-439719,216000,573719,-357719,57000,139000,-82000,105281,2021-06-09
1312,085781,聯電元大0C購04,0,0,0,0,0,0,0,0,0,105000,0,0,0,515000,410000,105000,105000,2021-06-09
1313,032535,長榮凱基0A購17,0,0,0,0,0,0,0,0,0,105000,0,0,0,105000,0,105000,105000,2021-06-09
1314,032033,玉晶光富邦0B購01,0,0,0,0,0,0,0,0,0,105000,0,0,0,105000,0,105000,105000,2021-06-09
1315,033472,聯發科凱基0B購08,0,0,0,0,0,0,0,0,0,105000,0,0,0,105000,0,105000,105000,2021-06-09
1316,033086,台化元富0A購01,0,0,0,0,0,0,0,0,0,105000,0,0,0,105000,0,105000,105000,2021-06-09
1317,030719,新纖元大0A購01,0,0,0,0,0,0,0,0,0,105000,0,0,0,115000,10000,105000,105000,2021-06-09
1318,035456,華新科國票0C購02,0,0,0,0,0,0,0,0,0,105000,0,0,0,112000,7000,105000,105000,2021-06-09
1319,035928,中鋼康和0C購01,0,0,0,0,0,0,0,0,0,105000,0,0,0,178000,73000,105000,105000,2021-06-09
1320,06846P,台灣50凱基11售01,30000,0,30000,0,0,0,0,0,0,75000,0,0,0,334000,259000,75000,105000,2021-06-09
1321,089347,旺宏元大09購11,0,0,0,0,0,0,0,0,0,105000,0,0,0,106000,1000,105000,105000,2021-06-09
1322,0061,元大寶滬深,12000,1000,11000,0,0,0,0,0,0,93451,0,0,0,94000,549,93451,104451,2021-06-09
1323,031062,冠德元大0A購01,0,0,0,0,0,0,0,0,0,104000,0,0,0,109000,5000,104000,104000,2021-06-09
1324,033087,正新元富0A購01,0,0,0,0,0,0,0,0,0,104000,0,0,0,115000,11000,104000,104000,2021-06-09
1325,033509,群創統一0C購09,0,0,0,0,0,0,0,0,0,104000,0,0,0,104000,0,104000,104000,2021-06-09
1326,035771,威鋒電元富13購01,0,0,0,0,0,0,0,0,0,104000,0,0,0,109000,5000,104000,104000,2021-06-09
1327,035389,中石化永豐0B購02,0,0,0,0,0,0,0,0,0,104000,0,0,0,104000,0,104000,104000,2021-06-09
1328,035554,欣興統一0B購05,0,0,0,0,0,0,0,0,0,104000,0,0,0,303000,199000,104000,104000,2021-06-09
1329,06368P,台積電元大0C售08,0,0,0,0,0,0,0,0,0,104000,0,0,0,122000,18000,104000,104000,2021-06-09
1330,081845,台達電永豐07購01,0,0,0,0,0,0,0,0,0,104000,0,0,0,104000,0,104000,104000,2021-06-09
1331,084732,台積電元大08購13,0,0,0,0,0,0,0,0,0,103000,0,0,0,182000,79000,103000,103000,2021-06-09
1332,088452,華碩統一0B購01,0,0,0,0,0,0,0,0,0,103000,0,0,0,103000,0,103000,103000,2021-06-09
1333,031796,中環國票0B購01,0,0,0,0,0,0,0,0,0,103000,0,0,0,103000,0,103000,103000,2021-06-09
1334,069636,嘉澤元富08購01,0,0,0,0,0,0,0,0,0,103000,0,0,0,121000,18000,103000,103000,2021-06-09
1335,072894,味全凱基07購01,0,0,0,0,0,0,0,0,0,103000,0,0,0,103000,0,103000,103000,2021-06-09
1336,083338,宏碁統一09購01,0,0,0,0,0,0,0,0,0,103000,0,0,0,179000,76000,103000,103000,2021-06-09
1337,087144,聯詠國票09購02,0,0,0,0,0,0,0,0,0,102000,0,0,0,115000,13000,102000,102000,2021-06-09
1338,032659,聚陽麥證0B購01,0,0,0,148000,46000,102000,0,0,0,102000,0,0,0,148000,46000,102000,102000,2021-06-09
1339,034303,大成鋼永豐0B購01,0,0,0,0,0,0,0,0,0,102000,0,0,0,105000,3000,102000,102000,2021-06-09
1340,035797,台表科永豐0B購01,0,0,0,0,0,0,0,0,0,102000,0,0,0,254000,152000,102000,102000,2021-06-09
1341,073766,智易中信08購01,0,0,0,0,0,0,0,0,0,102000,0,0,0,206000,104000,102000,102000,2021-06-09
1342,080640,鴻海元大06購19,0,0,0,0,0,0,0,0,0,102000,0,0,0,102000,0,102000,102000,2021-06-09
1343,089629,鴻海凱基13購06,0,0,0,0,0,0,0,0,0,102000,0,0,0,102000,0,102000,102000,2021-06-09
1344,086358,泰鼎元大09購02,0,0,0,0,0,0,0,0,0,101000,0,0,0,101000,0,101000,101000,2021-06-09
1345,030342,海悅群益0B購01,0,0,0,0,0,0,0,0,0,101000,0,0,0,101000,0,101000,101000,2021-06-09
1346,033389,欣興元大0C購01,0,0,0,0,0,0,0,0,0,101000,0,0,0,1023000,922000,101000,101000,2021-06-09
1347,07157P,中鋼國泰11售02,0,0,0,0,0,0,0,0,0,101000,0,0,0,147000,46000,101000,101000,2021-06-09
1348,089907,玉晶光凱基0B購02,0,0,0,0,0,0,0,0,0,101000,0,0,0,110000,9000,101000,101000,2021-06-09
1349,086239,義隆元富08購02,0,0,0,0,0,0,0,0,0,100000,0,0,0,100000,0,100000,100000,2021-06-09
1350,085838,台表科群益08購02,0,0,0,0,0,0,0,0,0,100000,0,0,0,100000,0,100000,100000,2021-06-09
1351,086085,鴻海中信08購03,0,0,0,0,0,0,0,0,0,100000,0,0,0,100000,0,100000,100000,2021-06-09
1352,085096,瑞昱凱基08購05,0,0,0,0,0,0,0,0,0,100000,0,0,0,100000,0,100000,100000,2021-06-09
1353,085124,和碩國泰0A購01,0,0,0,0,0,0,0,0,0,100000,0,0,0,100000,0,100000,100000,2021-06-09
1354,085666,聯詠統一09購06,0,0,0,0,0,0,0,0,0,100000,0,0,0,100000,0,100000,100000,2021-06-09
1355,085425,盛群元大08購02,0,0,0,0,0,0,0,0,0,100000,0,0,0,131000,31000,100000,100000,2021-06-09
1356,085548,中石化群益08購02,0,0,0,0,0,0,0,0,0,100000,0,0,0,200000,100000,100000,100000,2021-06-09
1357,085562,創意群益08購04,0,0,0,0,0,0,0,0,0,100000,0,0,0,100000,0,100000,100000,2021-06-09
1358,084726,鴻海元大0B購01,0,0,0,0,0,0,0,0,0,100000,0,0,0,100000,0,100000,100000,2021-06-09
1359,084753,台郡元大08購01,0,0,0,0,0,0,0,0,0,100000,0,0,0,100000,0,100000,100000,2021-06-09
1360,084744,健策元大08購02,0,0,0,0,0,0,0,0,0,100000,0,0,0,133000,33000,100000,100000,2021-06-09
1361,084561,國巨國票08購08,0,0,0,0,0,0,0,0,0,100000,0,0,0,100000,0,100000,100000,2021-06-09
1362,083457,和碩麥證09購01,0,0,0,100000,0,100000,0,0,0,100000,0,0,0,100000,0,100000,100000,2021-06-09
1363,083455,國巨麥證09購01,0,0,0,100000,0,100000,0,0,0,100000,0,0,0,100000,0,100000,100000,2021-06-09
1364,083522,漢唐元大07購03,0,0,0,0,0,0,0,0,0,100000,0,0,0,100000,0,100000,100000,2021-06-09
1365,084179,乙盛凱基07購02,0,0,0,0,0,0,0,0,0,100000,0,0,0,100000,0,100000,100000,2021-06-09
1366,087102,台積電元大0B購03,0,0,0,0,0,0,0,0,0,100000,0,0,0,100000,0,100000,100000,2021-06-09
1367,086616,鴻海日盛09購02,0,0,0,0,0,0,0,0,0,100000,0,0,0,100000,0,100000,100000,2021-06-09
1368,086569,上緯控元大0B購01,0,0,0,0,0,0,0,0,0,100000,0,0,0,100000,0,100000,100000,2021-06-09
1369,086954,矽創元大09購02,0,0,0,0,0,0,0,0,0,100000,0,0,0,100000,0,100000,100000,2021-06-09
1370,088561,國巨凱基09購12,0,0,0,0,0,0,0,0,0,100000,0,0,0,100000,0,100000,100000,2021-06-09
1371,088650,智易富邦09購01,0,0,0,0,0,0,0,0,0,100000,0,0,0,100000,0,100000,100000,2021-06-09
1372,088839,聯發科中信11購01,0,0,0,0,0,0,0,0,0,100000,0,0,0,100000,0,100000,100000,2021-06-09
1373,088936,群創統一0B購05,0,0,0,0,0,0,0,0,0,100000,0,0,0,157000,57000,100000,100000,2021-06-09
1374,087790,創意永豐09購01,0,0,0,0,0,0,0,0,0,100000,0,0,0,175000,75000,100000,100000,2021-06-09
1375,087804,台積電兆豐0A購06,0,0,0,0,0,0,0,0,0,100000,0,0,0,100000,0,100000,100000,2021-06-09
1376,033563,鴻準永豐0B購01,0,0,0,0,0,0,0,0,0,100000,0,0,0,100000,0,100000,100000,2021-06-09
1377,033119,台泥元大0A購04,0,0,0,0,0,0,0,0,0,100000,0,0,0,100000,0,100000,100000,2021-06-09
1378,032073,萬海中信0A購01,0,0,0,0,0,0,0,0,0,100000,0,0,0,100000,0,100000,100000,2021-06-09
1379,031917,萬海永豐0A購03,0,0,0,0,0,0,0,0,0,100000,0,0,0,100000,0,100000,100000,2021-06-09
1380,033333,力麗永豐0B購01,0,0,0,0,0,0,0,0,0,100000,0,0,0,100000,0,100000,100000,2021-06-09
1381,031499,台積電元大0A購12,0,0,0,0,0,0,0,0,0,100000,0,0,0,150000,50000,100000,100000,2021-06-09
1382,030085,美德醫群益0B購01,0,0,0,0,0,0,0,0,0,100000,0,0,0,110000,10000,100000,100000,2021-06-09
1383,030060,彩晶元大0A購04,0,0,0,0,0,0,0,0,0,100000,0,0,0,100000,0,100000,100000,2021-06-09
1384,033174,萬海永豐0B購01,0,0,0,0,0,0,0,0,0,100000,0,0,0,100000,0,100000,100000,2021-06-09
1385,033185,T50反1凱基12購02,0,0,0,0,0,0,0,0,0,100000,0,0,0,100000,0,100000,100000,2021-06-09
1386,032714,中鋼構群益0B購01,0,0,0,0,0,0,0,0,0,100000,0,0,0,110000,10000,100000,100000,2021-06-09
1387,031296,群創康和0A購04,0,0,0,0,0,0,0,0,0,100000,0,0,0,100000,0,100000,100000,2021-06-09
1388,035841,富邦金元大0B購09,0,0,0,0,0,0,0,0,0,100000,0,0,0,101000,1000,100000,100000,2021-06-09
1389,035824,華新元大0B購09,0,0,0,0,0,0,0,0,0,100000,0,0,0,119000,19000,100000,100000,2021-06-09
1390,033969,東鋼凱基0B購05,0,0,0,0,0,0,0,0,0,100000,0,0,0,100000,0,100000,100000,2021-06-09
1391,034334,聯發科群益0B購10,0,0,0,0,0,0,0,0,0,100000,0,0,0,100000,0,100000,100000,2021-06-09
1392,05243P,聯電國票07售05,0,0,0,0,0,0,0,0,0,100000,0,0,0,100000,0,100000,100000,2021-06-09
1393,04346P,台積電中信08售02,0,0,0,0,0,0,0,0,0,100000,0,0,0,100000,0,100000,100000,2021-06-09
1394,04910P,台灣50元富08售04,0,0,0,0,0,0,0,0,0,100000,0,0,0,100000,0,100000,100000,2021-06-09
1395,035127,華新統一0C購05,0,0,0,0,0,0,0,0,0,100000,0,0,0,140000,40000,100000,100000,2021-06-09
1396,035180,大亞元富0B購03,0,0,0,0,0,0,0,0,0,100000,0,0,0,100000,0,100000,100000,2021-06-09
1397,035071,鴻海群益0C購08,0,0,0,0,0,0,0,0,0,100000,0,0,0,100000,0,100000,100000,2021-06-09
1398,033702,中石化國票0C購01,0,0,0,0,0,0,0,0,0,100000,0,0,0,100000,0,100000,100000,2021-06-09
1399,034775,鴻海富邦12購01,0,0,0,0,0,0,0,0,0,100000,0,0,0,484000,384000,100000,100000,2021-06-09
1400,05897P,聯發科國票08售08,0,0,0,0,0,0,0,0,0,100000,0,0,0,100000,0,100000,100000,2021-06-09
1401,07242P,臺股指國票0B售21,0,0,0,0,0,0,0,0,0,100000,0,0,0,100000,0,100000,100000,2021-06-09
1402,078181,上証2X元大09購01,0,0,0,0,0,0,0,0,0,100000,0,0,0,100000,0,100000,100000,2021-06-09
1403,078182,滬深2X元大07購07,0,0,0,0,0,0,0,0,0,100000,0,0,0,100000,0,100000,100000,2021-06-09
1404,077411,中興電統一07購02,0,0,0,0,0,0,0,0,0,100000,0,0,0,100000,0,100000,100000,2021-06-09
1405,080974,華邦電元大07購07,0,0,0,0,0,0,0,0,0,100000,0,0,0,100000,0,100000,100000,2021-06-09
1406,081448,創意統一09購04,0,0,0,0,0,0,0,0,0,100000,0,0,0,100000,0,100000,100000,2021-06-09
1407,079611,上銀富邦08購01,0,0,0,0,0,0,0,0,0,100000,0,0,0,100000,0,100000,100000,2021-06-09
1408,079179,南茂富邦07購01,0,0,0,0,0,0,0,0,0,100000,0,0,0,100000,0,100000,100000,2021-06-09
1409,079324,彩晶兆豐06購02,0,0,0,0,0,0,0,0,0,100000,0,0,0,100000,0,100000,100000,2021-06-09
1410,082138,玉晶光統一09購04,0,0,0,0,0,0,0,0,0,100000,0,0,0,100000,0,100000,100000,2021-06-09
1411,082638,為升富邦09購01,0,0,0,0,0,0,0,0,0,100000,0,0,0,100000,0,100000,100000,2021-06-09
1412,082722,元石油群益07購01,0,0,0,0,0,0,0,0,0,100000,0,0,0,100000,0,100000,100000,2021-06-09
1413,082742,創意群益08購03,0,0,0,0,0,0,0,0,0,100000,0,0,0,100000,0,100000,100000,2021-06-09
1414,082785,台積電元富07購37,0,0,0,0,0,0,0,0,0,100000,0,0,0,100000,0,100000,100000,2021-06-09
1415,083041,和碩中信0A購01,0,0,0,0,0,0,0,0,0,100000,0,0,0,100000,0,100000,100000,2021-06-09
1416,083002,美指2X凱基0A購01,0,0,0,0,0,0,0,0,0,100000,0,0,0,100000,0,100000,100000,2021-06-09
1417,083211,億光統一09購02,0,0,0,0,0,0,0,0,0,100000,0,0,0,160000,60000,100000,100000,2021-06-09
1418,089588,滬深2X群益09購12,0,0,0,0,0,0,0,0,0,100000,0,0,0,100000,0,100000,100000,2021-06-09
1419,089209,台積電群益09購10,0,0,0,0,0,0,0,0,0,100000,0,0,0,150000,50000,100000,100000,2021-06-09
1420,089133,鴻海元大0B購07,0,0,0,0,0,0,0,0,0,100000,0,0,0,100000,0,100000,100000,2021-06-09
1421,089087,鴻海統一13購04,0,0,0,0,0,0,0,0,0,100000,0,0,0,100000,0,100000,100000,2021-06-09
1422,2504,國產,955000,844000,111000,0,0,0,0,0,0,-11194,806,5000,-4194,0,7000,-7000,99806,2021-06-09
1423,00717,富邦美國特別股,5000,6000,-1000,0,0,0,0,0,0,100100,0,0,0,490100,390000,100100,99100,2021-06-09
1424,088868,立積永豐09購02,0,0,0,0,0,0,0,0,0,99000,0,0,0,100000,1000,99000,99000,2021-06-09
1425,088855,佳世達永豐09購02,0,0,0,0,0,0,0,0,0,99000,0,0,0,99000,0,99000,99000,2021-06-09
1426,086486,晶技統一0B購01,0,0,0,0,0,0,0,0,0,99000,0,0,0,105000,6000,99000,99000,2021-06-09
1427,084513,凌陽元大08購04,0,0,0,0,0,0,0,0,0,99000,0,0,0,217000,118000,99000,99000,2021-06-09
1428,030871,同欣電永豐0A購01,0,0,0,0,0,0,0,0,0,99000,0,0,0,99000,0,99000,99000,2021-06-09
1429,032536,長榮凱基12購02,0,0,0,0,0,0,0,0,0,99000,0,0,0,99000,0,99000,99000,2021-06-09
1430,031922,嘉澤永豐0A購01,0,0,0,0,0,0,0,0,0,99000,0,0,0,217000,118000,99000,99000,2021-06-09
1431,032870,台苯凱基0A購01,0,0,0,0,0,0,0,0,0,99000,0,0,0,135000,36000,99000,99000,2021-06-09
1432,081070,永豐餘中信07購01,0,0,0,0,0,0,0,0,0,99000,0,0,0,99000,0,99000,99000,2021-06-09
1433,080801,華邦電凱基07購04,0,0,0,0,0,0,0,0,0,99000,0,0,0,99000,0,99000,99000,2021-06-09
1434,083346,欣興統一0A購01,0,0,0,0,0,0,0,0,0,99000,0,0,0,100000,1000,99000,99000,2021-06-09
1435,6189,豐藝,127000,16000,111000,0,0,0,0,0,0,-12000,0,12000,-12000,0,0,0,99000,2021-06-09
1436,086781,台達電兆豐0A購01,0,0,0,0,0,0,0,0,0,98000,0,0,0,98000,0,98000,98000,2021-06-09
1437,033133,義隆元大0C購01,0,0,0,0,0,0,0,0,0,98000,0,0,0,300000,202000,98000,98000,2021-06-09
1438,032332,國巨群益0A購03,0,0,0,0,0,0,0,0,0,98000,0,0,0,106000,8000,98000,98000,2021-06-09
1439,033560,南紡永豐0B購01,0,0,0,0,0,0,0,0,0,98000,0,0,0,256000,158000,98000,98000,2021-06-09
1440,031928,華夏元富0A購01,0,0,0,0,0,0,0,0,0,98000,0,0,0,98000,0,98000,98000,2021-06-09
1441,030867,玉晶光永豐0A購03,0,0,0,0,0,0,0,0,0,98000,0,0,0,110000,12000,98000,98000,2021-06-09
1442,030025,台灣50台新0A購01,0,0,0,0,0,0,0,0,0,98000,0,0,0,99000,1000,98000,98000,2021-06-09
1443,030316,鴻海麥證11購01,0,0,0,302000,204000,98000,0,0,0,98000,0,0,0,302000,204000,98000,98000,2021-06-09
1444,030519,申豐群益0B購02,0,0,0,0,0,0,0,0,0,98000,0,0,0,122000,24000,98000,98000,2021-06-09
1445,034946,台玻凱基0C購03,0,0,0,0,0,0,0,0,0,98000,0,0,0,109000,11000,98000,98000,2021-06-09
1446,035569,廣達元富0B購01,0,0,0,0,0,0,0,0,0,98000,0,0,0,100000,2000,98000,98000,2021-06-09
1447,035034,聯電麥證0B購04,0,0,0,115000,16000,99000,0,0,0,98000,0,0,0,115000,17000,98000,98000,2021-06-09
1448,034328,泰豐群益0C購01,0,0,0,0,0,0,0,0,0,98000,0,0,0,98000,0,98000,98000,2021-06-09
1449,034869,GIS元大0B購01,0,0,0,0,0,0,0,0,0,98000,0,0,0,119000,21000,98000,98000,2021-06-09
1450,033999,中鋼群益0B購11,0,0,0,0,0,0,0,0,0,98000,0,0,0,271000,173000,98000,98000,2021-06-09
1451,086915,美德醫凱基09購01,0,0,0,0,0,0,0,0,0,97000,0,0,0,97000,0,97000,97000,2021-06-09
1452,087091,美食元富09購01,0,0,0,0,0,0,0,0,0,97000,0,0,0,112000,15000,97000,97000,2021-06-09
1453,083569,南亞科群益08購02,0,0,0,0,0,0,0,0,0,97000,0,0,0,100000,3000,97000,97000,2021-06-09
1454,030949,全新富邦0A購02,0,0,0,0,0,0,0,0,0,97000,0,0,0,200000,103000,97000,97000,2021-06-09
1455,033438,聯發科元大11購03,0,0,0,0,0,0,0,0,0,97000,0,0,0,102000,5000,97000,97000,2021-06-09
1456,032899,彩晶統一0C購06,0,0,0,0,0,0,0,0,0,97000,0,0,0,135000,38000,97000,97000,2021-06-09
1457,035825,大亞元大0B購08,0,0,0,0,0,0,0,0,0,97000,0,0,0,100000,3000,97000,97000,2021-06-09
1458,035659,祥碩國泰12購01,0,0,0,0,0,0,0,0,0,97000,0,0,0,156000,59000,97000,97000,2021-06-09
1459,035009,華新科元大0B購04,0,0,0,0,0,0,0,0,0,97000,0,0,0,124000,27000,97000,97000,2021-06-09
1460,033752,群光永豐0B購01,0,0,0,0,0,0,0,0,0,97000,0,0,0,115000,18000,97000,97000,2021-06-09
1461,033632,群創元富0B購05,0,0,0,0,0,0,0,0,0,97000,0,0,0,97000,0,97000,97000,2021-06-09
1462,035602,開發金元大0C購01,0,0,0,0,0,0,0,0,0,97000,0,0,0,274000,177000,97000,97000,2021-06-09
1463,075362,玉晶光國票07購06,0,0,0,0,0,0,0,0,0,97000,0,0,0,97000,0,97000,97000,2021-06-09
1464,1514,亞力,117000,20000,97000,0,0,0,0,0,0,0,0,0,0,0,0,0,97000,2021-06-09
1465,2231,為升,196000,98000,98000,0,0,0,0,0,0,-1588,1000,2588,-1588,4000,4000,0,96412,2021-06-09
1466,085945,智原群益09購01,0,0,0,0,0,0,0,0,0,96000,0,0,0,322000,226000,96000,96000,2021-06-09
1467,087626,深中小凱基09購01,0,0,0,0,0,0,0,0,0,96000,0,0,0,718000,622000,96000,96000,2021-06-09
1468,088025,威健永豐09購01,1000,0,1000,0,0,0,0,0,0,95000,0,0,0,95000,0,95000,96000,2021-06-09
1469,031792,台橡國票0B購01,0,0,0,0,0,0,0,0,0,96000,0,0,0,116000,20000,96000,96000,2021-06-09
1470,033871,富邦金群益0B購05,0,0,0,0,0,0,0,0,0,96000,0,0,0,98000,2000,96000,96000,2021-06-09
1471,035487,國泰金群益0C購01,0,0,0,0,0,0,0,0,0,96000,0,0,0,96000,0,96000,96000,2021-06-09
1472,076620,國巨麥證08購01,0,0,0,229000,45000,184000,0,0,0,96000,0,0,0,232000,136000,96000,96000,2021-06-09
1473,083285,台光電元大07購02,0,0,0,0,0,0,0,0,0,96000,0,0,0,540000,444000,96000,96000,2021-06-09
1474,089176,T50反1凱基13購01,0,0,0,0,0,0,0,0,0,96000,0,0,0,100000,4000,96000,96000,2021-06-09
1475,087483,晶相光永豐09購01,0,0,0,0,0,0,0,0,0,95000,0,0,0,95000,0,95000,95000,2021-06-09
1476,032533,益航凱基0C購01,0,0,0,0,0,0,0,0,0,95000,0,0,0,95000,0,95000,95000,2021-06-09
1477,035420,新光鋼元大0B購06,0,0,0,0,0,0,0,0,0,95000,0,0,0,115000,20000,95000,95000,2021-06-09
1478,034373,大亞元大0C購02,0,0,0,0,0,0,0,0,0,95000,0,0,0,112000,17000,95000,95000,2021-06-09
1479,3312,弘憶股,206000,111000,95000,0,0,0,0,0,0,0,0,0,0,0,0,0,95000,2021-06-09
1480,087159,緯穎富邦09購01,0,0,0,0,0,0,0,0,0,94000,0,0,0,100000,6000,94000,94000,2021-06-09
1481,085896,創意國票09購01,0,0,0,0,0,0,0,0,0,94000,0,0,0,94000,0,94000,94000,2021-06-09
1482,031947,東聯元大0B購01,0,0,0,0,0,0,0,0,0,94000,0,0,0,94000,0,94000,94000,2021-06-09
1483,031434,晶技凱基0B購01,0,0,0,0,0,0,0,0,0,94000,0,0,0,101000,7000,94000,94000,2021-06-09
1484,05978P,大立光富邦09售02,0,0,0,0,0,0,0,0,0,94000,0,0,0,166000,72000,94000,94000,2021-06-09
1485,06366P,玉晶光凱基08售10,0,0,0,0,0,0,0,0,0,94000,0,0,0,112000,18000,94000,94000,2021-06-09
1486,081150,大立光凱基08購02,0,0,0,0,0,0,0,0,0,94000,0,0,0,94000,0,94000,94000,2021-06-09
1487,06555P,臺股指群益09售07,0,0,0,0,0,0,0,0,0,94000,0,0,0,327000,233000,94000,94000,2021-06-09
1488,3504,揚明光,172000,80000,92000,0,0,0,0,0,0,2000,0,0,0,2000,0,2000,94000,2021-06-09
1489,4746,台耀,148000,54000,94000,0,0,0,0,0,0,0,0,0,0,0,0,0,94000,2021-06-09
1490,912000,晨訊科-DR,116000,11000,105000,0,0,0,0,0,0,-11000,0,0,0,0,11000,-11000,94000,2021-06-09
1491,031361,長榮中信0A購03,0,0,0,0,0,0,0,0,0,93000,0,0,0,93000,0,93000,93000,2021-06-09
1492,030887,台積電第一14購02,0,0,0,0,0,0,0,0,0,93000,0,0,0,110000,17000,93000,93000,2021-06-09
1493,034706,長榮元富0B購04,0,0,0,0,0,0,0,0,0,93000,0,0,0,515000,422000,93000,93000,2021-06-09
1494,034217,台橡元富0B購02,0,0,0,0,0,0,0,0,0,93000,0,0,0,93000,0,93000,93000,2021-06-09
1495,036069,群創群益12購02,0,0,0,0,0,0,0,0,0,93000,0,0,0,146000,53000,93000,93000,2021-06-09
1496,06988P,聯電兆豐11售02,0,0,0,0,0,0,0,0,0,93000,0,0,0,153000,60000,93000,93000,2021-06-09
1497,078464,聯電統一08購02,0,0,0,0,0,0,0,0,0,93000,0,0,0,203000,110000,93000,93000,2021-06-09
1498,032711,東鋼群益0C購01,0,0,0,0,0,0,0,0,0,92000,0,0,0,143000,51000,92000,92000,2021-06-09
1499,033153,彩晶元大0C購04,0,0,0,0,0,0,0,0,0,92000,0,0,0,238000,146000,92000,92000,2021-06-09
1500,031188,祥碩永豐0A購01,0,0,0,0,0,0,0,0,0,92000,0,0,0,92000,0,92000,92000,2021-06-09
1501,030328,矽格麥證0A購01,0,0,0,106000,14000,92000,0,0,0,92000,0,0,0,106000,14000,92000,92000,2021-06-09
1502,030039,長興元大12購01,0,0,0,0,0,0,0,0,0,92000,0,0,0,130000,38000,92000,92000,2021-06-09
1503,076299,台光電元富08購01,0,0,0,0,0,0,0,0,0,92000,0,0,0,192000,100000,92000,92000,2021-06-09
1504,079404,國巨國泰08購02,0,0,0,0,0,0,0,0,0,92000,0,0,0,92000,0,92000,92000,2021-06-09
1505,3010,華立,167000,75000,92000,0,0,0,0,0,0,0,0,0,0,0,0,0,92000,2021-06-09
1506,1783,和康生,140000,48000,92000,0,0,0,0,0,0,0,0,0,0,0,0,0,92000,2021-06-09
1507,089824,T50反1元大11購01,0,0,0,0,0,0,0,0,0,92000,0,0,0,92000,0,92000,92000,2021-06-09
1508,083553,美利達元大07購01,0,0,0,0,0,0,0,0,0,91000,0,0,0,250000,159000,91000,91000,2021-06-09
1509,089068,友達凱基09購10,0,0,0,0,0,0,0,0,0,91000,0,0,0,111000,20000,91000,91000,2021-06-09
1510,00737,國泰AI+Robo,0,52000,-52000,0,0,0,0,0,0,143000,0,0,0,232000,89000,143000,91000,2021-06-09
1511,030548,松翰凱基0C購01,0,0,0,0,0,0,0,0,0,91000,0,0,0,91000,0,91000,91000,2021-06-09
1512,035801,中鋼凱基12購04,0,0,0,0,0,0,0,0,0,91000,0,0,0,141000,50000,91000,91000,2021-06-09
1513,05878P,T50正2群益08售10,0,0,0,0,0,0,0,0,0,91000,0,0,0,163000,72000,91000,91000,2021-06-09
1514,034525,大成鋼康和12購01,0,0,0,0,0,0,0,0,0,91000,0,0,0,91000,0,91000,91000,2021-06-09
1515,034428,中鋼台新0B購03,0,0,0,0,0,0,0,0,0,91000,0,0,0,91000,0,91000,91000,2021-06-09
1516,080213,泰山元大08購01,0,0,0,0,0,0,0,0,0,91000,0,0,0,91000,0,91000,91000,2021-06-09
1517,082932,奇鋐統一09購02,0,0,0,0,0,0,0,0,0,91000,0,0,0,91000,0,91000,91000,2021-06-09
1518,06971P,台灣50凱基0C售06,0,0,0,0,0,0,0,0,0,91000,0,0,0,96000,5000,91000,91000,2021-06-09
1519,3257,虹冠電,118000,27000,91000,0,0,0,0,0,0,0,0,0,0,0,0,0,91000,2021-06-09
1520,087172,鴻海統一09購21,0,0,0,0,0,0,0,0,0,90000,0,0,0,100000,10000,90000,90000,2021-06-09
1521,087526,玉晶光凱基09購04,0,0,0,0,0,0,0,0,0,90000,0,0,0,99000,9000,90000,90000,2021-06-09
1522,086701,聯電元大09購03,0,0,0,0,0,0,0,0,0,90000,0,0,0,121000,31000,90000,90000,2021-06-09
1523,088800,中興電元大0B購02,0,0,0,0,0,0,0,0,0,90000,0,0,0,90000,0,90000,90000,2021-06-09
1524,031962,友達元大0A購10,0,0,0,0,0,0,0,0,0,90000,0,0,0,90000,0,90000,90000,2021-06-09
1525,032606,晶技元大0A購04,0,0,0,0,0,0,0,0,0,90000,0,0,0,100000,10000,90000,90000,2021-06-09
1526,032898,群創統一0C購08,0,0,0,0,0,0,0,0,0,90000,0,0,0,200000,110000,90000,90000,2021-06-09
1527,034435,中鋼凱基13購03,0,0,0,0,0,0,0,0,0,90000,0,0,0,90000,0,90000,90000,2021-06-09
1528,06112P,華邦電群益07售04,0,0,0,0,0,0,0,0,0,90000,0,0,0,91000,1000,90000,90000,2021-06-09
1529,033693,TPK元大11購01,0,0,0,0,0,0,0,0,0,90000,0,0,0,210000,120000,90000,90000,2021-06-09
1530,03493B,臺股指凱基08熊17,0,0,0,0,0,0,0,0,0,90000,0,0,0,508000,418000,90000,90000,2021-06-09
1531,034387,富邦金元大0C購02,0,0,0,0,0,0,0,0,0,90000,0,0,0,121000,31000,90000,90000,2021-06-09
1532,034736,長榮元大0B購11,0,0,0,0,0,0,0,0,0,90000,0,0,0,453000,363000,90000,90000,2021-06-09
1533,033974,華碩凱基0B購01,0,0,0,0,0,0,0,0,0,90000,0,0,0,90000,0,90000,90000,2021-06-09
1534,035135,友達統一0B購10,0,0,0,0,0,0,0,0,0,90000,0,0,0,100000,10000,90000,90000,2021-06-09
1535,076695,A50正2富邦07購01,0,0,0,0,0,0,0,0,0,90000,0,0,0,300000,210000,90000,90000,2021-06-09
1536,082937,美利達統一09購01,0,0,0,0,0,0,0,0,0,90000,0,0,0,90000,0,90000,90000,2021-06-09
1537,082878,和碩兆豐07購01,0,0,0,0,0,0,0,0,0,90000,0,0,0,90000,0,90000,90000,2021-06-09
1538,080059,台化元大07購01,0,0,0,0,0,0,0,0,0,90000,0,0,0,100000,10000,90000,90000,2021-06-09
1539,080338,合勤控凱基09購01,0,0,0,0,0,0,0,0,0,90000,0,0,0,90000,0,90000,90000,2021-06-09
1540,4551,智伸科,65000,14000,51000,0,0,0,50000,0,50000,-11000,0,10000,-10000,2000,3000,-1000,90000,2021-06-09
1541,00701,國泰股利精選30,55000,30000,25000,0,0,0,0,0,0,64718,0,0,0,94000,29282,64718,89718,2021-06-09
1542,086902,聯電凱基09購05,0,0,0,0,0,0,0,0,0,89000,0,0,0,104000,15000,89000,89000,2021-06-09
1543,084205,億光元大07購05,0,0,0,0,0,0,0,0,0,89000,0,0,0,119000,30000,89000,89000,2021-06-09
1544,031194,億光兆豐0A購01,0,0,0,0,0,0,0,0,0,89000,0,0,0,274000,185000,89000,89000,2021-06-09
1545,032404,台泥元大0A購02,0,0,0,0,0,0,0,0,0,89000,0,0,0,90000,1000,89000,89000,2021-06-09
1546,032407,聯成元大0B購02,0,0,0,0,0,0,0,0,0,89000,0,0,0,217000,128000,89000,89000,2021-06-09
1547,035525,中鋼群益0C購08,0,0,0,0,0,0,0,0,0,89000,0,0,0,124000,35000,89000,89000,2021-06-09
1548,033890,中鋼統一11購02,0,0,0,0,0,0,0,0,0,89000,0,0,0,299000,210000,89000,89000,2021-06-09
1549,089796,潤泰新麥證09購01,0,0,0,100000,11000,89000,0,0,0,89000,0,0,0,100000,11000,89000,89000,2021-06-09
1550,083849,聯發科群益08購10,0,0,0,0,0,0,0,0,0,88000,0,0,0,122000,34000,88000,88000,2021-06-09
1551,036286,台積電元大0C購19,0,0,0,0,0,0,0,0,0,88000,0,0,0,88000,0,88000,88000,2021-06-09
1552,034577,大成鋼凱基0B購05,0,0,0,0,0,0,0,0,0,88000,0,0,0,192000,104000,88000,88000,2021-06-09
1553,089213,可成群益0B購01,0,0,0,0,0,0,0,0,0,88000,0,0,0,98000,10000,88000,88000,2021-06-09
1554,085399,美指2X元大0B購01,0,0,0,0,0,0,0,0,0,87000,0,0,0,123000,36000,87000,87000,2021-06-09
1555,087095,力山元大09購02,0,0,0,0,0,0,0,0,0,87000,0,0,0,356000,269000,87000,87000,2021-06-09
1556,031794,聯電國票0C購02,0,0,0,0,0,0,0,0,0,87000,0,0,0,101000,14000,87000,87000,2021-06-09
1557,031980,亞聚群益0B購01,0,0,0,0,0,0,0,0,0,87000,0,0,0,102000,15000,87000,87000,2021-06-09
1558,034902,南紡元大0B購04,0,0,0,0,0,0,0,0,0,87000,0,0,0,137000,50000,87000,87000,2021-06-09
1559,035551,華新科統一0B購03,0,0,0,0,0,0,0,0,0,87000,0,0,0,92000,5000,87000,87000,2021-06-09
1560,034016,台橡統一12購01,0,0,0,0,0,0,0,0,0,87000,0,0,0,91000,4000,87000,87000,2021-06-09
1561,035783,華碩國泰12購01,0,0,0,0,0,0,0,0,0,87000,0,0,0,132000,45000,87000,87000,2021-06-09
1562,035860,國喬元富13購01,0,0,0,0,0,0,0,0,0,87000,0,0,0,120000,33000,87000,87000,2021-06-09
1563,077606,大立光國泰08購02,0,0,0,0,0,0,0,0,0,87000,0,0,0,162000,75000,87000,87000,2021-06-09
1564,3419,譁裕,176000,89000,87000,0,0,0,0,0,0,0,0,0,0,0,0,0,87000,2021-06-09
1565,3380,明泰,206000,112249,93751,0,0,0,0,0,0,-7504,2000,504,1496,13000,22000,-9000,86247,2021-06-09
1566,087241,佳世達兆豐0A購01,0,0,0,0,0,0,0,0,0,86000,0,0,0,86000,0,86000,86000,2021-06-09
1567,036280,威致元大11購01,0,0,0,0,0,0,0,0,0,86000,0,0,0,120000,34000,86000,86000,2021-06-09
1568,035464,玉晶光國票0B購03,0,0,0,0,0,0,0,0,0,86000,0,0,0,86000,0,86000,86000,2021-06-09
1569,036010,國巨凱基0C購04,0,0,0,0,0,0,0,0,0,86000,0,0,0,89000,3000,86000,86000,2021-06-09
1570,033760,金像電凱基0C購01,0,0,0,0,0,0,0,0,0,86000,0,0,0,106000,20000,86000,86000,2021-06-09
1571,033709,燁輝國票0C購01,0,0,0,0,0,0,0,0,0,86000,0,0,0,86000,0,86000,86000,2021-06-09
1572,077103,聯電統一07購02,0,0,0,0,0,0,0,0,0,86000,0,0,0,86000,0,86000,86000,2021-06-09
1573,06550P,臺股指元大09售12,0,0,0,0,0,0,0,0,0,86000,0,0,0,136000,50000,86000,86000,2021-06-09
1574,06606P,臺股指中信11售03,0,1000,-1000,0,0,0,0,0,0,87000,0,0,0,100000,13000,87000,86000,2021-06-09
1575,088794,美食群益09購02,0,0,0,0,0,0,0,0,0,85000,0,0,0,90000,5000,85000,85000,2021-06-09
1576,085404,聯電元大0C購02,0,0,0,0,0,0,0,0,0,85000,0,0,0,85000,0,85000,85000,2021-06-09
1577,085864,晶技統一09購01,0,0,0,0,0,0,0,0,0,85000,0,0,0,395000,310000,85000,85000,2021-06-09
1578,086211,義隆國泰0A購01,0,0,0,0,0,0,0,0,0,85000,0,0,0,91000,6000,85000,85000,2021-06-09
1579,032042,燁輝國票0B購01,0,0,0,0,0,0,0,0,0,85000,0,0,0,94000,9000,85000,85000,2021-06-09
1580,032524,矽創永豐0A購02,0,0,0,0,0,0,0,0,0,85000,0,0,0,85000,0,85000,85000,2021-06-09
1581,033497,宏達電統一0C購01,0,0,0,0,0,0,0,0,0,85000,0,0,0,105000,20000,85000,85000,2021-06-09
1582,034455,大亞群益0C購02,0,0,0,0,0,0,0,0,0,85000,0,0,0,160000,75000,85000,85000,2021-06-09
1583,035660,台表科國泰12購01,0,0,0,0,0,0,0,0,0,85000,0,0,0,143000,58000,85000,85000,2021-06-09
1584,07049P,長榮航國票0B售04,0,0,0,0,0,0,0,0,0,85000,0,0,0,85000,0,85000,85000,2021-06-09
1585,080106,國喬群益07購01,0,0,0,0,0,0,0,0,0,85000,0,0,0,100000,15000,85000,85000,2021-06-09
1586,086377,聯發科國票09購07,0,0,0,0,0,0,0,0,0,84000,0,0,0,129000,45000,84000,84000,2021-06-09
1587,035462,欣興國票0C購04,0,0,0,0,0,0,0,0,0,84000,0,0,0,141000,57000,84000,84000,2021-06-09
1588,035279,中鋼國票0C購06,0,0,0,0,0,0,0,0,0,84000,0,0,0,152000,68000,84000,84000,2021-06-09
1589,034340,新唐群益0C購01,0,0,0,0,0,0,0,0,0,84000,0,0,0,226000,142000,84000,84000,2021-06-09
1590,034937,中鋼群益0C購07,0,0,0,0,0,0,0,0,0,84000,0,0,0,142000,58000,84000,84000,2021-06-09
1591,076560,中興電國泰08購01,0,0,0,0,0,0,0,0,0,84000,0,0,0,84000,0,84000,84000,2021-06-09
1592,1467,南緯,178000,95000,83000,0,0,0,0,0,0,1,1,0,1,0,0,0,83001,2021-06-09
1593,033329,矽創凱基13購01,0,0,0,0,0,0,0,0,0,83000,0,0,0,303000,220000,83000,83000,2021-06-09
1594,031003,聯成永豐0A購02,0,0,0,0,0,0,0,0,0,83000,0,0,0,83000,0,83000,83000,2021-06-09
1595,034734,聯發科元大11購04,0,0,0,0,0,0,0,0,0,83000,0,0,0,114000,31000,83000,83000,2021-06-09
1596,034836,健策康和0C購01,0,0,0,0,0,0,0,0,0,83000,0,0,0,177000,94000,83000,83000,2021-06-09
1597,035492,國巨國泰12購01,0,0,0,0,0,0,0,0,0,83000,0,0,0,83000,0,83000,83000,2021-06-09
1598,06587P,臺股指凱基0C售12,0,0,0,0,0,0,0,0,0,83000,0,0,0,145000,62000,83000,83000,2021-06-09
1599,085811,SGBR2X群益08購01,0,0,0,0,0,0,0,0,0,82000,0,0,0,85000,3000,82000,82000,2021-06-09
1600,088641,智易國票0A購01,0,0,0,0,0,0,0,0,0,82000,0,0,0,82000,0,82000,82000,2021-06-09
1601,035776,聯電富邦12購02,0,0,0,0,0,0,0,0,0,82000,0,0,0,82000,0,82000,82000,2021-06-09
1602,035764,茂林元富0B購01,0,0,0,0,0,0,0,0,0,82000,0,0,0,107000,25000,82000,82000,2021-06-09
1603,034844,A50正2元大12購01,0,0,0,0,0,0,0,0,0,82000,0,0,0,82000,0,82000,82000,2021-06-09
1604,035138,友達統一0C購07,0,0,0,0,0,0,0,0,0,82000,0,0,0,105000,23000,82000,82000,2021-06-09
1605,036411,長榮航群益14購01,0,0,0,0,0,0,0,0,0,82000,0,0,0,99000,17000,82000,82000,2021-06-09
1606,034138,遠東新凱基0C購01,0,0,0,0,0,0,0,0,0,82000,0,0,0,201000,119000,82000,82000,2021-06-09
1607,07004P,華邦電群益0B售05,0,0,0,0,0,0,0,0,0,82000,0,0,0,86000,4000,82000,82000,2021-06-09
1608,077602,玉晶光元富0B購02,0,0,0,0,0,0,0,0,0,82000,0,0,0,82000,0,82000,82000,2021-06-09
1609,089635,華新科凱基13購01,0,0,0,0,0,0,0,0,0,82000,0,0,0,140000,58000,82000,82000,2021-06-09
1610,089642,玉晶光凱基09購06,0,0,0,0,0,0,0,0,0,82000,0,0,0,186000,104000,82000,82000,2021-06-09
1611,086280,華碩群益0A購01,0,0,0,0,0,0,0,0,0,81000,0,0,0,100000,19000,81000,81000,2021-06-09
1612,033093,友達元富12購02,0,0,0,0,0,0,0,0,0,81000,0,0,0,111000,30000,81000,81000,2021-06-09
1613,033634,群創元富0B購07,0,0,0,0,0,0,0,0,0,81000,0,0,0,81000,0,81000,81000,2021-06-09
1614,03504B,臺股指元大0A熊32,0,0,0,0,0,0,0,0,0,81000,0,0,0,238000,157000,81000,81000,2021-06-09
1615,07095P,聯電國泰11售02,0,0,0,0,0,0,0,0,0,81000,0,0,0,103000,22000,81000,81000,2021-06-09
1616,3450,聯鈞,128000,45000,83000,0,0,0,0,0,0,-2000,0,0,0,0,2000,-2000,81000,2021-06-09
1617,6226,光鼎,252000,171000,81000,0,0,0,0,0,0,0,0,0,0,0,0,0,81000,2021-06-09
1618,086292,南茂群益09購01,0,0,0,0,0,0,0,0,0,80000,0,0,0,80000,0,80000,80000,2021-06-09
1619,086249,和碩麥證08購01,0,0,0,80000,0,80000,0,0,0,80000,0,0,0,80000,0,80000,80000,2021-06-09
1620,085532,A50正2永豐08購01,0,0,0,0,0,0,0,0,0,80000,0,0,0,80000,0,80000,80000,2021-06-09
1621,085159,聯發科凱基08購17,0,0,0,0,0,0,0,0,0,80000,0,0,0,102000,22000,80000,80000,2021-06-09
1622,084096,玉晶光元大08購06,0,0,0,0,0,0,0,0,0,80000,0,0,0,80000,0,80000,80000,2021-06-09
1623,083513,台積電元大07購25,0,0,0,0,0,0,0,0,0,80000,0,0,0,80000,0,80000,80000,2021-06-09
1624,088598,聯發科日盛13購01,0,0,0,0,0,0,0,0,0,80000,0,0,0,80000,0,80000,80000,2021-06-09
1625,087308,元油反中信0A購01,0,0,0,0,0,0,0,0,0,80000,0,0,0,100000,20000,80000,80000,2021-06-09
1626,087588,亞光元大09購03,0,0,0,0,0,0,0,0,0,80000,0,0,0,80000,0,80000,80000,2021-06-09
1627,030993,明基材元大0A購01,0,0,0,0,0,0,0,0,0,80000,0,0,0,80000,0,80000,80000,2021-06-09
1628,031640,永豐餘元大0A購03,0,0,0,0,0,0,0,0,0,80000,0,0,0,80000,0,80000,80000,2021-06-09
1629,031154,明基材兆豐0A購01,0,0,0,0,0,0,0,0,0,80000,0,0,0,80000,0,80000,80000,2021-06-09
1630,034337,大立光群益0B購03,0,0,0,0,0,0,0,0,0,80000,0,0,0,150000,70000,80000,80000,2021-06-09
1631,034000,大成鋼群益0C購05,0,0,0,0,0,0,0,0,0,80000,0,0,0,117000,37000,80000,80000,2021-06-09
1632,033907,群創統一12購01,0,0,0,0,0,0,0,0,0,80000,0,0,0,80000,0,80000,80000,2021-06-09
1633,034921,聯發科麥證11購01,0,0,0,132000,52000,80000,0,0,0,80000,0,0,0,132000,52000,80000,80000,2021-06-09
1634,06190P,台積電凱基08售19,0,0,0,0,0,0,0,0,0,80000,0,0,0,100000,20000,80000,80000,2021-06-09
1635,06532P,聯電兆豐0A售02,0,0,0,0,0,0,0,0,0,80000,0,0,0,80000,0,80000,80000,2021-06-09
1636,078495,華新科國票08購03,0,0,0,0,0,0,0,0,0,80000,0,0,0,81000,1000,80000,80000,2021-06-09
1637,076487,中興電國票06購01,0,0,0,0,0,0,0,0,0,80000,0,0,0,80000,0,80000,80000,2021-06-09
1638,076490,強茂國票06購02,0,0,0,0,0,0,0,0,0,80000,0,0,0,80000,0,80000,80000,2021-06-09
1639,081100,和大群益09購01,0,0,0,0,0,0,0,0,0,80000,0,0,0,80000,0,80000,80000,2021-06-09
1640,081459,精英元富08購01,0,0,0,0,0,0,0,0,0,80000,0,0,0,80000,0,80000,80000,2021-06-09
1641,080781,大成鋼日盛06購01,0,0,0,0,0,0,0,0,0,80000,0,0,0,80000,0,80000,80000,2021-06-09
1642,080898,長榮日盛09購01,0,0,0,0,0,0,0,0,0,80000,0,0,0,80000,0,80000,80000,2021-06-09
1643,081022,欣興統一08購03,0,0,0,0,0,0,0,0,0,80000,0,0,0,130000,50000,80000,80000,2021-06-09
1644,082313,臺股指元大0A購10,0,0,0,0,0,0,0,0,0,80000,0,0,0,80000,0,80000,80000,2021-06-09
1645,089734,創意永豐09購03,0,0,0,0,0,0,0,0,0,80000,0,0,0,100000,20000,80000,80000,2021-06-09
1646,084052,南電國票08購05,0,0,0,0,0,0,0,0,0,79000,0,0,0,85000,6000,79000,79000,2021-06-09
1647,032827,群創康和0A購05,0,0,0,0,0,0,0,0,0,79000,0,0,0,154000,75000,79000,79000,2021-06-09
1648,032393,裕民統一12購01,0,0,0,0,0,0,0,0,0,79000,0,0,0,79000,0,79000,79000,2021-06-09
1649,034786,長榮國泰13購01,0,0,0,0,0,0,0,0,0,79000,0,0,0,79000,0,79000,79000,2021-06-09
1650,035560,群創統一0B購19,0,0,0,0,0,0,0,0,0,79000,0,0,0,79000,0,79000,79000,2021-06-09
1651,034536,中鋼統一0C購12,0,0,0,0,0,0,0,0,0,79000,0,0,0,229000,150000,79000,79000,2021-06-09
1652,034852,華通元大0C購01,0,0,0,0,0,0,0,0,0,79000,0,0,0,138000,59000,79000,79000,2021-06-09
1653,035372,中石化凱基0B購02,0,0,0,0,0,0,0,0,0,79000,0,0,0,99000,20000,79000,79000,2021-06-09
1654,3356,奇偶,101000,22000,79000,0,0,0,0,0,0,0,0,0,0,0,0,0,79000,2021-06-09
1655,083934,欣興中信07購02,0,0,0,0,0,0,0,0,0,78000,0,0,0,108000,30000,78000,78000,2021-06-09
1656,086571,智伸科元大0A購01,0,0,0,0,0,0,0,0,0,78000,0,0,0,78000,0,78000,78000,2021-06-09
1657,032948,力鵬元大0C購01,0,0,0,0,0,0,0,0,0,78000,0,0,0,78000,0,78000,78000,2021-06-09
1658,030905,台積電凱基14購02,0,0,0,0,0,0,0,0,0,78000,0,0,0,290000,212000,78000,78000,2021-06-09
1659,030004,群創中信0C購01,0,0,0,0,0,0,0,0,0,78000,0,0,0,78000,0,78000,78000,2021-06-09
1660,035575,欣興元富12購03,0,0,0,0,0,0,0,0,0,78000,0,0,0,79000,1000,78000,78000,2021-06-09
1661,078151,全新中信09購01,0,0,0,0,0,0,0,0,0,78000,0,0,0,78000,0,78000,78000,2021-06-09
1662,077179,台積電富邦08購05,0,0,0,0,0,0,0,0,0,78000,0,0,0,88000,10000,78000,78000,2021-06-09
1663,06590P,SGBR2X中信09售02,0,0,0,0,0,0,0,0,0,78000,0,0,0,80000,2000,78000,78000,2021-06-09
1664,06420P,臺股指國票09售18,0,0,0,0,0,0,0,0,0,78000,0,0,0,100000,22000,78000,78000,2021-06-09
1665,089362,長榮元大12購02,0,0,0,0,0,0,0,0,0,78000,0,0,0,78000,0,78000,78000,2021-06-09
1666,030795,南亞科凱基0A購02,0,0,0,0,0,0,0,0,0,77000,0,0,0,80000,3000,77000,77000,2021-06-09
1667,032311,新興永豐0A購03,0,0,0,0,0,0,0,0,0,77000,0,0,0,122000,45000,77000,77000,2021-06-09
1668,032369,群創凱基0A購07,0,0,0,0,0,0,0,0,0,77000,0,0,0,364000,287000,77000,77000,2021-06-09
1669,033416,微星永豐0B購01,0,0,0,0,0,0,0,0,0,77000,0,0,0,112000,35000,77000,77000,2021-06-09
1670,036364,金像電國票11購01,0,0,0,0,0,0,0,0,0,77000,0,0,0,187000,110000,77000,77000,2021-06-09
1671,035938,台驊控凱基13購03,0,0,0,0,0,0,0,0,0,77000,0,0,0,300000,223000,77000,77000,2021-06-09
1672,06320P,臺股指群益08售13,0,0,0,0,0,0,0,0,0,77000,0,0,0,221000,144000,77000,77000,2021-06-09
1673,068113,台光電元富07購01,0,0,0,0,0,0,0,0,0,77000,0,0,0,290000,213000,77000,77000,2021-06-09
1674,083078,滬深2X元大08購05,0,0,0,0,0,0,0,0,0,77000,0,0,0,257000,180000,77000,77000,2021-06-09
1675,087521,華新科凱基11購01,0,0,0,0,0,0,0,0,0,76000,0,0,0,76000,0,76000,76000,2021-06-09
1676,032881,華晶科凱基0A購02,0,0,0,0,0,0,0,0,0,76000,0,0,0,98000,22000,76000,76000,2021-06-09
1677,035830,威致元大12購01,0,0,0,0,0,0,0,0,0,76000,0,0,0,84000,8000,76000,76000,2021-06-09
1678,035000,聯電元大0C購09,0,0,0,0,0,0,0,0,0,76000,0,0,0,76000,0,76000,76000,2021-06-09
1679,080557,滬深2X富邦08購02,0,0,0,0,0,0,0,0,0,76000,0,0,0,89000,13000,76000,76000,2021-06-09
1680,079880,國巨元富08購13,0,0,0,0,0,0,0,0,0,76000,0,0,0,82000,6000,76000,76000,2021-06-09
1681,06637P,台灣50凱基0A售04,0,0,0,0,0,0,0,0,0,76000,0,0,0,89000,13000,76000,76000,2021-06-09
1682,2392,正崴,225000,150000,75000,0,0,0,0,0,0,39,1000,961,39,0,0,0,75039,2021-06-09
1683,083933,欣興中信07購01,0,0,0,0,0,0,0,0,0,75000,0,0,0,75000,0,75000,75000,2021-06-09
1684,084488,聯發科凱基08購14,0,0,0,0,0,0,0,0,0,75000,0,0,0,113000,38000,75000,75000,2021-06-09
1685,084351,聯發科元大07購38,0,0,0,0,0,0,0,0,0,75000,0,0,0,75000,0,75000,75000,2021-06-09
1686,084792,中興電群益09購03,0,0,0,0,0,0,0,0,0,75000,0,0,0,77000,2000,75000,75000,2021-06-09
1687,085123,美利達元大08購01,0,0,0,0,0,0,0,0,0,75000,0,0,0,100000,25000,75000,75000,2021-06-09
1688,032089,中石化永豐0A購03,0,0,0,0,0,0,0,0,0,75000,0,0,0,90000,15000,75000,75000,2021-06-09
1689,031429,長榮凱基0A購13,0,0,0,0,0,0,0,0,0,75000,0,0,0,75000,0,75000,75000,2021-06-09
1690,06648P,台灣50凱基0A售05,0,0,0,0,0,0,0,0,0,75000,0,0,0,145000,70000,75000,75000,2021-06-09
1691,06809P,臻鼎元大0A售01,0,0,0,0,0,0,0,0,0,75000,0,0,0,75000,0,75000,75000,2021-06-09
1692,082627,欣興國票08購01,0,0,0,0,0,0,0,0,0,75000,0,0,0,75000,0,75000,75000,2021-06-09
1693,082361,大立光中信07購04,0,0,0,0,0,0,0,0,0,75000,0,0,0,75000,0,75000,75000,2021-06-09
1694,082201,力成永豐07購01,0,0,0,0,0,0,0,0,0,75000,0,0,0,75000,0,75000,75000,2021-06-09
1695,3055,蔚華科,89000,14000,75000,0,0,0,0,0,0,0,0,0,0,0,0,0,75000,2021-06-09
1696,035467,健策國票0C購02,0,0,0,0,0,0,0,0,0,74000,0,0,0,126000,52000,74000,74000,2021-06-09
1697,035267,群創統一0B購16,0,0,0,0,0,0,0,0,0,74000,0,0,0,74000,0,74000,74000,2021-06-09
1698,035259,智原凱基11購02,0,0,0,0,0,0,0,0,0,74000,0,0,0,171000,97000,74000,74000,2021-06-09
1699,089785,界霖凱基11購01,0,0,0,0,0,0,0,0,0,74000,0,0,0,80000,6000,74000,74000,2021-06-09
1700,033029,矽統群益0B購04,0,0,0,0,0,0,0,0,0,73000,0,0,0,109000,36000,73000,73000,2021-06-09
1701,033125,金寶元大0C購01,0,0,0,0,0,0,0,0,0,73000,0,0,0,73000,0,73000,73000,2021-06-09
1702,035013,旺宏第一15購01,0,0,0,0,0,0,0,0,0,73000,0,0,0,78000,5000,73000,73000,2021-06-09
1703,035722,群創元大0B購19,0,0,0,0,0,0,0,0,0,73000,0,0,0,82000,9000,73000,73000,2021-06-09
1704,034409,智原國票0C購01,0,0,0,0,0,0,0,0,0,73000,0,0,0,78000,5000,73000,73000,2021-06-09
1705,034179,儒鴻元大0C購01,0,0,0,0,0,0,0,0,0,73000,0,0,0,73000,0,73000,73000,2021-06-09
1706,079273,金像電國票07購02,0,0,0,0,0,0,0,0,0,73000,0,0,0,73000,0,73000,73000,2021-06-09
1707,073819,大立光元富0A購01,0,0,0,0,0,0,0,0,0,73000,0,0,0,85000,12000,73000,73000,2021-06-09
1708,086366,大立光康和09購01,0,0,0,0,0,0,0,0,0,72000,0,0,0,100000,28000,72000,72000,2021-06-09
1709,087087,光罩元富0C購01,0,0,0,0,0,0,0,0,0,72000,0,0,0,72000,0,72000,72000,2021-06-09
1710,086984,宏碁元富0C購04,0,0,0,0,0,0,0,0,0,72000,0,0,0,72000,0,72000,72000,2021-06-09
1711,086874,祥碩國票0B購01,0,0,0,0,0,0,0,0,0,72000,0,0,0,87000,15000,72000,72000,2021-06-09
1712,033096,聯發科元富12購03,0,0,0,0,0,0,0,0,0,72000,0,0,0,172000,100000,72000,72000,2021-06-09
1713,032377,榮成統一0C購01,0,0,0,0,0,0,0,0,0,72000,0,0,0,72000,0,72000,72000,2021-06-09
1714,031784,華夏國票0B購01,0,0,0,0,0,0,0,0,0,72000,0,0,0,72000,0,72000,72000,2021-06-09
1715,031570,大成鋼凱基0A購03,0,0,0,0,0,0,0,0,0,72000,0,0,0,110000,38000,72000,72000,2021-06-09
1716,030702,超豐群益0A購01,0,0,0,0,0,0,0,0,0,72000,0,0,0,151000,79000,72000,72000,2021-06-09
1717,034975,國巨麥證0B購03,0,0,0,110000,38000,72000,0,0,0,72000,0,0,0,110000,38000,72000,72000,2021-06-09
1718,06774P,臺股指群益0A售05,0,0,0,0,0,0,0,0,0,72000,0,0,0,72000,0,72000,72000,2021-06-09
1719,081216,順德統一09購01,0,0,0,0,0,0,0,0,0,72000,0,0,0,568000,496000,72000,72000,2021-06-09
1720,4956,光鋐,160000,88000,72000,0,0,0,0,0,0,0,0,0,0,0,0,0,72000,2021-06-09
1721,8996,高力,86000,14000,72000,0,0,0,0,0,0,0,0,0,0,0,0,0,72000,2021-06-09
1722,086437,友達中信0A購03,0,0,0,0,0,0,0,0,0,71000,0,0,0,101000,30000,71000,71000,2021-06-09
1723,088573,聯詠凱基09購06,0,0,0,0,0,0,0,0,0,71000,0,0,0,76000,5000,71000,71000,2021-06-09
1724,032707,世紀鋼兆豐0B購02,0,0,0,0,0,0,0,0,0,71000,0,0,0,135000,64000,71000,71000,2021-06-09
1725,033492,友達統一15購02,0,0,0,0,0,0,0,0,0,71000,0,0,0,308000,237000,71000,71000,2021-06-09
1726,035003,國巨元大0C購10,0,0,0,0,0,0,0,0,0,71000,0,0,0,310000,239000,71000,71000,2021-06-09
1727,034740,長榮元大11購03,0,0,0,0,0,0,0,0,0,71000,0,0,0,409000,338000,71000,71000,2021-06-09
1728,06828P,華邦電元大0A售04,0,0,0,0,0,0,0,0,0,71000,0,0,0,116000,45000,71000,71000,2021-06-09
1729,069996,可成元富08購01,0,0,0,0,0,0,0,0,0,71000,0,0,0,98000,27000,71000,71000,2021-06-09
1730,06958P,友達元大0A售13,0,0,0,0,0,0,0,0,0,71000,0,0,0,100000,29000,71000,71000,2021-06-09
1731,089756,南電統一0B購02,0,0,0,0,0,0,0,0,0,71000,0,0,0,71000,0,71000,71000,2021-06-09
1732,089349,宏碁元大09購04,0,0,0,0,0,0,0,0,0,71000,0,0,0,126000,55000,71000,71000,2021-06-09
1733,088512,群創元大09購12,0,0,0,0,0,0,0,0,0,70000,0,0,0,93000,23000,70000,70000,2021-06-09
1734,085894,聯詠國票08購01,0,0,0,0,0,0,0,0,0,70000,0,0,0,70000,0,70000,70000,2021-06-09
1735,085985,國巨元大0C購04,0,0,0,0,0,0,0,0,0,70000,0,0,0,90000,20000,70000,70000,2021-06-09
1736,084942,啟碁元大08購02,0,0,0,0,0,0,0,0,0,70000,0,0,0,70000,0,70000,70000,2021-06-09
1737,083975,致新凱基08購01,0,0,0,0,0,0,0,0,0,70000,0,0,0,70000,0,70000,70000,2021-06-09
1738,032927,台光電國票0B購01,0,0,0,0,0,0,0,0,0,70000,0,0,0,363000,293000,70000,70000,2021-06-09
1739,032594,宏達電元大11購02,0,0,0,0,0,0,0,0,0,70000,0,0,0,71000,1000,70000,70000,2021-06-09
1740,031580,友達凱基0B購06,0,0,0,0,0,0,0,0,0,70000,0,0,0,70000,0,70000,70000,2021-06-09
1741,030873,安普新永豐0A購02,0,0,0,0,0,0,0,0,0,70000,0,0,0,70000,0,70000,70000,2021-06-09
1742,030443,安普新元大0A購01,0,0,0,0,0,0,0,0,0,70000,0,0,0,70000,0,70000,70000,2021-06-09
1743,06083P,聚陽元大07售02,0,0,0,0,0,0,0,0,0,70000,0,0,0,70000,0,70000,70000,2021-06-09
1744,035714,友達元大0B購15,0,0,0,0,0,0,0,0,0,70000,0,0,0,101000,31000,70000,70000,2021-06-09
1745,035674,裕民第一15購01,0,0,0,0,0,0,0,0,0,70000,0,0,0,80000,10000,70000,70000,2021-06-09
1746,036054,台積電麥證0C購05,0,0,0,70000,0,70000,0,0,0,70000,0,0,0,70000,0,70000,70000,2021-06-09
1747,05054P,京鼎元富09售02,0,0,0,0,0,0,0,0,0,70000,0,0,0,70000,0,70000,70000,2021-06-09
1748,03740C,聯發科富邦0C牛01,0,0,0,0,0,0,0,0,0,70000,0,0,0,110000,40000,70000,70000,2021-06-09
1749,035310,允強元大0C購03,0,0,0,0,0,0,0,0,0,70000,0,0,0,105000,35000,70000,70000,2021-06-09
1750,035244,華新科群益0B購03,0,0,0,0,0,0,0,0,0,70000,0,0,0,178000,108000,70000,70000,2021-06-09
1751,035383,大銀凱基0B購01,0,0,0,0,0,0,0,0,0,70000,0,0,0,70000,0,70000,70000,2021-06-09
1752,074450,玉晶光統一06購03,0,0,0,0,0,0,0,0,0,70000,0,0,0,70000,0,70000,70000,2021-06-09
1753,076787,台表科元富08購02,0,0,0,0,0,0,0,0,0,70000,0,0,0,140000,70000,70000,70000,2021-06-09
1754,077861,台達電富邦08購01,0,0,0,0,0,0,0,0,0,70000,0,0,0,110000,40000,70000,70000,2021-06-09
1755,077752,南電中信09購01,0,0,0,0,0,0,0,0,0,70000,0,0,0,70000,0,70000,70000,2021-06-09
1756,078792,長榮康和06購01,0,0,0,0,0,0,0,0,0,70000,0,0,0,70000,0,70000,70000,2021-06-09
1757,080630,滬深2X元大07購09,0,0,0,0,0,0,0,0,0,70000,0,0,0,120000,50000,70000,70000,2021-06-09
1758,079413,和碩富邦07購01,0,0,0,0,0,0,0,0,0,70000,0,0,0,70000,0,70000,70000,2021-06-09
1759,079700,聯茂國票07購01,0,0,0,0,0,0,0,0,0,70000,0,0,0,220000,150000,70000,70000,2021-06-09
1760,080368,上緯控國泰08購01,0,0,0,0,0,0,0,0,0,70000,0,0,0,70000,0,70000,70000,2021-06-09
1761,082001,SGBR2X中信09購01,0,0,0,0,0,0,0,0,0,70000,0,0,0,70000,0,70000,70000,2021-06-09
1762,082628,玉晶光國票08購07,0,0,0,0,0,0,0,0,0,70000,0,0,0,70000,0,70000,70000,2021-06-09
1763,089951,台灣50元大0A購18,0,0,0,0,0,0,0,0,0,70000,0,0,0,70000,0,70000,70000,2021-06-09
1764,3059,華晶科,1038000,1040000,-2000,0,0,0,0,0,0,72000,20000,0,20000,57000,5000,52000,70000,2021-06-09
1765,2538,基泰,131000,61000,70000,0,0,0,0,0,0,0,0,0,0,0,0,0,70000,2021-06-09
1766,910322,康師傅-DR,78000,8000,70000,0,0,0,0,0,0,0,0,0,0,0,0,0,70000,2021-06-09
1767,5515,建國,94000,24000,70000,0,0,0,0,0,0,0,0,0,0,0,0,0,70000,2021-06-09
1768,085650,光罩統一0A購01,0,0,0,0,0,0,0,0,0,69000,0,0,0,69000,0,69000,69000,2021-06-09
1769,031594,東聯國票0B購01,0,0,0,0,0,0,0,0,0,69000,0,0,0,95000,26000,69000,69000,2021-06-09
1770,032641,晶技統一11購01,0,0,0,0,0,0,0,0,0,69000,0,0,0,369000,300000,69000,69000,2021-06-09
1771,031037,聯陽凱基0A購01,0,0,0,0,0,0,0,0,0,69000,0,0,0,69000,0,69000,69000,2021-06-09
1772,033601,和碩兆豐0C購01,0,0,0,0,0,0,0,0,0,69000,0,0,0,69000,0,69000,69000,2021-06-09
1773,036437,日月光凱基11購01,0,0,0,0,0,0,0,0,0,69000,0,0,0,100000,31000,69000,69000,2021-06-09
1774,06226P,緯創元大08售02,0,0,0,0,0,0,0,0,0,69000,0,0,0,89000,20000,69000,69000,2021-06-09
1775,034788,大立光國泰11購02,0,0,0,0,0,0,0,0,0,69000,0,0,0,70000,1000,69000,69000,2021-06-09
1776,079908,佳世達國泰08購01,0,0,0,0,0,0,0,0,0,69000,0,0,0,81000,12000,69000,69000,2021-06-09
1777,07015P,鴻準元富0B售03,0,0,0,0,0,0,0,0,0,69000,0,0,0,101000,32000,69000,69000,2021-06-09
1778,2250,IKKA-KY,93000,24000,69000,0,0,0,0,0,0,0,0,0,0,0,0,0,69000,2021-06-09
1779,1522,堤維西,101000,32000,69000,0,0,0,0,0,0,0,0,0,0,0,0,0,69000,2021-06-09
1780,085938,可成群益0A購01,0,0,0,0,0,0,0,0,0,68000,0,0,0,100000,32000,68000,68000,2021-06-09
1781,086617,南電日盛09購01,0,0,0,0,0,0,0,0,0,68000,0,0,0,350000,282000,68000,68000,2021-06-09
1782,032278,長榮富邦13購01,0,0,0,0,0,0,0,0,0,68000,0,0,0,68000,0,68000,68000,2021-06-09
1783,034532,儒鴻統一11購01,0,0,0,0,0,0,0,0,0,68000,0,0,0,108000,40000,68000,68000,2021-06-09
1784,034485,聯發科元大0C購09,0,0,0,0,0,0,0,0,0,68000,0,0,0,178000,110000,68000,68000,2021-06-09
1785,034729,大成鋼元大0C購03,0,0,0,0,0,0,0,0,0,68000,0,0,0,94000,26000,68000,68000,2021-06-09
1786,034666,台玻凱基0B購03,0,0,0,0,0,0,0,0,0,68000,0,0,0,135000,67000,68000,68000,2021-06-09
1787,035108,愛普元大12購01,0,0,0,0,0,0,0,0,0,68000,0,0,0,72000,4000,68000,68000,2021-06-09
1788,035948,寶成凱基0C購01,0,0,0,0,0,0,0,0,0,68000,0,0,0,78000,10000,68000,68000,2021-06-09
1789,06783P,大成鋼元大0A售04,0,0,0,0,0,0,0,0,0,68000,0,0,0,76000,8000,68000,68000,2021-06-09
1790,06714P,聯詠中信09售04,0,0,0,0,0,0,0,0,0,68000,0,0,0,68000,0,68000,68000,2021-06-09
1791,07213P,萬海元富0B售06,0,0,0,0,0,0,0,0,0,68000,0,0,0,258000,190000,68000,68000,2021-06-09
1792,089662,台達化元大0B購02,0,0,0,0,0,0,0,0,0,68000,0,0,0,71000,3000,68000,68000,2021-06-09
1793,086196,長榮航凱基08購03,0,0,0,0,0,0,0,0,0,67000,0,0,0,67000,0,67000,67000,2021-06-09
1794,085705,億光富邦08購01,0,0,0,0,0,0,0,0,0,67000,0,0,0,183000,116000,67000,67000,2021-06-09
1795,083995,聯電永豐07購06,0,0,0,0,0,0,0,0,0,67000,0,0,0,67000,0,67000,67000,2021-06-09
1796,033591,國泰金凱基15購01,0,0,0,0,0,0,0,0,0,67000,0,0,0,85000,18000,67000,67000,2021-06-09
1797,031020,華紙凱基0A購01,0,0,0,0,0,0,0,0,0,67000,0,0,0,67000,0,67000,67000,2021-06-09
1798,031423,友訊凱基0A購02,0,0,0,0,0,0,0,0,0,67000,0,0,0,72000,5000,67000,67000,2021-06-09
1799,035149,萬海統一0C購07,0,0,0,0,0,0,0,0,0,67000,0,0,0,80000,13000,67000,67000,2021-06-09
1800,035414,南紡元大0B購05,0,0,0,0,0,0,0,0,0,67000,0,0,0,85000,18000,67000,67000,2021-06-09
1801,034192,鴻準元大0B購01,0,0,0,0,0,0,0,0,0,67000,0,0,0,67000,0,67000,67000,2021-06-09
1802,033613,華新科群益0B購02,0,0,0,0,0,0,0,0,0,67000,0,0,0,75000,8000,67000,67000,2021-06-09
1803,066688,台積電元富07購01,0,0,0,0,0,0,0,0,0,67000,0,0,0,67000,0,67000,67000,2021-06-09
1804,06501P,京元電元大09售01,0,0,0,0,0,0,0,0,0,67000,0,0,0,68000,1000,67000,67000,2021-06-09
1805,084521,崇越元大08購01,0,0,0,0,0,0,0,0,0,66000,0,0,0,66000,0,66000,66000,2021-06-09
1806,085494,金像電凱基08購03,0,0,0,0,0,0,0,0,0,66000,0,0,0,326000,260000,66000,66000,2021-06-09
1807,088981,玉晶光元富0C購05,0,0,0,0,0,0,0,0,0,66000,0,0,0,66000,0,66000,66000,2021-06-09
1808,031260,立積群益0C購03,0,0,0,0,0,0,0,0,0,66000,0,0,0,70000,4000,66000,66000,2021-06-09
1809,031270,長榮統一12購01,0,0,0,0,0,0,0,0,0,66000,0,0,0,66000,0,66000,66000,2021-06-09
1810,033079,聯電統一0C購05,0,0,0,0,0,0,0,0,0,66000,0,0,0,72000,6000,66000,66000,2021-06-09
1811,033308,上銀元富0B購01,0,0,0,0,0,0,0,0,0,66000,0,0,0,96000,30000,66000,66000,2021-06-09
1812,034748,愛普元大0B購02,0,0,0,0,0,0,0,0,0,66000,0,0,0,208000,142000,66000,66000,2021-06-09
1813,034216,台橡元富0B購01,0,0,0,0,0,0,0,0,0,66000,0,0,0,66000,0,66000,66000,2021-06-09
1814,034687,允強群益0B購02,0,0,0,0,0,0,0,0,0,66000,0,0,0,91000,25000,66000,66000,2021-06-09
1815,075060,玉晶光元富09購03,0,0,0,0,0,0,0,0,0,66000,0,0,0,66000,0,66000,66000,2021-06-09
1816,076049,奇鋐國票07購01,0,0,0,0,0,0,0,0,0,66000,0,0,0,350000,284000,66000,66000,2021-06-09
1817,078740,玉晶光元富0C購01,0,0,0,0,0,0,0,0,0,66000,0,0,0,66000,0,66000,66000,2021-06-09
1818,089358,冠德元大09購01,0,0,0,0,0,0,0,0,0,66000,0,0,0,66000,0,66000,66000,2021-06-09
1819,089802,瑞儀元富09購01,0,0,0,0,0,0,0,0,0,66000,0,0,0,66000,0,66000,66000,2021-06-09
1820,08987P,臻鼎元富07售02,0,0,0,0,0,0,0,0,0,66000,0,0,0,66000,0,66000,66000,2021-06-09
1821,088355,美食統一0B購01,0,0,0,0,0,0,0,0,0,65000,0,0,0,75000,10000,65000,65000,2021-06-09
1822,087739,欣興台新09購01,0,0,0,0,0,0,0,0,0,65000,0,0,0,65000,0,65000,65000,2021-06-09
1823,083630,友達凱基0C購01,0,0,0,0,0,0,0,0,0,65000,0,0,0,65000,0,65000,65000,2021-06-09
1824,032107,榮運永豐0A購02,0,0,0,0,0,0,0,0,0,65000,0,0,0,82000,17000,65000,65000,2021-06-09
1825,032905,亞光日盛0A購01,0,0,0,0,0,0,0,0,0,65000,0,0,0,65000,0,65000,65000,2021-06-09
1826,031323,台達電元大0A購01,0,0,0,0,0,0,0,0,0,65000,0,0,0,108000,43000,65000,65000,2021-06-09
1827,030862,漢唐永豐0A購01,0,0,0,0,0,0,0,0,0,65000,0,0,0,65000,0,65000,65000,2021-06-09
1828,031504,華邦電元大12購02,0,0,0,0,0,0,0,0,0,65000,0,0,0,65000,0,65000,65000,2021-06-09
1829,030112,台勝科永豐0A購01,0,0,0,0,0,0,0,0,0,65000,0,0,0,108000,43000,65000,65000,2021-06-09
1830,036372,長榮航國票12購01,0,0,0,0,0,0,0,0,0,65000,0,0,0,85000,20000,65000,65000,2021-06-09
1831,034581,南亞科凱基0B購02,0,0,0,0,0,0,0,0,0,65000,0,0,0,68000,3000,65000,65000,2021-06-09
1832,034507,聯發科凱基15購02,0,0,0,0,0,0,0,0,0,65000,0,0,0,104000,39000,65000,65000,2021-06-09
1833,034367,新纖元大0B購02,0,0,0,0,0,0,0,0,0,65000,0,0,0,65000,0,65000,65000,2021-06-09
1834,034123,宏碁兆豐0C購01,0,0,0,0,0,0,0,0,0,65000,0,0,0,65000,0,65000,65000,2021-06-09
1835,034302,燁輝永豐0B購03,0,0,0,0,0,0,0,0,0,65000,0,0,0,76000,11000,65000,65000,2021-06-09
1836,076059,奇鋐統一07購01,0,0,0,0,0,0,0,0,0,65000,0,0,0,90000,25000,65000,65000,2021-06-09
1837,072651,嘉澤元富06購01,0,0,0,0,0,0,0,0,0,65000,0,0,0,100000,35000,65000,65000,2021-06-09
1838,073397,國巨元富07購23,0,0,0,0,0,0,0,0,0,65000,0,0,0,92000,27000,65000,65000,2021-06-09
1839,06488P,臺股指元大0A售19,0,0,0,0,0,0,0,0,0,65000,0,0,0,65000,0,65000,65000,2021-06-09
1840,06834P,聯電凱基0B售03,0,0,0,0,0,0,0,0,0,65000,0,0,0,102000,37000,65000,65000,2021-06-09
1841,07047P,技嘉元富12售02,0,0,0,0,0,0,0,0,0,65000,0,0,0,105000,40000,65000,65000,2021-06-09
1842,079942,台苯凱基08購01,0,0,0,0,0,0,0,0,0,65000,0,0,0,95000,30000,65000,65000,2021-06-09
1843,085226,台積電元大0C購02,0,0,0,0,0,0,0,0,0,64000,0,0,0,70000,6000,64000,64000,2021-06-09
1844,087857,創意國票0A購03,0,0,0,0,0,0,0,0,0,64000,0,0,0,64000,0,64000,64000,2021-06-09
1845,088054,長榮航元大09購05,0,0,0,0,0,0,0,0,0,64000,0,0,0,64000,0,64000,64000,2021-06-09
1846,086601,南電國泰0B購01,0,0,0,0,0,0,0,0,0,64000,0,0,0,120000,56000,64000,64000,2021-06-09
1847,00702,國泰標普低波高息,0,0,0,0,0,0,0,0,0,64000,0,0,0,184000,120000,64000,64000,2021-06-09
1848,031875,金寶凱基0A購01,0,0,0,0,0,0,0,0,0,64000,0,0,0,64000,0,64000,64000,2021-06-09
1849,035230,中鋼永豐0B購02,0,0,0,0,0,0,0,0,0,64000,0,0,0,64000,0,64000,64000,2021-06-09
1850,06228P,台灣50群益09售04,0,0,0,0,0,0,0,0,0,64000,0,0,0,154000,90000,64000,64000,2021-06-09
1851,06311P,臺股指元大08售16,0,0,0,0,0,0,0,0,0,64000,0,0,0,64000,0,64000,64000,2021-06-09
1852,080018,長榮航國票08購02,0,0,0,0,0,0,0,0,0,64000,0,0,0,64000,0,64000,64000,2021-06-09
1853,081724,世芯統一09購02,0,0,0,0,0,0,0,0,0,64000,0,0,0,64000,0,64000,64000,2021-06-09
1854,089979,美食元大0A購01,0,0,0,0,0,0,0,0,0,64000,0,0,0,76000,12000,64000,64000,2021-06-09
1855,087389,宏碁元大11購01,0,0,0,0,0,0,0,0,0,63000,0,0,0,87000,24000,63000,63000,2021-06-09
1856,031454,台苯群益0A購01,0,0,0,0,0,0,0,0,0,63000,0,0,0,115000,52000,63000,63000,2021-06-09
1857,033853,健策永豐0B購01,0,0,0,0,0,0,0,0,0,63000,0,0,0,174000,111000,63000,63000,2021-06-09
1858,034784,鴻海國泰11購05,0,0,0,0,0,0,0,0,0,63000,0,0,0,474000,411000,63000,63000,2021-06-09
1859,034924,群創麥證0C購01,0,0,0,83000,20000,63000,0,0,0,63000,0,0,0,83000,20000,63000,63000,2021-06-09
1860,035257,凌陽凱基11購01,0,0,0,0,0,0,0,0,0,63000,0,0,0,766000,703000,63000,63000,2021-06-09
1861,082552,聯電麥證0C購01,0,0,0,63000,0,63000,0,0,0,63000,0,0,0,63000,0,63000,63000,2021-06-09
1862,080600,強茂統一09購01,0,0,0,0,0,0,0,0,0,63000,0,0,0,70000,7000,63000,63000,2021-06-09
1863,06431P,大立光凱基09售07,0,0,0,0,0,0,0,0,0,63000,0,0,0,81000,18000,63000,63000,2021-06-09
1864,089897,國巨凱基13購02,0,0,0,0,0,0,0,0,0,63000,0,0,0,63000,0,63000,63000,2021-06-09
1865,2467,志聖,121000,58000,63000,0,0,0,0,0,0,0,0,0,0,0,0,0,63000,2021-06-09
1866,087246,超眾兆豐0A購01,0,0,0,0,0,0,0,0,0,62000,0,0,0,62000,0,62000,62000,2021-06-09
1867,088163,旺宏元大09購09,0,0,0,0,0,0,0,0,0,62000,0,0,0,103000,41000,62000,62000,2021-06-09
1868,083593,健策國票08購02,0,0,0,0,0,0,0,0,0,62000,0,0,0,71000,9000,62000,62000,2021-06-09
1869,05727P,同欣電群益08售02,0,0,0,0,0,0,0,0,0,62000,0,0,0,62000,0,62000,62000,2021-06-09
1870,035355,聯電兆豐0C購03,0,0,0,0,0,0,0,0,0,62000,0,0,0,97000,35000,62000,62000,2021-06-09
1871,035082,南紡凱基11購02,0,0,0,0,0,0,0,0,0,62000,0,0,0,62000,0,62000,62000,2021-06-09
1872,035663,燁輝統一13購01,0,0,0,0,0,0,0,0,0,62000,0,0,0,122000,60000,62000,62000,2021-06-09
1873,033782,聯電元大0B購02,0,0,0,0,0,0,0,0,0,62000,0,0,0,149000,87000,62000,62000,2021-06-09
1874,034471,力鵬元大0B購01,0,0,0,0,0,0,0,0,0,62000,0,0,0,245000,183000,62000,62000,2021-06-09
1875,07009P,聯發科凱基0C售07,0,0,0,0,0,0,0,0,0,62000,0,0,0,92000,30000,62000,62000,2021-06-09
1876,080117,南亞國票07購01,0,0,0,0,0,0,0,0,0,62000,0,0,0,62000,0,62000,62000,2021-06-09
1877,080449,大亞凱基07購01,0,0,0,0,0,0,0,0,0,62000,0,0,0,82000,20000,62000,62000,2021-06-09
1878,081602,精英元大07購02,0,0,0,0,0,0,0,0,0,62000,0,0,0,70000,8000,62000,62000,2021-06-09
1879,089539,南電元大12購01,0,0,0,0,0,0,0,0,0,62000,0,0,0,1120000,1058000,62000,62000,2021-06-09
1880,087132,正新國票0A購01,0,0,0,0,0,0,0,0,0,61000,0,0,0,66000,5000,61000,61000,2021-06-09
1881,086556,禾伸堂元大09購01,0,0,0,0,0,0,0,0,0,61000,0,0,0,345000,284000,61000,61000,2021-06-09
1882,030145,立積凱基0A購02,0,0,0,0,0,0,0,0,0,61000,0,0,0,89000,28000,61000,61000,2021-06-09
1883,030259,國光生永豐0A購01,0,0,0,0,0,0,0,0,0,61000,0,0,0,241000,180000,61000,61000,2021-06-09
1884,031150,禾伸堂兆豐0B購01,0,0,0,0,0,0,0,0,0,61000,0,0,0,86000,25000,61000,61000,2021-06-09
1885,032649,新興元富0A購01,0,0,0,0,0,0,0,0,0,61000,0,0,0,330000,269000,61000,61000,2021-06-09
1886,032294,國產兆豐0A購01,0,0,0,0,0,0,0,0,0,61000,0,0,0,61000,0,61000,61000,2021-06-09
1887,032303,鴻海永豐0A購05,0,0,0,0,0,0,0,0,0,61000,0,0,0,305000,244000,61000,61000,2021-06-09
1888,034075,華新元大11購02,0,0,0,0,0,0,0,0,0,61000,0,0,0,75000,14000,61000,61000,2021-06-09
1889,035392,正隆永豐0B購01,0,0,0,0,0,0,0,0,0,61000,0,0,0,61000,0,61000,61000,2021-06-09
1890,035437,創意元大0B購02,0,0,0,0,0,0,0,0,0,61000,0,0,0,146000,85000,61000,61000,2021-06-09
1891,06347P,台積電元大0C售07,0,0,0,0,0,0,0,0,0,61000,0,0,0,158000,97000,61000,61000,2021-06-09
1892,082633,滬深2X富邦08購03,0,0,0,0,0,0,0,0,0,61000,0,0,0,62000,1000,61000,61000,2021-06-09
1893,080324,寶齡凱基08購01,0,0,0,0,0,0,0,0,0,61000,0,0,0,61000,0,61000,61000,2021-06-09
1894,080157,玉晶光凱基07購04,0,0,0,0,0,0,0,0,0,61000,0,0,0,61000,0,61000,61000,2021-06-09
1895,079881,國巨元富08購14,0,0,0,0,0,0,0,0,0,61000,0,0,0,61000,0,61000,61000,2021-06-09
1896,07053P,裕民元大0C售01,0,0,0,0,0,0,0,0,0,61000,0,0,0,119000,58000,61000,61000,2021-06-09
1897,1218,泰山,258000,194000,64000,0,0,0,0,0,0,-3000,0,0,0,0,3000,-3000,61000,2021-06-09
1898,089921,旺宏麥證0A購01,0,0,0,152000,91000,61000,0,0,0,61000,0,0,0,152000,91000,61000,61000,2021-06-09
1899,3056,總太,114000,53000,61000,0,0,0,0,0,0,0,0,0,0,0,0,0,61000,2021-06-09
1900,086823,旺宏元大09購04,0,0,0,0,0,0,0,0,0,60000,0,0,0,60000,0,60000,60000,2021-06-09
1901,086924,健策兆豐0A購01,0,0,0,0,0,0,0,0,0,60000,0,0,0,60000,0,60000,60000,2021-06-09
1902,088421,瑞軒群益0A購01,0,0,0,0,0,0,0,0,0,60000,0,0,0,87000,27000,60000,60000,2021-06-09
1903,083610,聯詠兆豐08購02,0,0,0,0,0,0,0,0,0,60000,0,0,0,428000,368000,60000,60000,2021-06-09
1904,084031,台積電元富07購50,0,0,0,0,0,0,0,0,0,60000,0,0,0,70000,10000,60000,60000,2021-06-09
1905,084692,國巨統一0A購01,0,0,0,0,0,0,0,0,0,60000,0,0,0,60000,0,60000,60000,2021-06-09
1906,086240,美食元富08購01,0,0,0,0,0,0,0,0,0,60000,0,0,0,60000,0,60000,60000,2021-06-09
1907,086235,上証2X元富08購02,0,0,0,0,0,0,0,0,0,60000,0,0,0,60000,0,60000,60000,2021-06-09
1908,086138,臺股指群益08購14,0,0,0,0,0,0,0,0,0,60000,0,0,0,60000,0,60000,60000,2021-06-09
1909,031846,乙盛兆豐0A購01,0,0,0,0,0,0,0,0,0,60000,0,0,0,60000,0,60000,60000,2021-06-09
1910,033436,京元電元大0B購02,0,0,0,0,0,0,0,0,0,60000,0,0,0,105000,45000,60000,60000,2021-06-09
1911,032612,臻鼎元大0A購02,0,0,0,0,0,0,0,0,0,60000,0,0,0,150000,90000,60000,60000,2021-06-09
1912,031816,技嘉元大0A購03,0,0,0,0,0,0,0,0,0,60000,0,0,0,60000,0,60000,60000,2021-06-09
1913,031742,新光鋼凱基14購01,0,0,0,0,0,0,0,0,0,60000,0,0,0,60000,0,60000,60000,2021-06-09
1914,032792,群創元大0A購19,0,0,0,0,0,0,0,0,0,60000,0,0,0,60000,0,60000,60000,2021-06-09
1915,030237,力山永豐0A購01,0,0,0,0,0,0,0,0,0,60000,0,0,0,60000,0,60000,60000,2021-06-09
1916,030409,聯發科元大12購02,0,0,0,0,0,0,0,0,0,60000,0,0,0,60000,0,60000,60000,2021-06-09
1917,031223,立積凱基0A購04,0,0,0,0,0,0,0,0,0,60000,0,0,0,83000,23000,60000,60000,2021-06-09
1918,036366,友達國票11購03,0,0,0,0,0,0,0,0,0,60000,0,0,0,60000,0,60000,60000,2021-06-09
1919,035320,聯發科元大11購05,0,0,0,0,0,0,0,0,0,60000,0,0,0,60000,0,60000,60000,2021-06-09
1920,035272,萬海台新0B購03,0,0,0,0,0,0,0,0,0,60000,0,0,0,60000,0,60000,60000,2021-06-09
1921,035913,國巨永豐0C購01,0,0,0,0,0,0,0,0,0,60000,0,0,0,60000,0,60000,60000,2021-06-09
1922,034475,華新元大0C購02,0,0,0,0,0,0,0,0,0,60000,0,0,0,74000,14000,60000,60000,2021-06-09
1923,034448,富邦金國泰11購01,0,0,0,0,0,0,0,0,0,60000,0,0,0,68000,8000,60000,60000,2021-06-09
1924,034380,燁輝元大12購01,0,0,0,0,0,0,0,0,0,60000,0,0,0,80000,20000,60000,60000,2021-06-09
1925,034503,台苯凱基11購01,0,0,0,0,0,0,0,0,0,60000,0,0,0,60000,0,60000,60000,2021-06-09
1926,033711,台橡國票0C購01,0,0,0,0,0,0,0,0,0,60000,0,0,0,60000,0,60000,60000,2021-06-09
1927,06055P,電子類富邦07售01,0,0,0,0,0,0,0,0,0,60000,0,0,0,60000,0,60000,60000,2021-06-09
1928,07090P,國光生元富12售03,0,0,0,0,0,0,0,0,0,60000,0,0,0,60000,0,60000,60000,2021-06-09
1929,06967P,華邦電群益0A售01,0,0,0,0,0,0,0,0,0,60000,0,0,0,60000,0,60000,60000,2021-06-09
1930,078500,新唐國票07購01,0,0,0,0,0,0,0,0,0,60000,0,0,0,60000,0,60000,60000,2021-06-09
1931,078756,中工國票07購02,0,0,0,0,0,0,0,0,0,60000,0,0,0,132000,72000,60000,60000,2021-06-09
1932,078993,大成鋼凱基07購04,0,0,0,0,0,0,0,0,0,60000,0,0,0,60000,0,60000,60000,2021-06-09
1933,079845,欣興元大07購04,0,0,0,0,0,0,0,0,0,60000,0,0,0,69000,9000,60000,60000,2021-06-09
1934,079836,全新元大06購05,0,0,0,0,0,0,0,0,0,60000,0,0,0,60000,0,60000,60000,2021-06-09
1935,079520,國巨元大07購07,0,0,0,0,0,0,0,0,0,60000,0,0,0,60000,0,60000,60000,2021-06-09
1936,079037,台光電元大06購02,0,0,0,0,0,0,0,0,0,60000,0,0,0,60000,0,60000,60000,2021-06-09
1937,080841,南港元富07購01,0,0,0,0,0,0,0,0,0,60000,0,0,0,60000,0,60000,60000,2021-06-09
1938,081286,玉晶光統一09購03,0,0,0,0,0,0,0,0,0,60000,0,0,0,60000,0,60000,60000,2021-06-09
1939,082917,京元電國泰09購01,0,0,0,0,0,0,0,0,0,60000,0,0,0,60000,0,60000,60000,2021-06-09
1940,082933,和碩統一09購01,0,0,0,0,0,0,0,0,0,60000,0,0,0,80000,20000,60000,60000,2021-06-09
1941,083033,國巨中信07購03,0,0,0,0,0,0,0,0,0,60000,0,0,0,60000,0,60000,60000,2021-06-09
1942,081943,玉晶光元富11購01,0,0,0,0,0,0,0,0,0,60000,0,0,0,60000,0,60000,60000,2021-06-09
1943,081920,貿聯凱基07購01,0,0,0,0,0,0,0,0,0,60000,0,0,0,60000,0,60000,60000,2021-06-09
1944,082089,南電元大07購06,0,0,0,0,0,0,0,0,0,60000,0,0,0,60000,0,60000,60000,2021-06-09
1945,2453,凌群,121000,61000,60000,0,0,0,0,0,0,0,0,0,0,0,0,0,60000,2021-06-09
1946,089534,訊芯元大09購02,0,0,0,0,0,0,0,0,0,60000,0,0,0,100000,40000,60000,60000,2021-06-09
1947,089627,鴻海凱基0B購08,0,0,0,0,0,0,0,0,0,60000,0,0,0,67000,7000,60000,60000,2021-06-09
1948,089252,凌陽統一0B購02,0,0,0,0,0,0,0,0,0,60000,0,0,0,60000,0,60000,60000,2021-06-09
1949,085969,聯陽凱基08購02,0,0,0,0,0,0,0,0,0,59000,0,0,0,59000,0,59000,59000,2021-06-09
1950,086067,欣興統一0B購01,0,0,0,0,0,0,0,0,0,59000,0,0,0,59000,0,59000,59000,2021-06-09
1951,088006,台光電兆豐0A購01,0,0,0,0,0,0,0,0,0,59000,0,0,0,69000,10000,59000,59000,2021-06-09
1952,087767,聯電中信0A購01,0,0,0,0,0,0,0,0,0,59000,0,0,0,70000,11000,59000,59000,2021-06-09
1953,087164,炎洲永豐09購01,0,1000,-1000,0,0,0,0,0,0,60000,0,0,0,142000,82000,60000,59000,2021-06-09
1954,031035,華新科凱基0A購03,0,0,0,0,0,0,0,0,0,59000,0,0,0,184000,125000,59000,59000,2021-06-09
1955,030855,東鋼永豐0A購02,0,0,0,0,0,0,0,0,0,59000,0,0,0,63000,4000,59000,59000,2021-06-09
1956,06033P,台灣50元富0A售01,0,0,0,0,0,0,0,0,0,59000,0,0,0,64000,5000,59000,59000,2021-06-09
1957,034472,聚陽元大0B購02,0,0,0,0,0,0,0,0,0,59000,0,0,0,113000,54000,59000,59000,2021-06-09
1958,035762,國光生元富13購01,0,0,0,0,0,0,0,0,0,59000,0,0,0,117000,58000,59000,59000,2021-06-09
1959,080053,上証2X元大08購01,0,0,0,0,0,0,0,0,0,59000,0,0,0,62000,3000,59000,59000,2021-06-09
1960,080335,玉晶光凱基07購05,0,0,0,0,0,0,0,0,0,59000,0,0,0,59000,0,59000,59000,2021-06-09
1961,07296P,裕民元富13售08,0,0,0,0,0,0,0,0,0,59000,0,0,0,110000,51000,59000,59000,2021-06-09
1962,06874P,華夏元富0A售02,0,0,0,0,0,0,0,0,0,59000,0,0,0,192000,133000,59000,59000,2021-06-09
1963,070961,國巨凱基09購01,0,0,0,0,0,0,0,0,0,59000,0,0,0,118000,59000,59000,59000,2021-06-09
1964,06835P,臺股指麥證0C售04,0,0,0,59000,0,59000,0,0,0,59000,0,0,0,59000,0,59000,59000,2021-06-09
1965,089954,上証2X元大0B購01,0,0,0,0,0,0,0,0,0,59000,0,0,0,86000,27000,59000,59000,2021-06-09
1966,2305,全友,186000,127000,59000,0,0,0,0,0,0,0,0,0,0,0,0,0,59000,2021-06-09
1967,2912,統一超,600043,537700,62343,0,0,0,0,0,0,-4000,0,4000,-4000,0,0,0,58343,2021-06-09
1968,088568,聯發科凱基09購09,0,0,0,0,0,0,0,0,0,58000,0,0,0,164000,106000,58000,58000,2021-06-09
1969,030575,國巨富邦0B購02,0,0,0,0,0,0,0,0,0,58000,0,0,0,130000,72000,58000,58000,2021-06-09
1970,032689,聯電永豐0A購04,0,0,0,0,0,0,0,0,0,58000,0,0,0,108000,50000,58000,58000,2021-06-09
1971,00663L,國泰臺灣加權正2,6000,1000,5000,0,0,0,0,0,0,53000,0,0,0,60000,7000,53000,58000,2021-06-09
1972,033459,智原群益0C購01,0,0,0,0,0,0,0,0,0,58000,0,0,0,159000,101000,58000,58000,2021-06-09
1973,035478,元油反群益0B購01,0,0,0,0,0,0,0,0,0,58000,0,0,0,68000,10000,58000,58000,2021-06-09
1974,034524,大成鋼康和0B購01,0,0,0,0,0,0,0,0,0,58000,0,0,0,258000,200000,58000,58000,2021-06-09
1975,034630,臻鼎康和0B購01,0,0,0,0,0,0,0,0,0,58000,0,0,0,68000,10000,58000,58000,2021-06-09
1976,034670,旺宏凱基0B購05,0,0,0,0,0,0,0,0,0,58000,0,0,0,58000,0,58000,58000,2021-06-09
1977,033788,榮運元大0C購01,0,0,0,0,0,0,0,0,0,58000,0,0,0,199000,141000,58000,58000,2021-06-09
1978,073409,欣興元富0A購02,0,0,0,0,0,0,0,0,0,58000,0,0,0,62000,4000,58000,58000,2021-06-09
1979,079753,國巨元富07購25,0,0,0,0,0,0,0,0,0,58000,0,0,0,100000,42000,58000,58000,2021-06-09
1980,082356,仁寶中信07購01,0,0,0,0,0,0,0,0,0,58000,0,0,0,58000,0,58000,58000,2021-06-09
1981,082838,台灣50富邦07購01,0,0,0,0,0,0,0,0,0,58000,0,0,0,58000,0,58000,58000,2021-06-09
1982,088795,玉晶光群益13購01,0,0,0,0,0,0,0,0,0,57000,0,0,0,65000,8000,57000,57000,2021-06-09
1983,086969,強茂統一0B購01,0,0,0,0,0,0,0,0,0,57000,0,0,0,57000,0,57000,57000,2021-06-09
1984,085563,嘉澤群益09購01,0,0,0,0,0,0,0,0,0,57000,0,0,0,180000,123000,57000,57000,2021-06-09
1985,084925,台積電元大09購11,0,0,0,0,0,0,0,0,0,57000,0,0,0,80000,23000,57000,57000,2021-06-09
1986,084599,力成日盛08購01,0,0,0,0,0,0,0,0,0,57000,0,0,0,57000,0,57000,57000,2021-06-09
1987,089028,松翰元大0A購02,0,0,0,0,0,0,0,0,0,57000,0,0,0,100000,43000,57000,57000,2021-06-09
1988,032931,嘉晶國票0B購01,0,0,0,0,0,0,0,0,0,57000,0,0,0,73000,16000,57000,57000,2021-06-09
1989,032663,合勤控麥證0B購01,0,0,0,57000,0,57000,0,0,0,57000,0,0,0,57000,0,57000,57000,2021-06-09
1990,030740,盟立元大0B購01,0,0,0,0,0,0,0,0,0,57000,0,0,0,120000,63000,57000,57000,2021-06-09
1991,031641,永豐餘元大0C購01,0,0,0,0,0,0,0,0,0,57000,0,0,0,59000,2000,57000,57000,2021-06-09
1992,031287,群創日盛0B購02,0,0,0,0,0,0,0,0,0,57000,0,0,0,57000,0,57000,57000,2021-06-09
1993,034031,中鋼元富0B購04,0,0,0,0,0,0,0,0,0,57000,0,0,0,352000,295000,57000,57000,2021-06-09
1994,034752,南電元大11購01,0,0,0,0,0,0,0,0,0,57000,0,0,0,87000,30000,57000,57000,2021-06-09
1995,035265,大成鋼統一0B購08,0,0,0,0,0,0,0,0,0,57000,0,0,0,61000,4000,57000,57000,2021-06-09
1996,03802P,玉晶光元富09售02,0,0,0,0,0,0,0,0,0,57000,0,0,0,67000,10000,57000,57000,2021-06-09
1997,079694,金像電國票07購03,0,0,0,0,0,0,0,0,0,57000,0,0,0,57000,0,57000,57000,2021-06-09
1998,06373P,聯詠元大08售05,0,0,0,0,0,0,0,0,0,57000,0,0,0,57000,0,57000,57000,2021-06-09
1999,06889P,友達國票0A售03,0,0,0,0,0,0,0,0,0,57000,0,0,0,62000,5000,57000,57000,2021-06-09
2000,6405,悅城,70000,13000,57000,0,0,0,0,0,0,0,0,0,0,0,0,0,57000,2021-06-09
2001,032835,長榮航富邦0B購01,0,0,0,0,0,0,0,0,0,56000,0,0,0,56000,0,56000,56000,2021-06-09
2002,033089,聯電元富0A購04,0,0,0,0,0,0,0,0,0,56000,0,0,0,56000,0,56000,56000,2021-06-09
2003,035253,中鋼凱基0B購06,0,0,0,0,0,0,0,0,0,56000,0,0,0,56000,0,56000,56000,2021-06-09
2004,034065,台玻富邦13購01,0,0,0,0,0,0,0,0,0,56000,0,0,0,116000,60000,56000,56000,2021-06-09
2005,034578,上銀凱基0B購01,0,0,0,0,0,0,0,0,0,56000,0,0,0,56000,0,56000,56000,2021-06-09
2006,06624P,惠特元富09售02,0,0,0,0,0,0,0,0,0,56000,0,0,0,59000,3000,56000,56000,2021-06-09
2007,075363,玉晶光國票08購01,0,0,0,0,0,0,0,0,0,56000,0,0,0,56000,0,56000,56000,2021-06-09
2008,074466,智易元富08購03,0,0,0,0,0,0,0,0,0,56000,0,0,0,56000,0,56000,56000,2021-06-09
2009,077717,欣興元大07購02,0,0,0,0,0,0,0,0,0,56000,0,0,0,67000,11000,56000,56000,2021-06-09
2010,081365,長華凱基0A購01,0,0,0,0,0,0,0,0,0,56000,0,0,0,56000,0,56000,56000,2021-06-09
2011,083092,英業達元大07購01,0,0,0,0,0,0,0,0,0,56000,0,0,0,56000,0,56000,56000,2021-06-09
2012,3583,辛耘,85000,29000,56000,0,0,0,0,0,0,0,0,0,0,0,0,0,56000,2021-06-09
2013,084190,台達電元大07購13,0,0,0,0,0,0,0,0,0,55000,0,0,0,55000,0,55000,55000,2021-06-09
2014,083930,可成中信09購01,0,0,0,0,0,0,0,0,0,55000,0,0,0,75000,20000,55000,55000,2021-06-09
2015,083737,華泰國票08購01,0,0,0,0,0,0,0,0,0,55000,0,0,0,55000,0,55000,55000,2021-06-09
2016,087181,聯電群益0A購03,0,0,0,0,0,0,0,0,0,55000,0,0,0,55000,0,55000,55000,2021-06-09
2017,087119,日月光元大0B購02,0,0,0,0,0,0,0,0,0,55000,0,0,0,55000,0,55000,55000,2021-06-09
2018,087373,台達化元大09購01,0,0,0,0,0,0,0,0,0,55000,0,0,0,55000,0,55000,55000,2021-06-09
2019,087530,台勝科凱基09購01,0,0,0,0,0,0,0,0,0,55000,0,0,0,153000,98000,55000,55000,2021-06-09
2020,088727,台郡凱基0A購01,0,0,0,0,0,0,0,0,0,55000,0,0,0,55000,0,55000,55000,2021-06-09
2021,087851,台積電國票0C購04,0,0,0,0,0,0,0,0,0,55000,0,0,0,55000,0,55000,55000,2021-06-09
2022,033451,華新群益0B購03,0,0,0,0,0,0,0,0,0,55000,0,0,0,56000,1000,55000,55000,2021-06-09
2023,032388,長榮統一0C購08,0,0,0,0,0,0,0,0,0,55000,0,0,0,55000,0,55000,55000,2021-06-09
2024,033568,富邦金永豐0B購01,0,0,0,0,0,0,0,0,0,55000,0,0,0,55000,0,55000,55000,2021-06-09
2025,036261,榮成群益0C購01,0,0,0,0,0,0,0,0,0,55000,0,0,0,55000,0,55000,55000,2021-06-09
2026,032618,百和元大0A購01,0,0,0,0,0,0,0,0,0,55000,0,0,0,95000,40000,55000,55000,2021-06-09
2027,032099,大成鋼永豐0A購05,0,0,0,0,0,0,0,0,0,55000,0,0,0,55000,0,55000,55000,2021-06-09
2028,032243,台達化元大0B購03,0,0,0,0,0,0,0,0,0,55000,0,0,0,55000,0,55000,55000,2021-06-09
2029,030439,晶碩元大0A購02,0,0,0,0,0,0,0,0,0,55000,0,0,0,102000,47000,55000,55000,2021-06-09
2030,034566,華新科國泰11購01,0,0,0,0,0,0,0,0,0,55000,0,0,0,82000,27000,55000,55000,2021-06-09
2031,034561,鴻海國泰11購04,0,0,0,0,0,0,0,0,0,55000,0,0,0,305000,250000,55000,55000,2021-06-09
2032,034349,華新科元富0B購02,0,0,0,0,0,0,0,0,0,55000,0,0,0,55000,0,55000,55000,2021-06-09
2033,035148,萬海統一0B購03,0,0,0,0,0,0,0,0,0,55000,0,0,0,60000,5000,55000,55000,2021-06-09
2034,035929,義隆康和0C購01,0,0,0,0,0,0,0,0,0,55000,0,0,0,65000,10000,55000,55000,2021-06-09
2035,082990,嘉澤元大08購01,0,0,0,0,0,0,0,0,0,55000,0,0,0,76000,21000,55000,55000,2021-06-09
2036,082567,美食統一09購01,0,0,0,0,0,0,0,0,0,55000,0,0,0,55000,0,55000,55000,2021-06-09
2037,081004,健鼎永豐07購01,0,0,0,0,0,0,0,0,0,55000,0,0,0,55000,0,55000,55000,2021-06-09
2038,077654,景碩統一07購03,0,0,0,0,0,0,0,0,0,55000,0,0,0,95000,40000,55000,55000,2021-06-09
2039,077990,惠特元大08購01,0,0,0,0,0,0,0,0,0,55000,0,0,0,55000,0,55000,55000,2021-06-09
2040,2707,晶華,78000,23000,55000,0,0,0,0,0,0,0,0,0,0,0,0,0,55000,2021-06-09
2041,2480,敦陽科,78000,31000,47000,0,0,0,0,0,0,8000,8000,0,8000,0,0,0,55000,2021-06-09
2042,1307,三芳,78000,23000,55000,0,0,0,0,0,0,0,0,0,0,0,0,0,55000,2021-06-09
2043,089143,玉晶光元大0B購02,0,0,0,0,0,0,0,0,0,55000,0,0,0,55000,0,55000,55000,2021-06-09
2044,087059,滬深2X群益09購05,0,0,0,0,0,0,0,0,0,54000,0,0,0,64000,10000,54000,54000,2021-06-09
2045,031417,允強凱基0A購01,0,0,0,0,0,0,0,0,0,54000,0,0,0,61000,7000,54000,54000,2021-06-09
2046,030474,台苯永豐0A購01,0,0,0,0,0,0,0,0,0,54000,0,0,0,54000,0,54000,54000,2021-06-09
2047,032527,聯電凱基0A購10,0,0,0,0,0,0,0,0,0,54000,0,0,0,139000,85000,54000,54000,2021-06-09
2048,031981,聯成群益0B購04,0,0,0,0,0,0,0,0,0,54000,0,0,0,81000,27000,54000,54000,2021-06-09
2049,032296,南亞永豐0A購02,0,0,0,0,0,0,0,0,0,54000,0,0,0,100000,46000,54000,54000,2021-06-09
2050,035805,台船凱基13購01,0,0,0,0,0,0,0,0,0,54000,0,0,0,54000,0,54000,54000,2021-06-09
2051,034725,華新元大0B購08,0,0,0,0,0,0,0,0,0,54000,0,0,0,89000,35000,54000,54000,2021-06-09
2052,06165P,中興電凱基08售03,0,0,0,0,0,0,0,0,0,54000,0,0,0,206000,152000,54000,54000,2021-06-09
2053,082703,聯發科凱基0C購02,0,0,0,0,0,0,0,0,0,54000,0,0,0,60000,6000,54000,54000,2021-06-09
2054,089738,立積永豐09購08,0,0,0,0,0,0,0,0,0,54000,0,0,0,120000,66000,54000,54000,2021-06-09
2055,6243,迅杰,93000,39000,54000,0,0,0,0,0,0,0,0,0,0,0,0,0,54000,2021-06-09
2056,085566,百和群益08購02,0,0,0,0,0,0,0,0,0,53000,0,0,0,56000,3000,53000,53000,2021-06-09
2057,085863,欣興統一0A購04,0,0,0,0,0,0,0,0,0,53000,0,0,0,53000,0,53000,53000,2021-06-09
2058,086213,微星富邦09購01,0,0,0,0,0,0,0,0,0,53000,0,0,0,153000,100000,53000,53000,2021-06-09
2059,086286,義隆群益09購01,0,0,0,0,0,0,0,0,0,53000,0,0,0,53000,0,53000,53000,2021-06-09
2060,033447,新唐元大0B購02,0,0,0,0,0,0,0,0,0,53000,0,0,0,77000,24000,53000,53000,2021-06-09
2061,032140,華邦電凱基0A購11,0,10000,-10000,0,0,0,0,0,0,63000,0,0,0,68000,5000,63000,53000,2021-06-09
2062,030183,友達兆豐0B購02,0,0,0,0,0,0,0,0,0,53000,0,0,0,53000,0,53000,53000,2021-06-09
2063,06103P,鴻海凱基09售07,0,0,0,0,0,0,0,0,0,53000,0,0,0,82000,29000,53000,53000,2021-06-09
2064,034422,萬海統一11購04,0,0,0,0,0,0,0,0,0,53000,0,0,0,53000,0,53000,53000,2021-06-09
2065,034248,新光鋼統一13購01,0,0,0,0,0,0,0,0,0,53000,0,0,0,53000,0,53000,53000,2021-06-09
2066,035864,新光鋼元富0B購02,0,0,0,0,0,0,0,0,0,53000,0,0,0,173000,120000,53000,53000,2021-06-09
2067,082848,台勝科國票08購01,0,0,0,0,0,0,0,0,0,53000,0,0,0,222000,169000,53000,53000,2021-06-09
2068,081467,創意元富11購01,0,0,0,0,0,0,0,0,0,53000,0,0,0,76000,23000,53000,53000,2021-06-09
2069,078058,強茂元大07購01,0,0,0,0,0,0,0,0,0,53000,0,0,0,303000,250000,53000,53000,2021-06-09
2070,06848P,立積凱基0B售02,0,0,0,0,0,0,0,0,0,53000,0,0,0,53000,0,53000,53000,2021-06-09
2071,07072P,聯發科群益0B售12,0,0,0,0,0,0,0,0,0,53000,0,0,0,53000,0,53000,53000,2021-06-09
2072,07107P,臺股指群益0B售05,0,30000,-30000,0,0,0,0,0,0,83000,0,0,0,193000,110000,83000,53000,2021-06-09
2073,6139,亞翔,89000,20000,69000,0,0,0,0,0,0,-16000,0,0,0,0,16000,-16000,53000,2021-06-09
2074,089767,永豐餘凱基09購01,0,0,0,0,0,0,0,0,0,53000,0,0,0,53000,0,53000,53000,2021-06-09
2075,3138,耀登,95000,42000,53000,0,0,0,0,0,0,0,0,0,0,0,0,0,53000,2021-06-09
2076,3023,信邦,176000,114000,62000,0,0,0,1000,7000,-6000,-3000,0,0,0,0,3000,-3000,53000,2021-06-09
2077,2431,聯昌,96000,43000,53000,0,0,0,0,0,0,-5,1,6,-5,0,0,0,52995,2021-06-09
2078,086029,長榮航永豐08購01,0,0,0,0,0,0,0,0,0,52000,0,0,0,52000,0,52000,52000,2021-06-09
2079,086621,恆大凱基09購01,0,0,0,0,0,0,0,0,0,52000,0,0,0,66000,14000,52000,52000,2021-06-09
2080,087941,達方統一0A購01,0,0,0,0,0,0,0,0,0,52000,0,0,0,52000,0,52000,52000,2021-06-09
2081,088274,華碩中信09購01,0,0,0,0,0,0,0,0,0,52000,0,0,0,54000,2000,52000,52000,2021-06-09
2082,031332,全新元大0A購05,0,0,0,0,0,0,0,0,0,52000,0,0,0,108000,56000,52000,52000,2021-06-09
2083,033581,燁輝凱基12購02,0,0,0,0,0,0,0,0,0,52000,0,0,0,58000,6000,52000,52000,2021-06-09
2084,035882,國光生群益0B購01,0,0,0,0,0,0,0,0,0,52000,0,0,0,143000,91000,52000,52000,2021-06-09
2085,033979,群創凱基11購02,0,0,0,0,0,0,0,0,0,52000,0,0,0,110000,58000,52000,52000,2021-06-09
2086,035457,萬海國票11購03,0,0,0,0,0,0,0,0,0,52000,0,0,0,92000,40000,52000,52000,2021-06-09
2087,03787P,瑞昱中信09售01,0,0,0,0,0,0,0,0,0,52000,0,0,0,52000,0,52000,52000,2021-06-09
2088,035433,聯詠元大0B購05,0,0,0,0,0,0,0,0,0,52000,0,0,0,115000,63000,52000,52000,2021-06-09
2089,034703,愛普群益12購03,0,0,0,0,0,0,0,0,0,52000,0,0,0,52000,0,52000,52000,2021-06-09
2090,034534,台玻統一0C購02,0,0,0,0,0,0,0,0,0,52000,0,0,0,120000,68000,52000,52000,2021-06-09
2091,034980,欣興富邦0B購01,0,0,0,0,0,0,0,0,0,52000,0,0,0,52000,0,52000,52000,2021-06-09
2092,05966P,臺股指凱基0A售03,0,0,0,0,0,0,0,0,0,52000,0,0,0,60000,8000,52000,52000,2021-06-09
2093,034743,萬海元大0C購06,0,0,0,0,0,0,0,0,0,52000,0,0,0,52000,0,52000,52000,2021-06-09
2094,078468,旺宏統一08購01,0,0,0,0,0,0,0,0,0,52000,0,0,0,102000,50000,52000,52000,2021-06-09
2095,082764,欣興統一09購04,0,0,0,0,0,0,0,0,0,52000,0,0,0,52000,0,52000,52000,2021-06-09
2096,082573,欣興統一09購03,0,0,0,0,0,0,0,0,0,52000,0,0,0,63000,11000,52000,52000,2021-06-09
2097,081645,明基材元大07購01,0,0,0,0,0,0,0,0,0,52000,0,0,0,52000,0,52000,52000,2021-06-09
2098,081594,台揚元大07購01,0,0,0,0,0,0,0,0,0,52000,0,0,0,52000,0,52000,52000,2021-06-09
2099,3149,正達,435000,383000,52000,0,0,0,0,0,0,0,0,0,0,0,0,0,52000,2021-06-09
2100,3694,海華,81000,29000,52000,0,0,0,0,0,0,0,0,0,0,0,0,0,52000,2021-06-09
2101,087566,申豐國票0A購01,0,0,0,0,0,0,0,0,0,51000,0,0,0,58000,7000,51000,51000,2021-06-09
2102,084978,宏碁國泰0A購01,0,0,0,0,0,0,0,0,0,51000,0,0,0,54000,3000,51000,51000,2021-06-09
2103,033489,華邦電統一0C購04,0,0,0,0,0,0,0,0,0,51000,0,0,0,91000,40000,51000,51000,2021-06-09
2104,031115,正文群益0B購01,0,0,0,0,0,0,0,0,0,51000,0,0,0,71000,20000,51000,51000,2021-06-09
2105,030562,裕民統一0B購02,0,0,0,0,0,0,0,0,0,51000,0,0,0,51000,0,51000,51000,2021-06-09
2106,035169,長榮國票12購01,0,0,0,0,0,0,0,0,0,51000,0,0,0,85000,34000,51000,51000,2021-06-09
2107,03502B,臺股指凱基11熊08,0,0,0,0,0,0,0,0,0,51000,0,0,0,55000,4000,51000,51000,2021-06-09
2108,033997,創意兆豐0C購01,0,0,0,0,0,0,0,0,0,51000,0,0,0,327000,276000,51000,51000,2021-06-09
2109,081257,長榮國泰09購03,0,0,0,0,0,0,0,0,0,51000,0,0,0,51000,0,51000,51000,2021-06-09
2110,080901,卜蜂凱基0B購01,0,0,0,0,0,0,0,0,0,51000,0,0,0,61000,10000,51000,51000,2021-06-09
2111,071854,致茂元富07購02,0,0,0,0,0,0,0,0,0,51000,0,0,0,51000,0,51000,51000,2021-06-09
2112,06759P,臺股指凱基0C售21,0,0,0,0,0,0,0,0,0,51000,0,0,0,51000,0,51000,51000,2021-06-09
2113,089772,宏碁凱基09購06,0,0,0,0,0,0,0,0,0,51000,0,0,0,64000,13000,51000,51000,2021-06-09
2114,084367,台郡元大07購03,0,0,0,0,0,0,0,0,0,50000,0,0,0,50000,0,50000,50000,2021-06-09
2115,083720,台積電元大07購33,0,0,0,0,0,0,0,0,0,50000,0,0,0,50000,0,50000,50000,2021-06-09
2116,083591,順德國票08購02,0,0,0,0,0,0,0,0,0,50000,0,0,0,50000,0,50000,50000,2021-06-09
2117,083433,聯電凱基0A購04,0,0,0,0,0,0,0,0,0,50000,0,0,0,52000,2000,50000,50000,2021-06-09
2118,083957,圓剛凱基07購02,0,0,0,0,0,0,0,0,0,50000,0,0,0,50000,0,50000,50000,2021-06-09
2119,083970,祥碩凱基08購03,0,0,0,0,0,0,0,0,0,50000,0,0,0,50000,0,50000,50000,2021-06-09
2120,083822,華通凱基08購01,0,0,0,0,0,0,0,0,0,50000,0,0,0,300000,250000,50000,50000,2021-06-09
2121,084039,聯詠元富0A購01,0,0,0,0,0,0,0,0,0,50000,0,0,0,50000,0,50000,50000,2021-06-09
2122,086309,英業達凱基09購01,0,0,0,0,0,0,0,0,0,50000,0,0,0,50000,0,50000,50000,2021-06-09
2123,086236,長興元富08購01,0,0,0,0,0,0,0,0,0,50000,0,0,0,50000,0,50000,50000,2021-06-09
2124,086153,微星元大08購01,0,0,0,0,0,0,0,0,0,50000,0,0,0,150000,100000,50000,50000,2021-06-09
2125,086159,立隆電元大09購01,0,0,0,0,0,0,0,0,0,50000,0,0,0,50000,0,50000,50000,2021-06-09
2126,085133,全新統一0A購01,0,0,0,0,0,0,0,0,0,50000,0,0,0,50000,0,50000,50000,2021-06-09
2127,087576,國喬元大0A購01,0,0,0,0,0,0,0,0,0,50000,0,0,0,50000,0,50000,50000,2021-06-09
2128,087547,國喬元富0B購01,0,0,0,0,0,0,0,0,0,50000,0,0,0,50000,0,50000,50000,2021-06-09
2129,087187,聯發科群益09購04,0,0,0,0,0,0,0,0,0,50000,0,0,0,60000,10000,50000,50000,2021-06-09
2130,087252,南帝國票0A購01,0,0,0,0,0,0,0,0,0,50000,0,0,0,100000,50000,50000,50000,2021-06-09
2131,087311,華夏永豐09購01,0,0,0,0,0,0,0,0,0,50000,0,0,0,50000,0,50000,50000,2021-06-09
2132,086633,台光電凱基09購01,0,0,0,0,0,0,0,0,0,50000,0,0,0,60000,10000,50000,50000,2021-06-09
2133,086469,信邦兆豐0A購01,0,0,0,0,0,0,0,0,0,50000,0,0,0,50000,0,50000,50000,2021-06-09
2134,087000,祥碩國票0A購02,0,0,0,0,0,0,0,0,0,50000,0,0,0,50000,0,50000,50000,2021-06-09
2135,086882,聯茂富邦09購01,0,0,0,0,0,0,0,0,0,50000,0,0,0,50000,0,50000,50000,2021-06-09
2136,087814,樺漢兆豐0A購01,0,0,0,0,0,0,0,0,0,50000,0,0,0,50000,0,50000,50000,2021-06-09
2137,087818,華夏凱基0B購01,0,0,0,0,0,0,0,0,0,50000,0,0,0,50000,0,50000,50000,2021-06-09
2138,088919,滬深2X統一09購02,0,0,0,0,0,0,0,0,0,50000,0,0,0,50000,0,50000,50000,2021-06-09
2139,030202,群光凱基0C購01,0,0,0,0,0,0,0,0,0,50000,0,0,0,70000,20000,50000,50000,2021-06-09
2140,031116,緯穎群益0A購01,0,0,0,0,0,0,0,0,0,50000,0,0,0,50000,0,50000,50000,2021-06-09
2141,030773,精英麥證0A購02,0,0,0,160000,110000,50000,0,0,0,50000,0,0,0,160000,110000,50000,50000,2021-06-09
2142,030766,凌陽康和11購01,0,0,0,0,0,0,0,0,0,50000,0,0,0,50000,0,50000,50000,2021-06-09
2143,033189,華新凱基0B購02,0,0,0,0,0,0,0,0,0,50000,0,0,0,97000,47000,50000,50000,2021-06-09
2144,031283,矽創統一0C購01,0,0,0,0,0,0,0,0,0,50000,0,0,0,50000,0,50000,50000,2021-06-09
2145,030559,南亞科統一0C購03,0,0,0,0,0,0,0,0,0,50000,0,0,0,50000,0,50000,50000,2021-06-09
2146,030968,台積電元大0A購09,0,0,0,0,0,0,0,0,0,50000,0,0,0,50000,0,50000,50000,2021-06-09
2147,030950,奇力新富邦0C購01,0,0,0,0,0,0,0,0,0,50000,0,0,0,50000,0,50000,50000,2021-06-09
2148,033595,中纖兆豐0C購01,0,0,0,0,0,0,0,0,0,50000,0,0,0,60000,10000,50000,50000,2021-06-09
2149,032382,台船統一0C購01,0,0,0,0,0,0,0,0,0,50000,0,0,0,50000,0,50000,50000,2021-06-09
2150,032277,長榮富邦0C購02,0,0,0,0,0,0,0,0,0,50000,0,0,0,50000,0,50000,50000,2021-06-09
2151,032251,中鋼構元大0B購01,0,0,0,0,0,0,0,0,0,50000,0,0,0,50000,0,50000,50000,2021-06-09
2152,033264,力成元大0B購02,0,0,0,0,0,0,0,0,0,50000,0,0,0,50000,0,50000,50000,2021-06-09
2153,033255,聯詠元大0B購02,0,0,0,0,0,0,0,0,0,50000,0,0,0,50000,0,50000,50000,2021-06-09
2154,033256,智原元大0B購02,0,0,0,0,0,0,0,0,0,50000,0,0,0,50000,0,50000,50000,2021-06-09
2155,033233,台聚元大0B購02,0,0,0,0,0,0,0,0,0,50000,0,0,0,57000,7000,50000,50000,2021-06-09
2156,032810,台船國票0B購01,0,0,0,0,0,0,0,0,0,50000,0,0,0,60000,10000,50000,50000,2021-06-09
2157,032202,長榮航群益0B購03,0,0,0,0,0,0,0,0,0,50000,0,0,0,99000,49000,50000,50000,2021-06-09
2158,032075,國喬兆豐0B購01,0,0,0,0,0,0,0,0,0,50000,0,0,0,50000,0,50000,50000,2021-06-09
2159,032579,中石化元大0C購02,0,0,0,0,0,0,0,0,0,50000,0,0,0,50000,0,50000,50000,2021-06-09
2160,05503P,國巨元富08售16,0,0,0,0,0,0,0,0,0,50000,0,0,0,50000,0,50000,50000,2021-06-09
2161,036336,台達電元富12購01,0,0,0,0,0,0,0,0,0,50000,0,0,0,50000,0,50000,50000,2021-06-09
2162,034012,群創群益11購05,0,0,0,0,0,0,0,0,0,50000,0,0,0,50000,0,50000,50000,2021-06-09
2163,035916,友達永豐0C購01,0,0,0,0,0,0,0,0,0,50000,0,0,0,50000,0,50000,50000,2021-06-09
2164,03578P,創意元富08售04,0,0,0,0,0,0,0,0,0,50000,0,0,0,50000,0,50000,50000,2021-06-09
2165,034866,嘉聯益元大0B購02,0,0,0,0,0,0,0,0,0,50000,0,0,0,150000,100000,50000,50000,2021-06-09
2166,034292,燁輝中信0B購01,0,0,0,0,0,0,0,0,0,50000,0,0,0,50000,0,50000,50000,2021-06-09
2167,035358,大立光兆豐0B購01,0,0,0,0,0,0,0,0,0,50000,0,0,0,50000,0,50000,50000,2021-06-09
2168,035429,中工元大0B購01,0,0,0,0,0,0,0,0,0,50000,0,0,0,360000,310000,50000,50000,2021-06-09
2169,04258P,精元元富08售02,0,0,0,0,0,0,0,0,0,50000,0,0,0,50000,0,50000,50000,2021-06-09
2170,036410,長榮航群益12購02,0,0,0,0,0,0,0,0,0,50000,0,0,0,67000,17000,50000,50000,2021-06-09
2171,06035P,廣宇元富07售06,0,0,0,0,0,0,0,0,0,50000,0,0,0,50000,0,50000,50000,2021-06-09
2172,06040P,台積電元大07售34,0,0,0,0,0,0,0,0,0,50000,0,0,0,50000,0,50000,50000,2021-06-09
2173,034539,燁輝統一0C購04,0,0,0,0,0,0,0,0,0,50000,0,0,0,160000,110000,50000,50000,2021-06-09
2174,034462,晶技群益0C購01,0,0,0,0,0,0,0,0,0,50000,0,0,0,50000,0,50000,50000,2021-06-09
2175,034459,聯發科群益0B購11,0,0,0,0,0,0,0,0,0,50000,0,0,0,50000,0,50000,50000,2021-06-09
2176,06338P,臺股指凱基09售15,0,0,0,0,0,0,0,0,0,50000,0,0,0,400000,350000,50000,50000,2021-06-09
2177,06755P,台灣50凱基0C售04,0,0,0,0,0,0,0,0,0,50000,0,0,0,50000,0,50000,50000,2021-06-09
2178,06632P,仁寶元富09售03,0,0,0,0,0,0,0,0,0,50000,0,0,0,99000,49000,50000,50000,2021-06-09
2179,06689P,聯電凱基0A售06,0,0,0,0,0,0,0,0,0,50000,0,0,0,50000,0,50000,50000,2021-06-09
2180,06586P,臺股指凱基0C售11,0,0,0,0,0,0,0,0,0,50000,0,0,0,80000,30000,50000,50000,2021-06-09
2181,070740,世紀鋼元富08購01,0,0,0,0,0,0,0,0,0,50000,0,0,0,80000,30000,50000,50000,2021-06-09
2182,07061P,臺股指國票0B售15,0,0,0,0,0,0,0,0,0,50000,0,0,0,52000,2000,50000,50000,2021-06-09
2183,069055,台表科元富08購01,0,0,0,0,0,0,0,0,0,50000,0,0,0,50000,0,50000,50000,2021-06-09
2184,06931P,臺股指元大0C售14,0,0,0,0,0,0,0,0,0,50000,0,0,0,50000,0,50000,50000,2021-06-09
2185,076213,滬深2X富邦07購01,0,0,0,0,0,0,0,0,0,50000,0,0,0,50000,0,50000,50000,2021-06-09
2186,078367,圓剛元大07購01,0,0,0,0,0,0,0,0,0,50000,0,0,0,50000,0,50000,50000,2021-06-09
2187,079006,華新科凱基0A購01,0,0,0,0,0,0,0,0,0,50000,0,0,0,50000,0,50000,50000,2021-06-09
2188,080911,大毅凱基0A購01,0,0,0,0,0,0,0,0,0,50000,0,0,0,50000,0,50000,50000,2021-06-09
2189,080778,訊芯元大06購01,0,0,0,0,0,0,0,0,0,50000,0,0,0,100000,50000,50000,50000,2021-06-09
2190,080743,裕隆群益06購02,0,0,0,0,0,0,0,0,0,50000,0,0,0,50000,0,50000,50000,2021-06-09
2191,080638,川湖元大09購01,0,0,0,0,0,0,0,0,0,50000,0,0,0,50000,0,50000,50000,2021-06-09
2192,081276,勝一統一09購01,0,0,0,0,0,0,0,0,0,50000,0,0,0,50000,0,50000,50000,2021-06-09
2193,081186,國喬元大07購02,0,0,0,0,0,0,0,0,0,50000,0,0,0,50000,0,50000,50000,2021-06-09
2194,081160,世紀鋼凱基08購04,0,0,0,0,0,0,0,0,0,50000,0,0,0,50000,0,50000,50000,2021-06-09
2195,081069,台肥中信07購01,0,0,0,0,0,0,0,0,0,50000,0,0,0,50000,0,50000,50000,2021-06-09
2196,079755,國巨元富07購27,0,0,0,0,0,0,0,0,0,50000,0,0,0,50000,0,50000,50000,2021-06-09
2197,080480,長興元大06購02,0,0,0,0,0,0,0,0,0,50000,0,0,0,50000,0,50000,50000,2021-06-09
2198,080193,大成鋼元富06購04,0,0,0,0,0,0,0,0,0,50000,0,0,0,50000,0,50000,50000,2021-06-09
2199,081660,大毅永豐07購02,0,0,0,0,0,0,0,0,0,50000,0,0,0,50000,0,50000,50000,2021-06-09
2200,081905,台揚凱基08購01,0,0,0,0,0,0,0,0,0,50000,0,0,0,50000,0,50000,50000,2021-06-09
2201,081843,中興電永豐07購01,0,0,0,0,0,0,0,0,0,50000,0,0,0,50000,0,50000,50000,2021-06-09
2202,082853,嘉聯益國票08購02,0,0,0,0,0,0,0,0,0,50000,0,0,0,50000,0,50000,50000,2021-06-09
2203,089595,聯電群益0B購03,0,0,0,0,0,0,0,0,0,50000,0,0,0,50000,0,50000,50000,2021-06-09
2204,089527,臻鼎元大0B購01,0,0,0,0,0,0,0,0,0,50000,0,0,0,50000,0,50000,50000,2021-06-09
2205,089295,聚陽國票0A購02,0,0,0,0,0,0,0,0,0,50000,0,0,0,50000,0,50000,50000,2021-06-09
2206,088932,新興統一0C購01,0,0,0,0,0,0,0,0,0,49000,0,0,0,49000,0,49000,49000,2021-06-09
2207,087118,群創元大0A購03,0,0,0,0,0,0,0,0,0,49000,0,0,0,79000,30000,49000,49000,2021-06-09
2208,084568,京元電國票09購01,0,0,0,0,0,0,0,0,0,49000,0,0,0,49000,0,49000,49000,2021-06-09
2209,032039,華榮國票0C購01,0,0,0,0,0,0,0,0,0,49000,0,0,0,105000,56000,49000,49000,2021-06-09
2210,034392,智原元大0B購05,0,0,0,0,0,0,0,0,0,49000,0,0,0,158000,109000,49000,49000,2021-06-09
2211,034505,國巨凱基0B購05,0,0,0,0,0,0,0,0,0,49000,0,0,0,73000,24000,49000,49000,2021-06-09
2212,03499B,臺股指凱基09熊33,0,0,0,0,0,0,0,0,0,49000,0,0,0,96000,47000,49000,49000,2021-06-09
2213,035097,台驊控凱基11購01,0,0,0,0,0,0,0,0,0,49000,0,0,0,58000,9000,49000,49000,2021-06-09
2214,035212,長榮富邦12購03,10000,0,10000,0,0,0,0,0,0,39000,0,0,0,60000,21000,39000,49000,2021-06-09
2215,035692,祥碩凱基0B購02,0,0,0,0,0,0,0,0,0,49000,0,0,0,55000,6000,49000,49000,2021-06-09
2216,078334,聯電凱基0A購01,0,0,0,0,0,0,0,0,0,49000,0,0,0,104000,55000,49000,49000,2021-06-09
2217,06572P,台灣50元大0C售03,0,0,0,0,0,0,0,0,0,49000,0,0,0,50000,1000,49000,49000,2021-06-09
2218,089585,寶成永豐09購01,0,0,0,0,0,0,0,0,0,49000,0,0,0,54000,5000,49000,49000,2021-06-09
2219,2419,仲琦,109000,55000,54000,0,0,0,0,0,0,-5002,0,2,-2,0,5000,-5000,48998,2021-06-09
2220,006206,元大上證50,68000,25000,43000,0,0,0,0,0,0,5088,0,0,0,67088,62000,5088,48088,2021-06-09
2221,085556,聯發科群益08購17,0,0,0,0,0,0,0,0,0,48000,0,0,0,54000,6000,48000,48000,2021-06-09
2222,087028,玉晶光麥證09購01,0,0,0,61000,0,61000,0,0,0,48000,0,0,0,61000,13000,48000,48000,2021-06-09
2223,088417,台積電群益0C購03,0,0,0,0,0,0,0,0,0,48000,0,0,0,102000,54000,48000,48000,2021-06-09
2224,00650L,FH香港正2,120000,16000,104000,0,0,0,0,0,0,-56000,0,0,0,786000,842000,-56000,48000,2021-06-09
2225,035861,國喬元富13購02,0,0,0,0,0,0,0,0,0,48000,0,0,0,82000,34000,48000,48000,2021-06-09
2226,035037,裕民麥證0C購01,0,0,0,48000,0,48000,0,0,0,48000,0,0,0,48000,0,48000,48000,2021-06-09
2227,035278,大亞國票0B購02,0,0,0,0,0,0,0,0,0,48000,0,0,0,48000,0,48000,48000,2021-06-09
2228,033850,裕隆永豐0B購01,0,0,0,0,0,0,0,0,0,48000,0,0,0,48000,0,48000,48000,2021-06-09
2229,083027,南電凱基0A購02,0,0,0,0,0,0,0,0,0,48000,0,0,0,210000,162000,48000,48000,2021-06-09
2230,089655,美利達國票0B購01,0,0,0,0,0,0,0,0,0,48000,0,0,0,50000,2000,48000,48000,2021-06-09
2231,3665,貿聯-KY,501000,490110,10890,0,0,0,36000,0,36000,1000,0,1000,-1000,2000,0,2000,47890,2021-06-09
2232,088198,智易群益0A購01,0,0,0,0,0,0,0,0,0,47000,0,0,0,55000,8000,47000,47000,2021-06-09
2233,086960,國巨永豐09購01,0,0,0,0,0,0,0,0,0,47000,0,0,0,47000,0,47000,47000,2021-06-09
2234,087425,滬深2X元富09購07,0,0,0,0,0,0,0,0,0,47000,0,0,0,67000,20000,47000,47000,2021-06-09
2235,030391,南帝元大11購01,0,0,0,0,0,0,0,0,0,47000,0,0,0,75000,28000,47000,47000,2021-06-09
2236,033199,致新凱基0B購02,1000,0,1000,0,0,0,0,0,0,46000,0,0,0,59000,13000,46000,47000,2021-06-09
2237,031833,大立光富邦0B購04,0,0,0,0,0,0,0,0,0,47000,0,0,0,48000,1000,47000,47000,2021-06-09
2238,036333,榮成元富0C購01,0,0,0,0,0,0,0,0,0,47000,0,0,0,55000,8000,47000,47000,2021-06-09
2239,05916P,臺股指元大08售04,0,0,0,0,0,0,0,0,0,47000,0,0,0,57000,10000,47000,47000,2021-06-09
2240,034976,華新科麥證0C購01,0,0,0,93000,38000,55000,0,0,0,47000,0,0,0,93000,46000,47000,47000,2021-06-09
2241,06187P,台積電兆豐09售02,0,0,0,0,0,0,0,0,0,47000,0,0,0,47000,0,47000,47000,2021-06-09
2242,034562,國巨國泰11購03,0,0,0,0,0,0,0,0,0,47000,0,0,0,78000,31000,47000,47000,2021-06-09
2243,034137,亞聚凱基0B購02,0,0,0,0,0,0,0,0,0,47000,0,0,0,50000,3000,47000,47000,2021-06-09
2244,035863,新光鋼元富0B購01,0,0,0,0,0,0,0,0,0,47000,0,0,0,300000,253000,47000,47000,2021-06-09
2245,035638,玉晶光富邦13購01,0,0,0,0,0,0,0,0,0,47000,0,0,0,58000,11000,47000,47000,2021-06-09
2246,035466,創意國票0C購01,0,0,0,0,0,0,0,0,0,47000,0,0,0,61000,14000,47000,47000,2021-06-09
2247,082957,SGBR2X元大07購01,0,0,0,0,0,0,0,0,0,47000,0,0,0,47000,0,47000,47000,2021-06-09
2248,080238,聯發科元大08購04,0,0,0,0,0,0,0,0,0,47000,0,0,0,52000,5000,47000,47000,2021-06-09
2249,079200,群創群益07購01,0,0,0,0,0,0,0,0,0,47000,0,0,0,47000,0,47000,47000,2021-06-09
2250,07055P,玉晶光元大0C售03,0,0,0,0,0,0,0,0,0,47000,0,0,0,77000,30000,47000,47000,2021-06-09
2251,07212P,聯發科元富0B售04,0,0,0,0,0,0,0,0,0,47000,0,0,0,47000,0,47000,47000,2021-06-09
2252,088679,南茂元大09購02,0,0,0,0,0,0,0,0,0,46000,0,0,0,524000,478000,46000,46000,2021-06-09
2253,086375,精英國票0A購01,0,0,0,0,0,0,0,0,0,46000,0,0,0,46000,0,46000,46000,2021-06-09
2254,032237,道瓊反元大11購01,0,0,0,0,0,0,0,0,0,46000,0,0,0,100000,54000,46000,46000,2021-06-09
2255,033235,中石化元大0B購02,0,0,0,0,0,0,0,0,0,46000,0,0,0,47000,1000,46000,46000,2021-06-09
2256,031853,新光鋼中信0A購01,0,0,0,0,0,0,0,0,0,46000,0,0,0,46000,0,46000,46000,2021-06-09
2257,032751,臺股指凱基0A購24,0,0,0,0,0,0,0,0,0,46000,0,0,0,50000,4000,46000,46000,2021-06-09
2258,034327,新光鋼群益0B購06,0,0,0,0,0,0,0,0,0,46000,0,0,0,141000,95000,46000,46000,2021-06-09
2259,035098,群創凱基11購05,0,0,0,0,0,0,0,0,0,46000,0,0,0,56000,10000,46000,46000,2021-06-09
2260,033706,永光國票0C購01,0,0,0,0,0,0,0,0,0,46000,0,0,0,56000,10000,46000,46000,2021-06-09
2261,068921,奇鋐元富08購01,0,0,0,0,0,0,0,0,0,46000,0,0,0,46000,0,46000,46000,2021-06-09
2262,080645,致茂元大09購01,0,0,0,0,0,0,0,0,0,46000,0,0,0,175000,129000,46000,46000,2021-06-09
2263,6781,AES-KY,13000,27000,-14000,0,0,0,59000,0,59000,1000,1000,0,1000,0,0,0,46000,2021-06-09
2264,032366,嘉晶凱基0A購01,0,0,0,0,0,0,0,0,0,45000,0,0,0,99000,54000,45000,45000,2021-06-09
2265,033380,上銀元大0B購01,0,0,0,0,0,0,0,0,0,45000,0,0,0,45000,0,45000,45000,2021-06-09
2266,033647,台玻統一15購01,0,0,0,0,0,0,0,0,0,45000,0,0,0,45000,0,45000,45000,2021-06-09
2267,034785,華邦電國泰11購02,0,0,0,0,0,0,0,0,0,45000,0,0,0,820000,775000,45000,45000,2021-06-09
2268,06182P,台積電國票08售18,0,0,0,0,0,0,0,0,0,45000,0,0,0,45000,0,45000,45000,2021-06-09
2269,035220,中鋼國泰11購03,0,0,0,0,0,0,0,0,0,45000,0,0,0,89000,44000,45000,45000,2021-06-09
2270,081424,大銀群益09購01,0,0,0,0,0,0,0,0,0,45000,0,0,0,45000,0,45000,45000,2021-06-09
2271,079050,玉晶光元大09購03,0,0,0,0,0,0,0,0,0,45000,0,0,0,45000,0,45000,45000,2021-06-09
2272,082931,奇鋐統一09購01,0,5000,-5000,0,0,0,0,0,0,50000,0,0,0,1711000,1661000,50000,45000,2021-06-09
2273,068511,國巨統一07購01,0,0,0,0,0,0,0,0,0,45000,0,0,0,375000,330000,45000,45000,2021-06-09
2274,071050,同欣電中信07購01,0,0,0,0,0,0,0,0,0,45000,0,0,0,55000,10000,45000,45000,2021-06-09
2275,07205P,萬海凱基11售04,0,0,0,0,0,0,0,0,0,45000,0,0,0,147000,102000,45000,45000,2021-06-09
2276,07224P,儒鴻國票0B售01,0,0,0,0,0,0,0,0,0,45000,0,0,0,58000,13000,45000,45000,2021-06-09
2277,075065,美利達元富0B購01,0,0,0,0,0,0,0,0,0,45000,0,0,0,65000,20000,45000,45000,2021-06-09
2278,089997,南帝中信0A購02,0,0,0,0,0,0,0,0,0,45000,0,0,0,45000,0,45000,45000,2021-06-09
2279,089983,景碩元大0A購02,0,0,0,0,0,0,0,0,0,45000,0,0,0,585000,540000,45000,45000,2021-06-09
2280,085217,友達國票0A購01,0,0,0,0,0,0,0,0,0,44000,0,0,0,55000,11000,44000,44000,2021-06-09
2281,084504,滬深2X元大08購08,0,0,0,0,0,0,0,0,0,44000,0,0,0,44000,0,44000,44000,2021-06-09
2282,088177,志超元大09購01,0,0,0,0,0,0,0,0,0,44000,0,0,0,85000,41000,44000,44000,2021-06-09
2283,032802,中石化國票0B購03,0,0,0,0,0,0,0,0,0,44000,0,0,0,84000,40000,44000,44000,2021-06-09
2284,032839,亞泥中信0A購01,0,0,0,0,0,0,0,0,0,44000,0,0,0,44000,0,44000,44000,2021-06-09
2285,032938,矽統富邦0C購01,0,0,0,0,0,0,0,0,0,44000,0,0,0,198000,154000,44000,44000,2021-06-09
2286,031965,長榮元大0A購20,0,0,0,0,0,0,0,0,0,44000,0,0,0,44000,0,44000,44000,2021-06-09
2287,031823,康普元大0B購01,0,0,0,0,0,0,0,0,0,44000,0,0,0,49000,5000,44000,44000,2021-06-09
2288,031173,國喬永豐0A購01,0,0,0,0,0,0,0,0,0,44000,0,0,0,294000,250000,44000,44000,2021-06-09
2289,031022,旺宏凱基0A購04,0,0,0,0,0,0,0,0,0,44000,0,0,0,44000,0,44000,44000,2021-06-09
2290,035104,裕民元大0B購06,0,0,0,0,0,0,0,0,0,44000,0,0,0,49000,5000,44000,44000,2021-06-09
2291,06177P,臺股指元大0B售04,0,0,0,0,0,0,0,0,0,44000,0,0,0,45000,1000,44000,44000,2021-06-09
2292,034110,華邦電群益0B購07,0,0,0,0,0,0,0,0,0,44000,0,0,0,92000,48000,44000,44000,2021-06-09
2293,072860,世紀鋼國泰08購01,0,0,0,0,0,0,0,0,0,44000,0,0,0,44000,0,44000,44000,2021-06-09
2294,080133,台塑凱基06購01,0,0,0,0,0,0,0,0,0,44000,0,0,0,44000,0,44000,44000,2021-06-09
2295,2476,鉅祥,275000,181000,94000,0,0,0,0,0,0,-50000,0,50000,-50000,0,0,0,44000,2021-06-09
2296,2537,聯上發,100000,56000,44000,0,0,0,0,0,0,0,0,0,0,0,0,0,44000,2021-06-09
2297,088267,聯陽永豐09購01,0,0,0,0,0,0,0,0,0,43000,0,0,0,43000,0,43000,43000,2021-06-09
2298,087859,臺股指國票09購23,0,0,0,0,0,0,0,0,0,43000,0,0,0,43000,0,43000,43000,2021-06-09
2299,084864,凌陽元大08購07,0,0,0,0,0,0,0,0,0,43000,0,0,0,702000,659000,43000,43000,2021-06-09
2300,085800,嘉澤元大09購01,0,0,0,0,0,0,0,0,0,43000,0,0,0,446000,403000,43000,43000,2021-06-09
2301,032768,永光元大0C購01,0,0,0,0,0,0,0,0,0,43000,0,0,0,120000,77000,43000,43000,2021-06-09
2302,033158,百和元大0A購03,0,0,0,0,0,0,0,0,0,43000,0,0,0,43000,0,43000,43000,2021-06-09
2303,030532,泰豐凱基0B購01,0,0,0,0,0,0,0,0,0,43000,0,0,0,49000,6000,43000,43000,2021-06-09
2304,034426,智原統一0B購01,0,0,0,0,0,0,0,0,0,43000,0,0,0,116000,73000,43000,43000,2021-06-09
2305,034778,長榮富邦12購01,0,0,0,0,0,0,0,0,0,43000,0,0,0,43000,0,43000,43000,2021-06-09
2306,036172,中鋼麥證0C購03,0,0,0,49000,5000,44000,0,0,0,43000,0,0,0,49000,6000,43000,43000,2021-06-09
2307,035103,長榮元大0B購20,1000,1000,0,0,0,0,0,0,0,43000,0,0,0,625000,582000,43000,43000,2021-06-09
2308,035866,義隆元富0B購03,0,0,0,0,0,0,0,0,0,43000,0,0,0,43000,0,43000,43000,2021-06-09
2309,081103,台肥群益09購01,0,0,0,0,0,0,0,0,0,43000,0,0,0,96000,53000,43000,43000,2021-06-09
2310,06523P,聯電元大09售04,0,0,0,0,0,0,0,0,0,43000,0,0,0,63000,20000,43000,43000,2021-06-09
2311,06402P,祥碩元大08售09,0,0,0,0,0,0,0,0,0,43000,0,0,0,43000,0,43000,43000,2021-06-09
2312,3708,上緯投控,260000,211000,49000,0,0,0,0,0,0,-6000,0,0,0,1000,7000,-6000,43000,2021-06-09
2313,089916,達運凱基11購01,0,0,0,0,0,0,0,0,0,43000,0,0,0,55000,12000,43000,43000,2021-06-09
2314,089562,義隆統一0C購01,0,0,0,0,0,0,0,0,0,43000,0,0,0,94000,51000,43000,43000,2021-06-09
2315,088123,亞德客凱基09購02,0,0,0,0,0,0,0,0,0,42000,0,0,0,120000,78000,42000,42000,2021-06-09
2316,031500,台積電元大11購09,0,0,0,0,0,0,0,0,0,42000,0,0,0,44000,2000,42000,42000,2021-06-09
2317,034811,中鋼群益0B購14,0,0,0,0,0,0,0,0,0,42000,0,0,0,104000,62000,42000,42000,2021-06-09
2318,034868,矽格元大0B購01,0,0,0,0,0,0,0,0,0,42000,0,0,0,42000,0,42000,42000,2021-06-09
2319,035393,榮成永豐0B購01,0,0,0,0,0,0,0,0,0,42000,0,0,0,172000,130000,42000,42000,2021-06-09
2320,034167,開發金永豐0B購01,0,0,0,0,0,0,0,0,0,42000,0,0,0,42000,0,42000,42000,2021-06-09
2321,034222,萬海元富0B購04,0,0,0,0,0,0,0,0,0,42000,0,0,0,42000,0,42000,42000,2021-06-09
2322,034361,台積電麥證0B購05,0,0,0,42000,0,42000,0,0,0,42000,0,0,0,42000,0,42000,42000,2021-06-09
2323,06337P,台積電凱基08售30,0,0,0,0,0,0,0,0,0,42000,0,0,0,47000,5000,42000,42000,2021-06-09
2324,06365P,廣宇凱基08售02,0,0,0,0,0,0,0,0,0,42000,0,0,0,50000,8000,42000,42000,2021-06-09
2325,082868,日月光中信08購01,0,0,0,0,0,0,0,0,0,42000,0,0,0,42000,0,42000,42000,2021-06-09
2326,089147,崇越元大09購01,0,0,0,0,0,0,0,0,0,42000,0,0,0,42000,0,42000,42000,2021-06-09
2327,089241,京鼎永豐09購01,0,0,0,0,0,0,0,0,0,42000,0,0,0,147000,105000,42000,42000,2021-06-09
2328,9927,泰銘,179000,137000,42000,0,0,0,0,0,0,0,0,0,0,0,0,0,42000,2021-06-09
2329,3406,玉晶光,602766,510200,92566,0,0,0,0,0,0,-51089,35911,21000,14911,4000,70000,-66000,41477,2021-06-09
2330,088135,晶碩凱基09購01,0,0,0,0,0,0,0,0,0,41000,0,0,0,41000,0,41000,41000,2021-06-09
2331,086627,國巨凱基09購07,0,0,0,0,0,0,0,0,0,41000,0,0,0,82000,41000,41000,41000,2021-06-09
2332,085528,世紀鋼富邦0A購01,0,0,0,0,0,0,0,0,0,41000,0,0,0,44000,3000,41000,41000,2021-06-09
2333,031528,永豐餘富邦0C購01,0,0,0,0,0,0,0,0,0,41000,0,0,0,42000,1000,41000,41000,2021-06-09
2334,030525,臺股指群益0A購02,0,0,0,0,0,0,0,0,0,41000,0,0,0,89000,48000,41000,41000,2021-06-09
2335,031329,友達元大0C購07,0,0,0,0,0,0,0,0,0,41000,0,0,0,41000,0,41000,41000,2021-06-09
2336,036236,群創第一16購01,0,0,0,0,0,0,0,0,0,41000,0,0,0,53000,12000,41000,41000,2021-06-09
2337,036318,榮運統一12購01,0,0,0,0,0,0,0,0,0,41000,0,0,0,41000,0,41000,41000,2021-06-09
2338,033294,矽創統一11購02,0,0,0,0,0,0,0,0,0,41000,0,0,0,51000,10000,41000,41000,2021-06-09
2339,033507,晶技統一11購02,0,0,0,0,0,0,0,0,0,41000,0,0,0,115000,74000,41000,41000,2021-06-09
2340,06324P,創意元大08售03,0,0,0,0,0,0,0,0,0,41000,0,0,0,50000,9000,41000,41000,2021-06-09
2341,034515,南紡元富0B購03,0,0,0,0,0,0,0,0,0,41000,0,0,0,52000,11000,41000,41000,2021-06-09
2342,034355,玉晶光元富12購03,0,0,0,0,0,0,0,0,0,41000,0,0,0,41000,0,41000,41000,2021-06-09
2343,035436,欣興元大0C購02,0,0,0,0,0,0,0,0,0,41000,0,0,0,115000,74000,41000,41000,2021-06-09
2344,036055,台積電麥證11購04,0,0,0,41000,0,41000,0,0,0,41000,0,0,0,41000,0,41000,41000,2021-06-09
2345,035673,聯發科第一15購05,0,0,0,0,0,0,0,0,0,41000,0,0,0,41000,0,41000,41000,2021-06-09
2346,035780,新唐富邦0C購01,0,0,0,0,0,0,0,0,0,41000,0,0,0,237000,196000,41000,41000,2021-06-09
2347,079321,禾伸堂中信06購01,0,0,0,0,0,0,0,0,0,41000,0,0,0,51000,10000,41000,41000,2021-06-09
2348,07026P,台表科凱基0B售02,0,0,0,0,0,0,0,0,0,41000,0,0,0,46000,5000,41000,41000,2021-06-09
2349,069982,大立光凱基06購02,0,0,0,0,0,0,0,0,0,41000,0,0,0,41000,0,41000,41000,2021-06-09
2350,076436,健策國票06購03,0,0,0,0,0,0,0,0,0,41000,0,0,0,41000,0,41000,41000,2021-06-09
2351,078941,嘉晶中信08購01,0,0,0,0,0,0,0,0,0,41000,0,0,0,41000,0,41000,41000,2021-06-09
2352,077000,世芯國票06購02,0,0,0,0,0,0,0,0,0,41000,0,0,0,41000,0,41000,41000,2021-06-09
2353,089742,滬深2X統一0B購04,0,0,0,0,0,0,0,0,0,41000,0,0,0,41000,0,41000,41000,2021-06-09
2354,8499,鼎炫-KY,43000,2000,41000,0,0,0,0,0,0,0,0,0,0,0,0,0,41000,2021-06-09
2355,085565,日月光群益08購02,0,0,0,0,0,0,0,0,0,40000,0,0,0,40000,0,40000,40000,2021-06-09
2356,085506,乙盛凱基08購02,0,0,0,0,0,0,0,0,0,40000,0,0,0,58000,18000,40000,40000,2021-06-09
2357,085442,創意統一0B購01,0,0,0,0,0,0,0,0,0,40000,0,0,0,40000,0,40000,40000,2021-06-09
2358,085861,聯詠統一0A購05,0,0,0,0,0,0,0,0,0,40000,0,0,0,40000,0,40000,40000,2021-06-09
2359,085831,欣興群益09購02,0,0,0,0,0,0,0,0,0,40000,0,0,0,40000,0,40000,40000,2021-06-09
2360,086143,光寶科元大08購01,0,0,0,0,0,0,0,0,0,40000,0,0,0,40000,0,40000,40000,2021-06-09
2361,084512,凌陽元大08購03,0,0,0,0,0,0,0,0,0,40000,0,0,0,60000,20000,40000,40000,2021-06-09
2362,083969,嘉澤凱基07購02,0,0,0,0,0,0,0,0,0,40000,0,0,0,40000,0,40000,40000,2021-06-09
2363,083446,臻鼎凱基09購01,0,0,0,0,0,0,0,0,0,40000,0,0,0,40000,0,40000,40000,2021-06-09
2364,083531,華新科元大07購10,0,0,0,0,0,0,0,0,0,40000,0,0,0,40000,0,40000,40000,2021-06-09
2365,086951,臻鼎元大09購01,0,0,0,0,0,0,0,0,0,40000,0,0,0,100000,60000,40000,40000,2021-06-09
2366,087916,晶豪科群益0A購03,0,0,0,0,0,0,0,0,0,40000,0,0,0,40000,0,40000,40000,2021-06-09
2367,088680,寶成元大09購01,0,0,0,0,0,0,0,0,0,40000,0,0,0,60000,20000,40000,40000,2021-06-09
2368,088802,鴻海元大09購19,0,0,0,0,0,0,0,0,0,40000,0,0,0,40000,0,40000,40000,2021-06-09
2369,088872,立積永豐09購06,0,0,0,0,0,0,0,0,0,40000,0,0,0,217000,177000,40000,40000,2021-06-09
2370,088468,台積電元富09購08,0,0,0,0,0,0,0,0,0,40000,0,0,0,40000,0,40000,40000,2021-06-09
2371,032423,大成鋼元大0A購10,0,0,0,0,0,0,0,0,0,40000,0,0,0,40000,0,40000,40000,2021-06-09
2372,031684,正文中信0A購01,0,0,0,0,0,0,0,0,0,40000,0,0,0,40000,0,40000,40000,2021-06-09
2373,031952,中鋼元大12購02,0,0,0,0,0,0,0,0,0,40000,0,0,0,40000,0,40000,40000,2021-06-09
2374,031977,世紀鋼元大0C購02,0,0,0,0,0,0,0,0,0,40000,0,0,0,40000,0,40000,40000,2021-06-09
2375,030892,南紡凱基0A購01,0,0,0,0,0,0,0,0,0,40000,0,0,0,180000,140000,40000,40000,2021-06-09
2376,030913,申豐凱基0B購03,0,0,0,0,0,0,0,0,0,40000,0,0,0,40000,0,40000,40000,2021-06-09
2377,030915,致新凱基0B購01,0,0,0,0,0,0,0,0,0,40000,0,0,0,40000,0,40000,40000,2021-06-09
2378,031041,乙盛凱基0A購03,0,0,0,0,0,0,0,0,0,40000,0,0,0,40000,0,40000,40000,2021-06-09
2379,035822,儒鴻元大11購01,0,0,0,0,0,0,0,0,0,40000,0,0,0,59000,19000,40000,40000,2021-06-09
2380,035500,玉晶光國泰12購01,0,0,0,0,0,0,0,0,0,40000,0,0,0,61000,21000,40000,40000,2021-06-09
2381,035450,順德國票0C購01,0,0,0,0,0,0,0,0,0,40000,0,0,0,53000,13000,40000,40000,2021-06-09
2382,034886,健策群益0B購02,0,0,0,0,0,0,0,0,0,40000,0,0,0,169000,129000,40000,40000,2021-06-09
2383,035086,春源凱基11購01,0,0,0,0,0,0,0,0,0,40000,0,0,0,40000,0,40000,40000,2021-06-09
2384,05777P,愛普統一07售05,0,0,0,0,0,0,0,0,0,40000,0,0,0,40000,0,40000,40000,2021-06-09
2385,05895P,台積電國票07售07,0,0,0,0,0,0,0,0,0,40000,0,0,0,40000,0,40000,40000,2021-06-09
2386,034570,大立光富邦0C購02,0,0,0,0,0,0,0,0,0,40000,0,0,0,50000,10000,40000,40000,2021-06-09
2387,033766,安普新凱基0B購01,0,0,0,0,0,0,0,0,0,40000,0,0,0,40000,0,40000,40000,2021-06-09
2388,03552P,上銀元富08售02,0,0,0,0,0,0,0,0,0,40000,0,0,0,40000,0,40000,40000,2021-06-09
2389,076800,聯發科國票07購05,0,0,0,0,0,0,0,0,0,40000,0,0,0,73000,33000,40000,40000,2021-06-09
2390,077910,聯茂凱基07購01,0,0,0,0,0,0,0,0,0,40000,0,0,0,70000,30000,40000,40000,2021-06-09
2391,078190,金像電元大07購01,0,0,0,0,0,0,0,0,0,40000,0,0,0,40000,0,40000,40000,2021-06-09
2392,078793,滬深2X凱基07購02,0,0,0,0,0,0,0,0,0,40000,0,0,0,110000,70000,40000,40000,2021-06-09
2393,078287,和大國票07購01,0,0,0,0,0,0,0,0,0,40000,0,0,0,40000,0,40000,40000,2021-06-09
2394,073759,華新科元富07購01,0,0,0,0,0,0,0,0,0,40000,0,0,0,40000,0,40000,40000,2021-06-09
2395,072980,國巨元富07購21,0,0,0,0,0,0,0,0,0,40000,0,0,0,40000,0,40000,40000,2021-06-09
2396,06495P,晶豪科凱基09售04,0,0,0,0,0,0,0,0,0,40000,0,0,0,40000,0,40000,40000,2021-06-09
2397,06685P,聯電元大09售08,0,0,0,0,0,0,0,0,0,40000,0,0,0,50000,10000,40000,40000,2021-06-09
2398,079560,永冠國票07購01,0,0,0,0,0,0,0,0,0,40000,0,0,0,50000,10000,40000,40000,2021-06-09
2399,080354,台灣50元富07購01,0,0,0,0,0,0,0,0,0,40000,0,0,0,40000,0,40000,40000,2021-06-09
2400,081111,圓剛群益09購03,0,0,0,0,0,0,0,0,0,40000,0,0,0,40000,0,40000,40000,2021-06-09
2401,080868,臻鼎統一08購02,0,0,0,0,0,0,0,0,0,40000,0,0,0,40000,0,40000,40000,2021-06-09
2402,082843,立隆電國票07購01,0,0,0,0,0,0,0,0,0,40000,0,0,0,40000,0,40000,40000,2021-06-09
2403,081560,台勝科永豐07購01,0,0,0,0,0,0,0,0,0,40000,0,0,0,50000,10000,40000,40000,2021-06-09
2404,081442,大毅統一0A購01,0,0,0,0,0,0,0,0,0,40000,0,0,0,40000,0,40000,40000,2021-06-09
2405,083412,精英永豐07購01,0,0,0,0,0,0,0,0,0,40000,0,0,0,40000,0,40000,40000,2021-06-09
2406,089567,國巨中信0B購02,0,0,0,0,0,0,0,0,0,40000,0,0,0,40000,0,40000,40000,2021-06-09
2407,089766,正隆凱基11購01,0,0,0,0,0,0,0,0,0,40000,0,0,0,43000,3000,40000,40000,2021-06-09
2408,088914,立積群益0C購01,0,0,0,0,0,0,0,0,0,39000,0,0,0,96000,57000,39000,39000,2021-06-09
2409,088976,聯發科元富09購10,0,0,0,0,0,0,0,0,0,39000,0,0,0,42000,3000,39000,39000,2021-06-09
2410,088806,台積電元大11購07,0,0,0,0,0,0,0,0,0,39000,0,0,0,80000,41000,39000,39000,2021-06-09
2411,084019,凱美統一08購01,0,0,0,0,0,0,0,0,0,39000,0,0,0,195000,156000,39000,39000,2021-06-09
2412,084158,國喬凱基08購01,0,0,0,0,0,0,0,0,0,39000,0,0,0,124000,85000,39000,39000,2021-06-09
2413,06296P,聯詠凱基08售04,0,0,0,0,0,0,0,0,0,39000,0,0,0,39000,0,39000,39000,2021-06-09
2414,035395,萬海永豐0B購04,0,0,0,0,0,0,0,0,0,39000,0,0,0,51000,12000,39000,39000,2021-06-09
2415,035907,和碩群益0C購01,0,0,0,0,0,0,0,0,0,39000,0,0,0,39000,0,39000,39000,2021-06-09
2416,081097,大成群益0A購01,0,0,0,0,0,0,0,0,0,39000,0,0,0,41000,2000,39000,39000,2021-06-09
2417,074411,欣興元大07購01,0,0,0,0,0,0,0,0,0,39000,0,0,0,90000,51000,39000,39000,2021-06-09
2418,074638,滬深2X國票06購01,0,0,0,0,0,0,0,0,0,39000,0,0,0,39000,0,39000,39000,2021-06-09
2419,078106,和桐元富0C購01,0,0,0,0,0,0,0,0,0,39000,0,0,0,39000,0,39000,39000,2021-06-09
2420,089420,聯電永豐0C購01,0,0,0,0,0,0,0,0,0,39000,0,0,0,104000,65000,39000,39000,2021-06-09
2421,3645,達邁,69000,30000,39000,0,0,0,0,0,0,0,0,0,0,0,0,0,39000,2021-06-09
2422,9935,慶豐富,57000,18000,39000,0,0,0,0,0,0,0,0,0,0,0,0,0,39000,2021-06-09
2423,8028,昇陽半導體,121000,82000,39000,0,0,0,0,0,0,0,0,0,0,0,0,0,39000,2021-06-09
2424,6531,愛普,677002,620000,57002,0,0,0,0,48000,-48000,29130,58081,66951,-8870,57000,19000,38000,38132,2021-06-09
2425,083552,志超元大07購01,0,0,0,0,0,0,0,0,0,38000,0,0,0,88000,50000,38000,38000,2021-06-09
2426,086169,景碩元大08購02,0,0,0,0,0,0,0,0,0,38000,0,0,0,39000,1000,38000,38000,2021-06-09
2427,086323,臺股指凱基11購02,0,0,0,0,0,0,0,0,0,38000,0,0,0,42000,4000,38000,38000,2021-06-09
2428,085192,滬深2X群益09購02,0,0,0,0,0,0,0,0,0,38000,0,0,0,48000,10000,38000,38000,2021-06-09
2429,086947,群創元大09購10,0,0,0,0,0,0,0,0,0,38000,0,0,0,38000,0,38000,38000,2021-06-09
2430,00646,元大S&P500,4000,8000,-4000,0,0,0,0,0,0,42000,0,0,0,95000,53000,42000,38000,2021-06-09
2431,033309,上銀元富0B購02,0,0,0,0,0,0,0,0,0,38000,0,0,0,241000,203000,38000,38000,2021-06-09
2432,031724,富邦金群益0C購02,0,0,0,0,0,0,0,0,0,38000,0,0,0,38000,0,38000,38000,2021-06-09
2433,031809,東鋼元大0A購06,0,0,0,0,0,0,0,0,0,38000,0,0,0,38000,0,38000,38000,2021-06-09
2434,032362,強茂凱基0C購01,0,0,0,0,0,0,0,0,0,38000,0,0,0,100000,62000,38000,38000,2021-06-09
2435,035811,榮運凱基13購01,0,0,0,0,0,0,0,0,0,38000,0,0,0,38000,0,38000,38000,2021-06-09
2436,034294,萬海中信12購01,0,0,0,0,0,0,0,0,0,38000,0,0,0,38000,0,38000,38000,2021-06-09
2437,035219,永豐餘國泰11購01,0,0,0,0,0,0,0,0,0,38000,0,0,0,38000,0,38000,38000,2021-06-09
2438,035297,新唐國票0C購02,0,0,0,0,0,0,0,0,0,38000,0,0,0,44000,6000,38000,38000,2021-06-09
2439,035050,友達富邦11購04,4000,0,4000,0,0,0,0,0,0,34000,0,0,0,48000,14000,34000,38000,2021-06-09
2440,035530,亞光群益0B購02,0,0,0,0,0,0,0,0,0,38000,0,0,0,38000,0,38000,38000,2021-06-09
2441,034794,長榮中信0B購01,0,0,0,0,0,0,0,0,0,38000,0,0,0,66000,28000,38000,38000,2021-06-09
2442,05882P,臺股指群益07售12,0,0,0,0,0,0,0,0,0,38000,0,0,0,39000,1000,38000,38000,2021-06-09
2443,05842P,臺股指元大0A售04,0,0,0,0,0,0,0,0,0,38000,0,0,0,40000,2000,38000,38000,2021-06-09
2444,034054,元大金麥證0B購01,0,0,0,38000,0,38000,0,0,0,38000,0,0,0,38000,0,38000,38000,2021-06-09
2445,06820P,臺股指凱基0A售11,0,0,0,0,0,0,0,0,0,38000,0,0,0,39000,1000,38000,38000,2021-06-09
2446,07066P,臺股指麥證0B售02,0,0,0,48000,10000,38000,0,0,0,38000,0,0,0,48000,10000,38000,38000,2021-06-09
2447,081661,長榮永豐07購06,0,0,0,0,0,0,0,0,0,38000,0,0,0,73000,35000,38000,38000,2021-06-09
2448,6285,啟碁,230000,172000,58000,0,0,0,0,0,0,-20000,2000,2000,0,5000,25000,-20000,38000,2021-06-09
2449,2425,承啟,212000,175000,37000,0,0,0,0,0,0,100,100,0,100,0,0,0,37100,2021-06-09
2450,087694,群創元大0B購04,0,0,0,0,0,0,0,0,0,37000,0,0,0,50000,13000,37000,37000,2021-06-09
2451,032596,長榮元大0B購07,0,0,0,0,0,0,0,0,0,37000,0,0,0,37000,0,37000,37000,2021-06-09
2452,030051,景碩元大0A購03,0,0,0,0,0,0,0,0,0,37000,0,0,0,49000,12000,37000,37000,2021-06-09
2453,032783,長榮元大0C購08,0,0,0,0,0,0,0,0,0,37000,0,0,0,37000,0,37000,37000,2021-06-09
2454,032787,長榮航元大0A購04,0,0,0,0,0,0,0,0,0,37000,0,0,0,37000,0,37000,37000,2021-06-09
2455,033848,東聯永豐0B購01,0,0,0,0,0,0,0,0,0,37000,0,0,0,37000,0,37000,37000,2021-06-09
2456,033804,欣興國票0C購02,0,0,0,0,0,0,0,0,0,37000,0,0,0,161000,124000,37000,37000,2021-06-09
2457,033786,友達元大0B購07,0,0,0,0,0,0,0,0,0,37000,0,0,0,117000,80000,37000,37000,2021-06-09
2458,034735,華新科元大0C購04,0,0,0,0,0,0,0,0,0,37000,0,0,0,1123000,1086000,37000,37000,2021-06-09
2459,035880,玉晶光群益11購03,0,0,0,0,0,0,0,0,0,37000,0,0,0,50000,13000,37000,37000,2021-06-09
2460,082379,T50反1兆豐0C購02,0,0,0,0,0,0,0,0,0,37000,0,0,0,42000,5000,37000,37000,2021-06-09
2461,07128P,長榮富邦12售02,9000,0,9000,0,0,0,0,0,0,28000,0,0,0,122000,94000,28000,37000,2021-06-09
2462,083321,南茂元大07購01,0,0,0,0,0,0,0,0,0,37000,0,0,0,56000,19000,37000,37000,2021-06-09
2463,3030,德律,87000,48000,39000,0,0,0,0,0,0,-2000,0,0,0,0,2000,-2000,37000,2021-06-09
2464,089421,宏碁永豐09購02,0,0,0,0,0,0,0,0,0,37000,0,0,0,40000,3000,37000,37000,2021-06-09
2465,087766,儒鴻中信09購01,0,0,0,0,0,0,0,0,0,36000,0,0,0,117000,81000,36000,36000,2021-06-09
2466,086651,東聯兆豐09購01,0,0,0,0,0,0,0,0,0,36000,0,0,0,128000,92000,36000,36000,2021-06-09
2467,087605,玉晶光中信09購02,0,0,0,0,0,0,0,0,0,36000,0,0,0,36000,0,36000,36000,2021-06-09
2468,086163,聯陽元大09購01,0,0,0,0,0,0,0,0,0,36000,0,0,0,40000,4000,36000,36000,2021-06-09
2469,086032,聯陽永豐08購03,0,0,0,0,0,0,0,0,0,36000,0,0,0,36000,0,36000,36000,2021-06-09
2470,083927,台灣50中信0B購01,0,0,0,0,0,0,0,0,0,36000,0,0,0,36000,0,36000,36000,2021-06-09
2471,032801,台泥國票0B購01,0,0,0,0,0,0,0,0,0,36000,0,0,0,56000,20000,36000,36000,2021-06-09
2472,068031,致茂元富07購01,0,0,0,0,0,0,0,0,0,36000,0,0,0,56000,20000,36000,36000,2021-06-09
2473,06415P,台表科元大09售01,0,0,0,0,0,0,0,0,0,36000,0,0,0,47000,11000,36000,36000,2021-06-09
2474,078235,健鼎元富0C購01,0,0,0,0,0,0,0,0,0,36000,0,0,0,36000,0,36000,36000,2021-06-09
2475,07192P,上銀元富0B售04,0,0,0,0,0,0,0,0,0,36000,0,0,0,36000,0,36000,36000,2021-06-09
2476,082745,健策群益08購04,0,0,0,0,0,0,0,0,0,36000,0,0,0,53000,17000,36000,36000,2021-06-09
2477,082650,金像電永豐07購01,0,0,0,0,0,0,0,0,0,36000,0,0,0,76000,40000,36000,36000,2021-06-09
2478,080532,欣興群益07購03,0,0,0,0,0,0,0,0,0,36000,0,0,0,36000,0,36000,36000,2021-06-09
2479,079343,滬深2X凱基08購03,0,0,0,0,0,0,0,0,0,36000,0,0,0,436000,400000,36000,36000,2021-06-09
2480,6438,迅得,123000,87000,36000,0,0,0,0,0,0,0,0,0,0,1000,1000,0,36000,2021-06-09
2481,8454,富邦媒,222000,194066,27934,0,0,0,0,0,0,7824,11000,3176,7824,0,0,0,35758,2021-06-09
2482,083480,世紀鋼統一09購04,0,0,0,0,0,0,0,0,0,35000,0,0,0,35000,0,35000,35000,2021-06-09
2483,084519,祥碩元大08購03,0,0,0,0,0,0,0,0,0,35000,0,0,0,35000,0,35000,35000,2021-06-09
2484,084472,國巨凱基08購09,0,0,0,0,0,0,0,0,0,35000,0,0,0,35000,0,35000,35000,2021-06-09
2485,085414,欣興元大08購04,0,0,0,0,0,0,0,0,0,35000,0,0,0,35000,0,35000,35000,2021-06-09
2486,086634,友達凱基0A購01,0,0,0,0,0,0,0,0,0,35000,0,0,0,39000,4000,35000,35000,2021-06-09
2487,086640,晶技凱基0A購01,0,0,0,0,0,0,0,0,0,35000,0,0,0,99000,64000,35000,35000,2021-06-09
2488,087023,世紀鋼永豐09購01,0,0,0,0,0,0,0,0,0,35000,0,0,0,35000,0,35000,35000,2021-06-09
2489,086808,南六統一0B購01,0,0,0,0,0,0,0,0,0,35000,0,0,0,95000,60000,35000,35000,2021-06-09
2490,088193,漢唐群益09購01,0,0,0,0,0,0,0,0,0,35000,0,0,0,61000,26000,35000,35000,2021-06-09
2491,088942,立積統一11購01,0,0,0,0,0,0,0,0,0,35000,0,0,0,55000,20000,35000,35000,2021-06-09
2492,088487,上証2X元大0C購02,0,0,0,0,0,0,0,0,0,35000,0,0,0,35000,0,35000,35000,2021-06-09
2493,030925,南亞科群益0A購02,0,0,0,0,0,0,0,0,0,35000,0,0,0,35000,0,35000,35000,2021-06-09
2494,030223,康普凱基0C購01,0,0,0,0,0,0,0,0,0,35000,0,0,0,45000,10000,35000,35000,2021-06-09
2495,031345,立積元大0A購06,0,0,0,0,0,0,0,0,0,35000,0,0,0,35000,0,35000,35000,2021-06-09
2496,05508P,智邦國票07售03,0,0,0,0,0,0,0,0,0,35000,0,0,0,48000,13000,35000,35000,2021-06-09
2497,032152,台航凱基0A購02,0,0,0,0,0,0,0,0,0,35000,0,0,0,35000,0,35000,35000,2021-06-09
2498,033609,智邦群益0B購01,0,0,0,0,0,0,0,0,0,35000,0,0,0,48000,13000,35000,35000,2021-06-09
2499,032401,元黃金元大11購01,0,0,0,0,0,0,0,0,0,35000,0,0,0,35000,0,35000,35000,2021-06-09
2500,032334,旺宏群益0C購04,0,0,0,0,0,0,0,0,0,35000,0,0,0,39000,4000,35000,35000,2021-06-09
2501,032339,王品群益0A購02,0,0,0,0,0,0,0,0,0,35000,0,0,0,50000,15000,35000,35000,2021-06-09
2502,032288,長榮中信0C購05,0,0,0,0,0,0,0,0,0,35000,0,0,0,45000,10000,35000,35000,2021-06-09
2503,035915,宏碁永豐0C購01,0,0,0,0,0,0,0,0,0,35000,0,0,0,38000,3000,35000,35000,2021-06-09
2504,033967,榮成凱基0C購01,0,0,0,0,0,0,0,0,0,35000,0,0,0,35000,0,35000,35000,2021-06-09
2505,036004,台玻凱基0C購04,0,0,0,0,0,0,0,0,0,35000,0,0,0,40000,5000,35000,35000,2021-06-09
2506,035027,義隆凱基0B購03,0,0,0,0,0,0,0,0,0,35000,0,0,0,90000,55000,35000,35000,2021-06-09
2507,05770P,台灣50群益08售04,0,0,0,0,0,0,0,0,0,35000,0,0,0,45000,10000,35000,35000,2021-06-09
2508,034608,聯詠統一0C購05,0,0,0,0,0,0,0,0,0,35000,0,0,0,83000,48000,35000,35000,2021-06-09
2509,05870P,玉晶光元大08售04,0,0,0,0,0,0,0,0,0,35000,0,0,0,52000,17000,35000,35000,2021-06-09
2510,06137P,台積電統一09售18,0,0,0,0,0,0,0,0,0,35000,0,0,0,35000,0,35000,35000,2021-06-09
2511,05998P,大立光元大07售07,0,0,0,0,0,0,0,0,0,35000,0,0,0,35000,0,35000,35000,2021-06-09
2512,05977P,臺股指國票0A售09,0,0,0,0,0,0,0,0,0,35000,0,0,0,35000,0,35000,35000,2021-06-09
2513,079134,新光鋼元大06購02,0,0,0,0,0,0,0,0,0,35000,0,0,0,35000,0,35000,35000,2021-06-09
2514,079176,大成富邦07購01,0,0,0,0,0,0,0,0,0,35000,0,0,0,35000,0,35000,35000,2021-06-09
2515,080035,台泥永豐06購01,0,0,0,0,0,0,0,0,0,35000,0,0,0,35000,0,35000,35000,2021-06-09
2516,081346,滬深2X凱基0A購01,0,0,0,0,0,0,0,0,0,35000,0,0,0,420000,385000,35000,35000,2021-06-09
2517,082731,台積電群益08購09,0,0,0,0,0,0,0,0,0,35000,0,0,0,50000,15000,35000,35000,2021-06-09
2518,082713,健策凱基09購01,0,0,0,0,0,0,0,0,0,35000,0,0,0,44000,9000,35000,35000,2021-06-09
2519,082973,金像電元大08購01,0,0,0,0,0,0,0,0,0,35000,0,0,0,50000,15000,35000,35000,2021-06-09
2520,082275,台積電元大07購14,0,0,0,0,0,0,0,0,0,35000,0,0,0,35000,0,35000,35000,2021-06-09
2521,078071,國巨國票08購03,0,0,0,0,0,0,0,0,0,35000,0,0,0,35000,0,35000,35000,2021-06-09
2522,06384P,聯詠統一08售04,0,0,0,0,0,0,0,0,0,35000,0,0,0,35000,0,35000,35000,2021-06-09
2523,07132P,臺股指中信13售01,0,0,0,0,0,0,0,0,0,35000,0,0,0,35000,0,35000,35000,2021-06-09
2524,07155P,長榮元大0B售16,0,0,0,0,0,0,0,0,0,35000,0,0,0,335000,300000,35000,35000,2021-06-09
2525,069825,滬深2X元富08購01,0,0,0,0,0,0,0,0,0,35000,0,0,0,35000,0,35000,35000,2021-06-09
2526,083385,元石油富邦08購03,0,0,0,0,0,0,0,0,0,35000,0,0,0,35000,0,35000,35000,2021-06-09
2527,089536,申豐元大09購03,0,0,0,0,0,0,0,0,0,35000,0,0,0,35000,0,35000,35000,2021-06-09
2528,089512,漢唐元大09購03,0,0,0,0,0,0,0,0,0,35000,0,0,0,50000,15000,35000,35000,2021-06-09
2529,089475,新唐國票0A購02,0,0,0,0,0,0,0,0,0,35000,0,0,0,35000,0,35000,35000,2021-06-09
2530,089744,鴻海統一11購08,0,0,0,0,0,0,0,0,0,35000,0,0,0,35000,0,35000,35000,2021-06-09
2531,089982,聯詠元大0C購06,0,0,0,0,0,0,0,0,0,35000,0,0,0,35000,0,35000,35000,2021-06-09
2532,086892,力麗群益0B購01,0,0,0,0,0,0,0,0,0,34000,0,0,0,34000,0,34000,34000,2021-06-09
2533,087371,華夏元大0B購01,0,0,0,0,0,0,0,0,0,34000,0,0,0,34000,0,34000,34000,2021-06-09
2534,086365,義隆康和09購01,0,0,0,0,0,0,0,0,0,34000,0,0,0,129000,95000,34000,34000,2021-06-09
2535,083499,志超元富07購01,0,0,0,0,0,0,0,0,0,34000,0,0,0,100000,66000,34000,34000,2021-06-09
2536,089032,國巨中信09購05,0,0,0,0,0,0,0,0,0,34000,0,0,0,52000,18000,34000,34000,2021-06-09
2537,033102,長榮元富0A購19,0,0,0,0,0,0,0,0,0,34000,0,0,0,34000,0,34000,34000,2021-06-09
2538,033048,華新永豐0A購03,0,0,0,0,0,0,0,0,0,34000,0,0,0,48000,14000,34000,34000,2021-06-09
2539,033587,萬海凱基15購01,0,0,0,0,0,0,0,0,0,34000,0,0,0,37000,3000,34000,34000,2021-06-09
2540,032498,台玻永豐0A購04,0,0,0,0,0,0,0,0,0,34000,0,0,0,34000,0,34000,34000,2021-06-09
2541,036306,矽創元大0C購04,0,0,0,0,0,0,0,0,0,34000,0,0,0,190000,156000,34000,34000,2021-06-09
2542,031791,新光鋼國票0B購01,0,0,0,0,0,0,0,0,0,34000,0,0,0,49000,15000,34000,34000,2021-06-09
2543,031432,長榮航凱基0A購04,0,0,0,0,0,0,0,0,0,34000,0,0,0,34000,0,34000,34000,2021-06-09
2544,030611,盟立元大0A購01,0,0,0,0,0,0,0,0,0,34000,0,0,0,34000,0,34000,34000,2021-06-09
2545,033220,欣興元富0B購03,0,0,0,0,0,0,0,0,0,34000,0,0,0,72000,38000,34000,34000,2021-06-09
2546,031175,大亞永豐0A購01,0,0,0,0,0,0,0,0,0,34000,0,0,0,34000,0,34000,34000,2021-06-09
2547,030745,長榮元大11購02,0,0,0,0,0,0,0,0,0,34000,0,0,0,34000,0,34000,34000,2021-06-09
2548,03553P,可成元富08售03,0,0,0,0,0,0,0,0,0,34000,0,0,0,34000,0,34000,34000,2021-06-09
2549,035541,東鋼統一0B購04,0,0,0,0,0,0,0,0,0,34000,0,0,0,34000,0,34000,34000,2021-06-09
2550,034768,長榮國票0C購01,0,0,0,0,0,0,0,0,0,34000,0,0,0,65000,31000,34000,34000,2021-06-09
2551,035322,萬海元大0B購10,0,0,0,0,0,0,0,0,0,34000,0,0,0,153000,119000,34000,34000,2021-06-09
2552,035166,友達國票0C購04,0,0,0,0,0,0,0,0,0,34000,0,0,0,34000,0,34000,34000,2021-06-09
2553,083347,和碩統一08購01,0,0,0,0,0,0,0,0,0,34000,0,0,0,34000,0,34000,34000,2021-06-09
2554,07001P,台灣5G元大11售01,0,0,0,0,0,0,0,0,0,34000,0,0,0,64000,30000,34000,34000,2021-06-09
2555,06907P,台灣50群益0A售06,0,0,0,0,0,0,0,0,0,34000,0,0,0,54000,20000,34000,34000,2021-06-09
2556,078099,長華統一08購02,0,0,0,0,0,0,0,0,0,34000,0,0,0,44000,10000,34000,34000,2021-06-09
2557,076208,臺股指國票09購03,0,0,0,0,0,0,0,0,0,34000,0,0,0,34000,0,34000,34000,2021-06-09
2558,083152,滬深2X群益07購04,0,0,0,0,0,0,0,0,0,34000,0,0,0,34000,0,34000,34000,2021-06-09
2559,089950,台灣50元大0A購17,0,0,0,0,0,0,0,0,0,34000,0,0,0,60000,26000,34000,34000,2021-06-09
2560,9946,三發地產,43000,9000,34000,0,0,0,0,0,0,0,0,0,0,0,0,0,34000,2021-06-09
2561,085358,玉晶光永豐08購03,0,0,0,0,0,0,0,0,0,33000,0,0,0,33000,0,33000,33000,2021-06-09
2562,087469,台郡國票0A購02,0,0,0,0,0,0,0,0,0,33000,0,0,0,50000,17000,33000,33000,2021-06-09
2563,030034,國喬元大0C購01,0,0,0,0,0,0,0,0,0,33000,0,0,0,33000,0,33000,33000,2021-06-09
2564,00678,群益NBI生技,10000,0,10000,0,0,0,0,0,0,23000,0,0,0,323000,300000,23000,33000,2021-06-09
2565,031773,長榮統一11購02,0,0,0,0,0,0,0,0,0,33000,0,0,0,38000,5000,33000,33000,2021-06-09
2566,036254,晶碩凱基11購01,0,0,0,0,0,0,0,0,0,33000,0,0,0,33000,0,33000,33000,2021-06-09
2567,031870,春源凱基0C購01,0,0,0,0,0,0,0,0,0,33000,0,0,0,53000,20000,33000,33000,2021-06-09
2568,034901,新纖元大0B購04,0,0,0,0,0,0,0,0,0,33000,0,0,0,59000,26000,33000,33000,2021-06-09
2569,05990P,國巨元富07售34,0,0,0,0,0,0,0,0,0,33000,0,0,0,50000,17000,33000,33000,2021-06-09
2570,06022P,鴻海凱基08售10,0,0,0,0,0,0,0,0,0,33000,0,0,0,160000,127000,33000,33000,2021-06-09
2571,036131,鴻準凱基0C購01,0,0,0,0,0,0,0,0,0,33000,0,0,0,59000,26000,33000,33000,2021-06-09
2572,034727,中鋼元大0B購10,1000,0,1000,0,0,0,0,0,0,32000,0,0,0,358000,326000,32000,33000,2021-06-09
2573,034632,亞德客元大0B購03,0,0,0,0,0,0,0,0,0,33000,0,0,0,78000,45000,33000,33000,2021-06-09
2574,06905P,臺股指中信12售02,0,0,0,0,0,0,0,0,0,33000,0,0,0,46000,13000,33000,33000,2021-06-09
2575,06773P,臺股指群益0A售04,0,0,0,0,0,0,0,0,0,33000,0,0,0,142000,109000,33000,33000,2021-06-09
2576,6416,瑞祺電通,110000,75000,35000,0,0,0,0,0,0,-2000,0,0,0,0,2000,-2000,33000,2021-06-09
2577,6155,鈞寶,67000,34000,33000,0,0,0,0,0,0,0,0,0,0,0,0,0,33000,2021-06-09
2578,1592,英瑞-KY,33000,0,33000,0,0,0,0,0,0,0,0,0,0,0,0,0,33000,2021-06-09
2579,1702,南僑,246000,165000,81000,0,0,0,0,0,0,-48238,0,46000,-46000,1000,3238,-2238,32762,2021-06-09
2580,087060,台達化群益0A購01,0,0,0,0,0,0,0,0,0,32000,0,0,0,32000,0,32000,32000,2021-06-09
2581,086773,聯詠凱基09購03,0,0,0,0,0,0,0,0,0,32000,0,0,0,135000,103000,32000,32000,2021-06-09
2582,089004,國巨元大0B購02,0,0,0,0,0,0,0,0,0,32000,0,0,0,32000,0,32000,32000,2021-06-09
2583,088055,美食元大09購02,0,0,0,0,0,0,0,0,0,32000,0,0,0,32000,0,32000,32000,2021-06-09
2584,088064,嘉聯益元大0A購01,0,0,0,0,0,0,0,0,0,32000,0,0,0,32000,0,32000,32000,2021-06-09
2585,085246,聯發科中信0C購01,0,0,0,0,0,0,0,0,0,32000,0,0,0,32000,0,32000,32000,2021-06-09
2586,085260,瑞儀國泰0A購01,0,0,0,0,0,0,0,0,0,32000,0,0,0,51000,19000,32000,32000,2021-06-09
2587,086318,彩晶凱基0B購02,0,0,0,0,0,0,0,0,0,32000,0,0,0,32000,0,32000,32000,2021-06-09
2588,085952,美德醫群益08購01,0,0,0,0,0,0,0,0,0,32000,0,0,0,80000,48000,32000,32000,2021-06-09
2589,033360,聯發科群益0B購02,0,0,0,0,0,0,0,0,0,32000,0,0,0,32000,0,32000,32000,2021-06-09
2590,031741,新光鋼凱基0C購01,0,0,0,0,0,0,0,0,0,32000,0,0,0,182000,150000,32000,32000,2021-06-09
2591,030704,聯詠群益0A購03,0,0,0,0,0,0,0,0,0,32000,0,0,0,32000,0,32000,32000,2021-06-09
2592,031620,中鋼統一12購01,0,0,0,0,0,0,0,0,0,32000,0,0,0,32000,0,32000,32000,2021-06-09
2593,034540,大成鋼統一0C購04,0,0,0,0,0,0,0,0,0,32000,0,0,0,39000,7000,32000,32000,2021-06-09
2594,034412,大亞統一0B購03,0,0,0,0,0,0,0,0,0,32000,0,0,0,32000,0,32000,32000,2021-06-09
2595,034950,華邦電凱基11購03,0,0,0,0,0,0,0,0,0,32000,0,0,0,32000,0,32000,32000,2021-06-09
2596,05783P,臺股指中信0B售08,0,0,0,0,0,0,0,0,0,32000,0,0,0,32000,0,32000,32000,2021-06-09
2597,06778P,臻鼎凱基0A售01,0,0,0,0,0,0,0,0,0,32000,0,0,0,32000,0,32000,32000,2021-06-09
2598,06389P,T50正2群益09售04,0,0,0,0,0,0,0,0,0,32000,0,0,0,32000,0,32000,32000,2021-06-09
2599,06535P,日月光國票0A售03,0,0,0,0,0,0,0,0,0,32000,0,0,0,32000,0,32000,32000,2021-06-09
2600,07215P,大立光元富0B售04,0,0,0,0,0,0,0,0,0,32000,0,0,0,50000,18000,32000,32000,2021-06-09
2601,080666,台汽電元大09購01,0,0,0,0,0,0,0,0,0,32000,0,0,0,32000,0,32000,32000,2021-06-09
2602,080452,南港凱基09購01,0,0,0,0,0,0,0,0,0,32000,0,0,0,55000,23000,32000,32000,2021-06-09
2603,089272,南電日盛09購02,0,0,0,0,0,0,0,0,0,32000,0,0,0,32000,0,32000,32000,2021-06-09
2604,6108,競國,48000,16000,32000,0,0,0,0,0,0,0,0,0,0,0,0,0,32000,2021-06-09
2605,9943,好樂迪,34000,2000,32000,0,0,0,0,0,0,0,0,0,0,0,0,0,32000,2021-06-09
2606,085805,日月光元大0A購02,0,0,0,0,0,0,0,0,0,31000,0,0,0,40000,9000,31000,31000,2021-06-09
2607,030709,群創群益0B購06,0,0,0,0,0,0,0,0,0,31000,0,0,0,277000,246000,31000,31000,2021-06-09
2608,031525,智原康和11購01,0,0,0,0,0,0,0,0,0,31000,0,0,0,31000,0,31000,31000,2021-06-09
2609,030485,長榮永豐0A購02,0,0,0,0,0,0,0,0,0,31000,0,0,0,41000,10000,31000,31000,2021-06-09
2610,032455,嘉聯益元大11購02,0,0,0,0,0,0,0,0,0,31000,0,0,0,38000,7000,31000,31000,2021-06-09
2611,033522,凌陽國票0C購01,0,20000,-20000,0,0,0,0,0,0,51000,0,0,0,77000,26000,51000,31000,2021-06-09
2612,035363,中鋼統一0B購08,0,0,0,0,0,0,0,0,0,31000,0,0,0,31000,0,31000,31000,2021-06-09
2613,035410,富邦金麥證0B購03,0,0,0,38000,7000,31000,0,0,0,31000,0,0,0,38000,7000,31000,31000,2021-06-09
2614,035397,玉晶光永豐0B購05,0,0,0,0,0,0,0,0,0,31000,0,0,0,39000,8000,31000,31000,2021-06-09
2615,03501B,臺股指富邦0A熊04,0,0,0,0,0,0,0,0,0,31000,0,0,0,31000,0,31000,31000,2021-06-09
2616,034286,華新科兆豐0C購01,0,0,0,0,0,0,0,0,0,31000,0,0,0,31000,0,31000,31000,2021-06-09
2617,034894,順德凱基0B購01,0,0,0,0,0,0,0,0,0,31000,0,0,0,53000,22000,31000,31000,2021-06-09
2618,034166,國泰金永豐0B購01,0,0,0,0,0,0,0,0,0,31000,0,0,0,130000,99000,31000,31000,2021-06-09
2619,083280,台積電元大07購24,0,0,0,0,0,0,0,0,0,31000,0,0,0,31000,0,31000,31000,2021-06-09
2620,078897,和碩元大06購01,0,0,0,0,0,0,0,0,0,31000,0,0,0,31000,0,31000,31000,2021-06-09
2621,06641P,大立光日盛09售03,0,0,0,0,0,0,0,0,0,31000,0,0,0,48000,17000,31000,31000,2021-06-09
2622,6136,富爾特,36000,5000,31000,0,0,0,0,0,0,0,0,0,0,0,0,0,31000,2021-06-09
2623,2423,固緯,38000,7000,31000,0,0,0,0,0,0,0,0,0,0,0,0,0,31000,2021-06-09
2624,085798,群創元大0C購02,0,0,0,0,0,0,0,0,0,30000,0,0,0,30000,0,30000,30000,2021-06-09
2625,085966,美食凱基08購02,0,0,0,0,0,0,0,0,0,30000,0,0,0,30000,0,30000,30000,2021-06-09
2626,085342,日月光中信08購03,0,0,0,0,0,0,0,0,0,30000,0,0,0,30000,0,30000,30000,2021-06-09
2627,083437,京元電凱基08購01,0,0,0,0,0,0,0,0,0,30000,0,0,0,30000,0,30000,30000,2021-06-09
2628,083629,友達凱基0B購02,0,0,0,0,0,0,0,0,0,30000,0,0,0,30000,0,30000,30000,2021-06-09
2629,084020,瑞昱統一09購04,0,0,0,0,0,0,0,0,0,30000,0,0,0,30000,0,30000,30000,2021-06-09
2630,084230,聯電統一09購09,0,0,0,0,0,0,0,0,0,30000,0,0,0,30000,0,30000,30000,2021-06-09
2631,084420,鴻海兆豐09購09,0,0,0,0,0,0,0,0,0,30000,0,0,0,30000,0,30000,30000,2021-06-09
2632,084946,裕隆凱基08購02,0,0,0,0,0,0,0,0,0,30000,0,0,0,130000,100000,30000,30000,2021-06-09
2633,084830,宏碁統一0A購05,0,0,0,0,0,0,0,0,0,30000,0,0,0,30000,0,30000,30000,2021-06-09
2634,084745,健策元大08購03,0,0,0,0,0,0,0,0,0,30000,0,0,0,40000,10000,30000,30000,2021-06-09
2635,088091,中信金元富09購01,0,0,0,0,0,0,0,0,0,30000,0,0,0,30000,0,30000,30000,2021-06-09
2636,088221,旺宏元富09購09,0,0,0,0,0,0,0,0,0,30000,0,0,0,250000,220000,30000,30000,2021-06-09
2637,088962,聯詠國票0A購02,0,0,0,0,0,0,0,0,0,30000,0,0,0,47000,17000,30000,30000,2021-06-09
2638,087416,晶豪科統一0B購01,0,0,0,0,0,0,0,0,0,30000,0,0,0,30000,0,30000,30000,2021-06-09
2639,087624,上証2X凱基09購03,0,0,0,0,0,0,0,0,0,30000,0,0,0,45000,15000,30000,30000,2021-06-09
2640,033487,華通統一0B購01,0,0,0,0,0,0,0,0,0,30000,0,0,0,30000,0,30000,30000,2021-06-09
2641,032385,友達統一0C購05,0,0,0,0,0,0,0,0,0,30000,0,0,0,30000,0,30000,30000,2021-06-09
2642,033544,國巨元富12購02,0,0,0,0,0,0,0,0,0,30000,0,0,0,30000,0,30000,30000,2021-06-09
2643,033061,智原永豐0A購02,0,0,0,0,0,0,0,0,0,30000,0,0,0,40000,10000,30000,30000,2021-06-09
2644,032956,中橡元大0A購01,0,0,0,0,0,0,0,0,0,30000,0,0,0,40000,10000,30000,30000,2021-06-09
2645,032286,三陽中信0A購01,0,0,0,0,0,0,0,0,0,30000,0,0,0,30000,0,30000,30000,2021-06-09
2646,032269,T50反1富邦13購01,0,0,0,0,0,0,0,0,0,30000,0,0,0,30000,0,30000,30000,2021-06-09
2647,033280,友達統一13購01,0,0,0,0,0,0,0,0,0,30000,0,0,0,30000,0,30000,30000,2021-06-09
2648,032084,亞聚永豐0A購03,0,0,0,0,0,0,0,0,0,30000,0,0,0,30000,0,30000,30000,2021-06-09
2649,032097,東鋼永豐0A購05,0,0,0,0,0,0,0,0,0,30000,0,0,0,130000,100000,30000,30000,2021-06-09
2650,05626P,滬深2X凱基08售04,0,0,0,0,0,0,0,0,0,30000,0,0,0,30000,0,30000,30000,2021-06-09
2651,031831,裕隆富邦0B購01,0,0,0,0,0,0,0,0,0,30000,0,0,0,30000,0,30000,30000,2021-06-09
2652,031681,美利達元大0C購01,0,0,0,0,0,0,0,0,0,30000,0,0,0,30000,0,30000,30000,2021-06-09
2653,031359,燿華中信0B購01,0,0,0,0,0,0,0,0,0,30000,0,0,0,30000,0,30000,30000,2021-06-09
2654,031351,寶成元大0B購01,0,0,0,0,0,0,0,0,0,30000,0,0,0,30000,0,30000,30000,2021-06-09
2655,030217,揚明光凱基0A購01,0,0,0,0,0,0,0,0,0,30000,0,0,0,30000,0,30000,30000,2021-06-09
2656,030221,新至陞凱基0A購01,0,0,0,0,0,0,0,0,0,30000,0,0,0,30000,0,30000,30000,2021-06-09
2657,033161,華新中信0B購01,0,0,0,0,0,0,0,0,0,30000,0,0,0,50000,20000,30000,30000,2021-06-09
2658,033180,TPK永豐0B購01,0,0,0,0,0,0,0,0,0,30000,0,0,0,30000,0,30000,30000,2021-06-09
2659,034135,滬深2X凱基0C購03,0,0,0,0,0,0,0,0,0,30000,0,0,0,30000,0,30000,30000,2021-06-09
2660,034996,中鋼元大0C購03,0,0,0,0,0,0,0,0,0,30000,0,0,0,30000,0,30000,30000,2021-06-09
2661,06054P,台灣50國泰09售01,0,0,0,0,0,0,0,0,0,30000,0,0,0,30000,0,30000,30000,2021-06-09
2662,06284P,台積電元大0C售01,0,0,0,0,0,0,0,0,0,30000,0,0,0,37000,7000,30000,30000,2021-06-09
2663,06173P,祥碩元大08售01,0,0,0,0,0,0,0,0,0,30000,0,0,0,30000,0,30000,30000,2021-06-09
2664,035460,富邦金國票0C購02,0,0,0,0,0,0,0,0,0,30000,0,0,0,30000,0,30000,30000,2021-06-09
2665,035701,聯成元大0B購05,0,0,0,0,0,0,0,0,0,30000,0,0,0,34000,4000,30000,30000,2021-06-09
2666,035814,聯陽凱基0B購02,1000,0,1000,0,0,0,0,0,0,29000,0,0,0,100000,71000,29000,30000,2021-06-09
2667,036040,南電統一0C購02,0,0,0,0,0,0,0,0,0,30000,0,0,0,30000,0,30000,30000,2021-06-09
2668,04564P,聯電國票07售01,0,0,0,0,0,0,0,0,0,30000,0,0,0,30000,0,30000,30000,2021-06-09
2669,04780P,臺股指國票09售12,0,0,0,0,0,0,0,0,0,30000,0,0,0,30000,0,30000,30000,2021-06-09
2670,035152,群創統一0B購15,0,0,0,0,0,0,0,0,0,30000,0,0,0,30000,0,30000,30000,2021-06-09
2671,06812P,臺股指元大0A售27,0,0,0,0,0,0,0,0,0,30000,0,0,0,30000,0,30000,30000,2021-06-09
2672,06516P,台積電凱基12售01,0,0,0,0,0,0,0,0,0,30000,0,0,0,30000,0,30000,30000,2021-06-09
2673,078940,友達第一06購01,0,0,0,0,0,0,0,0,0,30000,0,0,0,30000,0,30000,30000,2021-06-09
2674,078298,聯電兆豐07購01,0,0,0,0,0,0,0,0,0,30000,0,0,0,30000,0,30000,30000,2021-06-09
2675,078313,圓剛元富0C購01,0,0,0,0,0,0,0,0,0,30000,0,0,0,30000,0,30000,30000,2021-06-09
2676,078383,聯電國泰09購01,0,0,0,0,0,0,0,0,0,30000,0,0,0,30000,0,30000,30000,2021-06-09
2677,078390,旺宏富邦08購01,0,0,0,0,0,0,0,0,0,30000,0,0,0,30000,0,30000,30000,2021-06-09
2678,077801,元石油元富09購01,0,0,0,0,0,0,0,0,0,30000,0,0,0,30000,0,30000,30000,2021-06-09
2679,076737,台積電凱基07購08,0,0,0,0,0,0,0,0,0,30000,0,0,0,30000,0,30000,30000,2021-06-09
2680,077085,世芯元富06購01,0,0,0,0,0,0,0,0,0,30000,0,0,0,40000,10000,30000,30000,2021-06-09
2681,072652,智伸科元富09購02,0,0,0,0,0,0,0,0,0,30000,0,0,0,30000,0,30000,30000,2021-06-09
2682,076249,中石化群益06購01,0,0,0,0,0,0,0,0,0,30000,0,0,0,30000,0,30000,30000,2021-06-09
2683,082983,奇力新元大07購02,0,0,0,0,0,0,0,0,0,30000,0,0,0,30000,0,30000,30000,2021-06-09
2684,083000,元石油凱基09購02,0,0,0,0,0,0,0,0,0,30000,0,0,0,30000,0,30000,30000,2021-06-09
2685,082641,世紀鋼富邦08購01,0,0,0,0,0,0,0,0,0,30000,0,0,0,30000,0,30000,30000,2021-06-09
2686,082501,健策統一09購01,0,0,0,0,0,0,0,0,0,30000,0,0,0,97000,67000,30000,30000,2021-06-09
2687,082297,欣興元大07購06,0,0,0,0,0,0,0,0,0,30000,0,0,0,30000,0,30000,30000,2021-06-09
2688,082241,玉山金凱基08購01,0,0,0,0,0,0,0,0,0,30000,0,0,0,30000,0,30000,30000,2021-06-09
2689,081721,創意統一09購07,0,0,0,0,0,0,0,0,0,30000,0,0,0,30000,0,30000,30000,2021-06-09
2690,081774,祥碩元大07購02,0,0,0,0,0,0,0,0,0,30000,0,0,0,30000,0,30000,30000,2021-06-09
2691,081911,義隆凱基08購01,0,0,0,0,0,0,0,0,0,30000,0,0,0,30000,0,30000,30000,2021-06-09
2692,080341,南茂凱基07購01,0,0,0,0,0,0,0,0,0,30000,0,0,0,30000,0,30000,30000,2021-06-09
2693,079014,台泥元大06購01,0,0,0,0,0,0,0,0,0,30000,0,0,0,30000,0,30000,30000,2021-06-09
2694,079148,全新元大06購03,0,0,0,0,0,0,0,0,0,30000,0,0,0,30000,0,30000,30000,2021-06-09
2695,079494,佳世達凱基06購02,0,0,0,0,0,0,0,0,0,30000,0,0,0,30000,0,30000,30000,2021-06-09
2696,079506,榮成康和06購01,0,0,0,0,0,0,0,0,0,30000,0,0,0,30000,0,30000,30000,2021-06-09
2697,080582,中興電日盛06購01,0,0,0,0,0,0,0,0,0,30000,0,0,0,30000,0,30000,30000,2021-06-09
2698,081222,全新統一09購03,0,0,0,0,0,0,0,0,0,30000,0,0,0,30000,0,30000,30000,2021-06-09
2699,081122,炎洲群益09購01,0,0,0,0,0,0,0,0,0,30000,0,0,0,30000,0,30000,30000,2021-06-09
2700,2630,亞航,197000,167000,30000,0,0,0,0,0,0,0,0,0,0,0,0,0,30000,2021-06-09
2701,089696,矽創元大09購08,0,0,0,0,0,0,0,0,0,30000,0,0,0,30000,0,30000,30000,2021-06-09
2702,089722,台玻永豐09購01,0,0,0,0,0,0,0,0,0,30000,0,0,0,30000,0,30000,30000,2021-06-09
2703,088065,矽格元大09購01,0,0,0,0,0,0,0,0,0,29000,0,0,0,91000,62000,29000,29000,2021-06-09
2704,087954,上緯控元富09購02,0,0,0,0,0,0,0,0,0,29000,0,0,0,29000,0,29000,29000,2021-06-09
2705,084758,安集元大08購02,0,0,0,0,0,0,0,0,0,29000,0,0,0,30000,1000,29000,29000,2021-06-09
2706,085095,宏碁凱基0A購01,0,0,0,0,0,0,0,0,0,29000,0,0,0,42000,13000,29000,29000,2021-06-09
2707,089021,立積元大09購06,0,0,0,0,0,0,0,0,0,29000,0,0,0,50000,21000,29000,29000,2021-06-09
2708,031200,華夏凱基0B購02,0,0,0,0,0,0,0,0,0,29000,0,0,0,44000,15000,29000,29000,2021-06-09
2709,035384,和碩凱基0B購01,0,0,0,0,0,0,0,0,0,29000,0,0,0,29000,0,29000,29000,2021-06-09
2710,032981,A50正2元富0A購01,0,0,0,0,0,0,0,0,0,29000,0,0,0,29000,0,29000,29000,2021-06-09
2711,031874,允強凱基0C購01,0,0,0,0,0,0,0,0,0,29000,0,0,0,37000,8000,29000,29000,2021-06-09
2712,033462,祥碩群益0B購01,0,0,0,0,0,0,0,0,0,29000,0,0,0,30000,1000,29000,29000,2021-06-09
2713,033297,南亞中信0B購01,0,0,0,0,0,0,0,0,0,29000,0,0,0,29000,0,29000,29000,2021-06-09
2714,035434,聯詠元大0B購06,0,0,0,0,0,0,0,0,0,29000,0,0,0,58000,29000,29000,29000,2021-06-09
2715,035782,世紀鋼富邦0C購01,0,0,0,0,0,0,0,0,0,29000,0,0,0,930000,901000,29000,29000,2021-06-09
2716,034093,富邦金元大0B購04,0,0,0,0,0,0,0,0,0,29000,0,0,0,29000,0,29000,29000,2021-06-09
2717,081046,群創富邦07購02,0,0,0,0,0,0,0,0,0,29000,0,0,0,29000,0,29000,29000,2021-06-09
2718,081306,金像電元大07購07,0,0,0,0,0,0,0,0,0,29000,0,0,0,68000,39000,29000,29000,2021-06-09
2719,080209,滬深2X元大09購01,0,0,0,0,0,0,0,0,0,29000,0,0,0,34000,5000,29000,29000,2021-06-09
2720,081485,台積電凱基09購02,0,0,0,0,0,0,0,0,0,29000,0,0,0,29000,0,29000,29000,2021-06-09
2721,082606,信邦元大07購04,0,0,0,0,0,0,0,0,0,29000,0,0,0,29000,0,29000,29000,2021-06-09
2722,089531,祥碩元大12購01,0,0,0,0,0,0,0,0,0,29000,0,0,0,29000,0,29000,29000,2021-06-09
2723,3013,晟銘電,40000,11000,29000,0,0,0,0,0,0,0,0,0,0,0,0,0,29000,2021-06-09
2724,085977,臺股指凱基0B購04,0,0,0,0,0,0,0,0,0,28000,0,0,0,38000,10000,28000,28000,2021-06-09
2725,083757,聯電第一11購01,0,0,0,0,0,0,0,0,0,28000,0,0,0,114000,86000,28000,28000,2021-06-09
2726,083508,鴻海元大07購23,0,0,0,0,0,0,0,0,0,28000,0,0,0,29000,1000,28000,28000,2021-06-09
2727,088190,光罩群益0A購02,0,0,0,0,0,0,0,0,0,28000,0,0,0,30000,2000,28000,28000,2021-06-09
2728,088920,聯電統一0B購08,0,0,0,0,0,0,0,0,0,28000,0,0,0,41000,13000,28000,28000,2021-06-09
2729,088501,友達元大09購14,0,0,0,0,0,0,0,0,0,28000,0,0,0,30000,2000,28000,28000,2021-06-09
2730,087287,義隆元大09購02,0,0,0,0,0,0,0,0,0,28000,0,0,0,41000,13000,28000,28000,2021-06-09
2731,033519,遠東新國票0C購01,0,0,0,0,0,0,0,0,0,28000,0,0,0,46000,18000,28000,28000,2021-06-09
2732,031726,乙盛群益0A購01,0,0,0,0,0,0,0,0,0,28000,0,0,0,28000,0,28000,28000,2021-06-09
2733,031409,華新凱基0B購01,0,0,0,0,0,0,0,0,0,28000,0,0,0,74000,46000,28000,28000,2021-06-09
2734,030679,台達化兆豐0A購01,0,0,0,0,0,0,0,0,0,28000,0,0,0,28000,0,28000,28000,2021-06-09
2735,030561,長榮統一11購01,0,0,0,0,0,0,0,0,0,28000,0,0,0,38000,10000,28000,28000,2021-06-09
2736,034066,國巨富邦11購01,0,0,0,0,0,0,0,0,0,28000,0,0,0,158000,130000,28000,28000,2021-06-09
2737,034548,欣興統一11購03,0,0,0,0,0,0,0,0,0,28000,0,0,0,50000,22000,28000,28000,2021-06-09
2738,035605,欣興元大0B購06,0,0,0,0,0,0,0,0,0,28000,0,0,0,142000,114000,28000,28000,2021-06-09
2739,034938,國巨群益0B購05,0,0,0,0,0,0,0,0,0,28000,0,0,0,46000,18000,28000,28000,2021-06-09
2740,035881,群創群益0B購15,0,0,0,0,0,0,0,0,0,28000,0,0,0,40000,12000,28000,28000,2021-06-09
2741,035702,永豐餘元大0B購03,0,1000,-1000,0,0,0,0,0,0,29000,0,0,0,29000,0,29000,28000,2021-06-09
2742,035639,群創富邦13購01,0,0,0,0,0,0,0,0,0,28000,0,0,0,47000,19000,28000,28000,2021-06-09
2743,04414P,臻鼎元富0A售01,0,0,0,0,0,0,0,0,0,28000,0,0,0,28000,0,28000,28000,2021-06-09
2744,03719C,台積電富邦08牛08,0,0,0,0,0,0,0,0,0,28000,0,0,0,86000,58000,28000,28000,2021-06-09
2745,035178,滬深2X元富15購01,0,0,0,0,0,0,0,0,0,28000,0,0,0,32000,4000,28000,28000,2021-06-09
2746,082401,台光電凱基08購01,0,0,0,0,0,0,0,0,0,28000,0,0,0,30000,2000,28000,28000,2021-06-09
2747,07306P,長榮航元大0C售05,0,0,0,0,0,0,0,0,0,28000,0,0,0,142000,114000,28000,28000,2021-06-09
2748,06381P,南電群益08售05,0,0,0,0,0,0,0,0,0,28000,0,0,0,28000,0,28000,28000,2021-06-09
2749,6112,聚碩,39000,11000,28000,0,0,0,0,0,0,0,0,0,0,0,0,0,28000,2021-06-09
2750,1727,中華化,38000,11000,27000,0,0,0,0,0,0,34,34,0,34,0,0,0,27034,2021-06-09
2751,087171,大成鋼統一0B購02,0,0,0,0,0,0,0,0,0,27000,0,0,0,548000,521000,27000,27000,2021-06-09
2752,087049,亞光凱基09購02,0,0,0,0,0,0,0,0,0,27000,0,0,0,50000,23000,27000,27000,2021-06-09
2753,087826,國巨凱基09購11,0,0,0,0,0,0,0,0,0,27000,0,0,0,27000,0,27000,27000,2021-06-09
2754,084283,欣興中信07購03,0,0,0,0,0,0,0,0,0,27000,0,0,0,27000,0,27000,27000,2021-06-09
2755,084298,佳世達兆豐08購01,0,0,0,0,0,0,0,0,0,27000,0,0,0,27000,0,27000,27000,2021-06-09
2756,032213,中鋼統一0C購07,0,0,0,0,0,0,0,0,0,27000,0,0,0,27000,0,27000,27000,2021-06-09
2757,035407,台表科元富0C購01,0,0,0,0,0,0,0,0,0,27000,0,0,0,27000,0,27000,27000,2021-06-09
2758,05244P,聯電國票08售01,0,0,0,0,0,0,0,0,0,27000,0,0,0,27000,0,27000,27000,2021-06-09
2759,035479,聚陽群益0C購02,0,0,0,0,0,0,0,0,0,27000,0,0,0,27000,0,27000,27000,2021-06-09
2760,033919,和桐元大0B購02,0,0,0,0,0,0,0,0,0,27000,0,0,0,96000,69000,27000,27000,2021-06-09
2761,033708,台玻國票0C購01,0,0,0,0,0,0,0,0,0,27000,0,0,0,50000,23000,27000,27000,2021-06-09
2762,034986,華碩群益0B購02,0,0,0,0,0,0,0,0,0,27000,0,0,0,27000,0,27000,27000,2021-06-09
2763,033856,聯發科凱基11購03,0,0,0,0,0,0,0,0,0,27000,0,0,0,27000,0,27000,27000,2021-06-09
2764,034600,友達統一0B購08,0,0,0,0,0,0,0,0,0,27000,0,0,0,27000,0,27000,27000,2021-06-09
2765,05891P,台積電國泰0B售03,0,0,0,0,0,0,0,0,0,27000,0,0,0,55000,28000,27000,27000,2021-06-09
2766,06406P,大立光元富08售03,0,0,0,0,0,0,0,0,0,27000,0,0,0,49000,22000,27000,27000,2021-06-09
2767,06838P,臺股指群益0A售08,0,0,0,0,0,0,0,0,0,27000,0,0,0,58000,31000,27000,27000,2021-06-09
2768,07064P,大亞群益0B售03,0,0,0,0,0,0,0,0,0,27000,0,0,0,27000,0,27000,27000,2021-06-09
2769,077915,滬深2X群益07購01,0,0,0,0,0,0,0,0,0,27000,0,0,0,27000,0,27000,27000,2021-06-09
2770,082144,愛普統一0C購01,0,0,0,0,0,0,0,0,0,27000,0,0,0,45000,18000,27000,27000,2021-06-09
2771,081169,寶齡永豐07購01,0,0,0,0,0,0,0,0,0,27000,0,0,0,27000,0,27000,27000,2021-06-09
2772,081021,長榮統一09購02,0,0,0,0,0,0,0,0,0,27000,0,0,0,32000,5000,27000,27000,2021-06-09
2773,6278,台表科,746000,860000,-114000,0,0,0,202000,0,202000,-61000,22000,4000,18000,19000,98000,-79000,27000,2021-06-09
2774,083495,景碩元富07購01,0,0,0,0,0,0,0,0,0,26000,0,0,0,126000,100000,26000,26000,2021-06-09
2775,083698,台積電元富07購44,0,0,0,0,0,0,0,0,0,26000,0,0,0,26000,0,26000,26000,2021-06-09
2776,085730,中纖兆豐08購01,0,0,0,0,0,0,0,0,0,26000,0,0,0,41000,15000,26000,26000,2021-06-09
2777,087939,創意統一0B購04,0,0,0,0,0,0,0,0,0,26000,0,0,0,26000,0,26000,26000,2021-06-09
2778,088496,國巨元大0B購01,0,0,0,0,0,0,0,0,0,26000,0,0,0,26000,0,26000,26000,2021-06-09
2779,088823,乙盛元大0C購01,0,0,0,0,0,0,0,0,0,26000,0,0,0,26000,0,26000,26000,2021-06-09
2780,089038,台達電國泰0B購01,0,0,0,0,0,0,0,0,0,26000,0,0,0,65000,39000,26000,26000,2021-06-09
2781,031543,長榮永豐0A購06,0,0,0,0,0,0,0,0,0,26000,0,0,0,26000,0,26000,26000,2021-06-09
2782,032696,玉晶光永豐0A購06,0,0,0,0,0,0,0,0,0,26000,0,0,0,35000,9000,26000,26000,2021-06-09
2783,031390,信邦統一0C購01,0,0,0,0,0,0,0,0,0,26000,0,0,0,26000,0,26000,26000,2021-06-09
2784,030302,中砂康和0A購01,0,0,0,0,0,0,0,0,0,26000,0,0,0,26000,0,26000,26000,2021-06-09
2785,036373,奇鋐國票11購01,0,0,0,0,0,0,0,0,0,26000,0,0,0,41000,15000,26000,26000,2021-06-09
2786,034529,友達麥證11購01,0,0,0,168000,142000,26000,0,0,0,26000,0,0,0,168000,142000,26000,26000,2021-06-09
2787,034477,中鋼元大0B購07,0,0,0,0,0,0,0,0,0,26000,0,0,0,40000,14000,26000,26000,2021-06-09
2788,06145P,聯電兆豐09售01,0,0,0,0,0,0,0,0,0,26000,0,0,0,26000,0,26000,26000,2021-06-09
2789,035733,中鋼國票0C購07,0,0,0,0,0,0,0,0,0,26000,0,0,0,29000,3000,26000,26000,2021-06-09
2790,04748P,亞德客元富0B售02,0,0,0,0,0,0,0,0,0,26000,0,0,0,30000,4000,26000,26000,2021-06-09
2791,081038,國巨富邦09購01,0,0,0,0,0,0,0,0,0,26000,0,0,0,26000,0,26000,26000,2021-06-09
2792,083239,廣宇群益07購02,0,0,0,0,0,0,0,0,0,26000,0,0,0,26000,0,26000,26000,2021-06-09
2793,083091,順德元大07購05,0,0,0,0,0,0,0,0,0,26000,0,0,0,26000,0,26000,26000,2021-06-09
2794,077275,漢唐統一07購01,0,0,0,0,0,0,0,0,0,26000,0,0,0,26000,0,26000,26000,2021-06-09
2795,07036P,華邦電凱基11售02,0,0,0,0,0,0,0,0,0,26000,0,0,0,217000,191000,26000,26000,2021-06-09
2796,6196,帆宣,42000,17000,25000,0,0,0,0,0,0,1000,0,0,0,1000,0,1000,26000,2021-06-09
2797,2444,兆勁,32000,6000,26000,0,0,0,0,0,0,0,0,0,0,0,0,0,26000,2021-06-09
2798,4137,麗豐-KY,62000,36000,26000,0,0,0,0,0,0,0,0,0,0,1000,1000,0,26000,2021-06-09
2799,1315,達新,103000,77000,26000,0,0,0,0,0,0,0,0,0,0,0,0,0,26000,2021-06-09
2800,089044,漢唐群益09購02,0,0,0,0,0,0,0,0,0,25000,0,0,0,25000,0,25000,25000,2021-06-09
2801,088685,鴻海元富0C購09,0,0,0,0,0,0,0,0,0,25000,0,0,0,25000,0,25000,25000,2021-06-09
2802,088403,鴻海永豐09購07,0,0,0,0,0,0,0,0,0,25000,0,0,0,25000,0,25000,25000,2021-06-09
2803,088556,A50正2凱基0B購02,0,0,0,0,0,0,0,0,0,25000,0,0,0,39000,14000,25000,25000,2021-06-09
2804,088051,漢唐元大09購01,0,0,0,0,0,0,0,0,0,25000,0,0,0,130000,105000,25000,25000,2021-06-09
2805,086859,滬深2X國票0A購04,0,0,0,0,0,0,0,0,0,25000,0,0,0,25000,0,25000,25000,2021-06-09
2806,086837,王品元大0A購01,0,0,0,0,0,0,0,0,0,25000,0,0,0,127000,102000,25000,25000,2021-06-09
2807,087597,臺股指元大09購05,0,0,0,0,0,0,0,0,0,25000,0,0,0,30000,5000,25000,25000,2021-06-09
2808,086050,亞光元富08購02,0,0,0,0,0,0,0,0,0,25000,0,0,0,25000,0,25000,25000,2021-06-09
2809,086051,欣興元富0B購01,0,0,0,0,0,0,0,0,0,25000,0,0,0,25000,0,25000,25000,2021-06-09
2810,084135,光寶科永豐07購01,0,0,0,0,0,0,0,0,0,25000,0,0,0,25000,0,25000,25000,2021-06-09
2811,084092,大立光元大07購11,0,0,0,0,0,0,0,0,0,25000,0,0,0,25000,0,25000,25000,2021-06-09
2812,084315,大立光凱基07購09,0,0,0,0,0,0,0,0,0,25000,0,0,0,25000,0,25000,25000,2021-06-09
2813,084994,南電群益08購02,0,0,0,0,0,0,0,0,0,25000,0,0,0,320000,295000,25000,25000,2021-06-09
2814,030082,超眾群益11購01,0,0,0,0,0,0,0,0,0,25000,0,0,0,25000,0,25000,25000,2021-06-09
2815,030233,宏全凱基0C購01,0,0,0,0,0,0,0,0,0,25000,0,0,0,27000,2000,25000,25000,2021-06-09
2816,00753L,中信中國50正2,7000,9000,-2000,0,0,0,0,0,0,27000,0,0,0,359000,332000,27000,25000,2021-06-09
2817,031348,帆宣元大0A購02,0,0,0,0,0,0,0,0,0,25000,0,0,0,25000,0,25000,25000,2021-06-09
2818,031357,力麗中信0A購01,0,0,0,0,0,0,0,0,0,25000,0,0,0,30000,5000,25000,25000,2021-06-09
2819,031405,新光金兆豐0A購01,0,0,0,0,0,0,0,0,0,25000,0,0,0,25000,0,25000,25000,2021-06-09
2820,030197,南帝凱基0A購03,0,0,0,0,0,0,0,0,0,25000,0,0,0,304000,279000,25000,25000,2021-06-09
2821,030184,景碩兆豐0B購01,0,0,0,0,0,0,0,0,0,25000,0,0,0,25000,0,25000,25000,2021-06-09
2822,031316,台苯元大0A購01,0,0,0,0,0,0,0,0,0,25000,0,0,0,25000,0,25000,25000,2021-06-09
2823,032149,萬海凱基0A購03,0,0,0,0,0,0,0,0,0,25000,0,0,0,25000,0,25000,25000,2021-06-09
2824,032619,世紀鋼元大0B購02,0,0,0,0,0,0,0,0,0,25000,0,0,0,25000,0,25000,25000,2021-06-09
2825,05449P,臺股指國票0A售01,0,0,0,0,0,0,0,0,0,25000,0,0,0,80000,55000,25000,25000,2021-06-09
2826,033348,日月光永豐0B購01,0,0,0,0,0,0,0,0,0,25000,0,0,0,25000,0,25000,25000,2021-06-09
2827,032836,群創富邦0B購03,0,0,0,0,0,0,0,0,0,25000,0,0,0,25000,0,25000,25000,2021-06-09
2828,05166P,聯電元富07售04,0,0,0,0,0,0,0,0,0,25000,0,0,0,25000,0,25000,25000,2021-06-09
2829,036061,順德群益11購01,0,0,0,0,0,0,0,0,0,25000,0,0,0,69000,44000,25000,25000,2021-06-09
2830,035203,臻鼎元富0B購01,0,0,0,0,0,0,0,0,0,25000,0,0,0,25000,0,25000,25000,2021-06-09
2831,035137,友達統一0B購12,0,0,0,0,0,0,0,0,0,25000,0,0,0,25000,0,25000,25000,2021-06-09
2832,034859,長榮航元大11購03,0,0,0,0,0,0,0,0,0,25000,0,0,0,25000,0,25000,25000,2021-06-09
2833,034296,儒鴻永豐0B購01,0,0,0,0,0,0,0,0,0,25000,0,0,0,25000,0,25000,25000,2021-06-09
2834,035789,惠特國泰12購01,0,0,0,0,0,0,0,0,0,25000,0,0,0,86000,61000,25000,25000,2021-06-09
2835,06281P,臺股指群益08售07,0,0,0,0,0,0,0,0,0,25000,0,0,0,65000,40000,25000,25000,2021-06-09
2836,033860,智伸科凱基0B購01,0,0,0,0,0,0,0,0,0,25000,0,0,0,25000,0,25000,25000,2021-06-09
2837,034960,國喬元大0B購05,0,0,0,0,0,0,0,0,0,25000,0,0,0,96000,71000,25000,25000,2021-06-09
2838,034895,宏碁凱基0B購02,0,0,0,0,0,0,0,0,0,25000,0,0,0,33000,8000,25000,25000,2021-06-09
2839,034523,燁輝康和11購01,0,0,0,0,0,0,0,0,0,25000,0,0,0,25000,0,25000,25000,2021-06-09
2840,034504,聚陽凱基0C購01,0,0,0,0,0,0,0,0,0,25000,0,0,0,40000,15000,25000,25000,2021-06-09
2841,034484,聯發科元大0B購05,0,0,0,0,0,0,0,0,0,25000,0,0,0,189000,164000,25000,25000,2021-06-09
2842,034693,宏碁群益0C購02,0,0,0,0,0,0,0,0,0,25000,0,0,0,28000,3000,25000,25000,2021-06-09
2843,034250,國巨統一11購01,0,0,0,0,0,0,0,0,0,25000,0,0,0,25000,0,25000,25000,2021-06-09
2844,034034,鴻海元富12購04,0,0,0,0,0,0,0,0,0,25000,0,0,0,40000,15000,25000,25000,2021-06-09
2845,034205,祥碩元大11購02,0,0,0,0,0,0,0,0,0,25000,0,0,0,30000,5000,25000,25000,2021-06-09
2846,06961P,大成鋼元富0A售08,0,0,0,0,0,0,0,0,0,25000,0,0,0,80000,55000,25000,25000,2021-06-09
2847,06410P,景碩群益09售01,0,0,0,0,0,0,0,0,0,25000,0,0,0,155000,130000,25000,25000,2021-06-09
2848,06386P,聯詠國票08售02,0,0,0,0,0,0,0,0,0,25000,0,0,0,25000,0,25000,25000,2021-06-09
2849,07285P,京元電元富0C售01,0,0,0,0,0,0,0,0,0,25000,0,0,0,25000,0,25000,25000,2021-06-09
2850,074405,金像電元大06購01,0,0,0,0,0,0,0,0,0,25000,0,0,0,175000,150000,25000,25000,2021-06-09
2851,081899,道瓊銅凱基0A購01,0,0,0,0,0,0,0,0,0,25000,0,0,0,25000,0,25000,25000,2021-06-09
2852,081028,長榮元富08購03,0,0,0,0,0,0,0,0,0,25000,0,0,0,25000,0,25000,25000,2021-06-09
2853,089971,友達元大0B購04,0,0,0,0,0,0,0,0,0,25000,0,0,0,25000,0,25000,25000,2021-06-09
2854,089721,華夏永豐09購02,0,0,0,0,0,0,0,0,0,25000,0,0,0,25000,0,25000,25000,2021-06-09
2855,089365,聯陽元大09購04,0,0,0,0,0,0,0,0,0,25000,0,0,0,25000,0,25000,25000,2021-06-09
2856,089146,欣陸元大09購02,0,0,0,0,0,0,0,0,0,25000,0,0,0,25000,0,25000,25000,2021-06-09
2857,2841,台開,72000,47000,25000,0,0,0,0,0,0,0,0,0,0,0,0,0,25000,2021-06-09
2858,2607,榮運,1442000,1363000,79000,0,0,0,0,0,0,-54000,0,0,0,5000,59000,-54000,25000,2021-06-09
2859,00783,富邦中証500,1000,0,1000,0,0,0,0,0,0,23020,0,0,0,424020,401000,23020,24020,2021-06-09
2860,083741,聯發科國票08購09,0,0,0,0,0,0,0,0,0,24000,0,0,0,29000,5000,24000,24000,2021-06-09
2861,085349,微星永豐08購01,0,0,0,0,0,0,0,0,0,24000,0,0,0,24000,0,24000,24000,2021-06-09
2862,085276,聯電凱基08購12,0,0,0,0,0,0,0,0,0,24000,0,0,0,75000,51000,24000,24000,2021-06-09
2863,088948,台達化日盛09購01,0,0,0,0,0,0,0,0,0,24000,0,0,0,24000,0,24000,24000,2021-06-09
2864,030816,中鋼構國泰0C購02,0,0,0,0,0,0,0,0,0,24000,0,0,0,24000,0,24000,24000,2021-06-09
2865,030943,申豐群益0C購02,0,0,0,0,0,0,0,0,0,24000,0,0,0,158000,134000,24000,24000,2021-06-09
2866,032761,臺指反元大11購06,0,0,0,0,0,0,0,0,0,24000,0,0,0,24000,0,24000,24000,2021-06-09
2867,032640,萬海統一11購01,0,0,0,0,0,0,0,0,0,24000,0,0,0,24000,0,24000,24000,2021-06-09
2868,032968,長榮元大0A購30,0,0,0,0,0,0,0,0,0,24000,0,0,0,24000,0,24000,24000,2021-06-09
2869,036275,中鋼元大0C購08,0,0,0,0,0,0,0,0,0,24000,0,0,0,24000,0,24000,24000,2021-06-09
2870,032563,裕民群益0A購02,0,0,0,0,0,0,0,0,0,24000,0,0,0,96000,72000,24000,24000,2021-06-09
2871,031815,智邦元大0A購02,0,0,0,0,0,0,0,0,0,24000,0,0,0,34000,10000,24000,24000,2021-06-09
2872,034490,萬海元大11購03,0,0,0,0,0,0,0,0,0,24000,0,0,0,92000,68000,24000,24000,2021-06-09
2873,034917,中鋼麥證11購03,0,0,0,71000,46000,25000,0,0,0,24000,0,0,0,71000,47000,24000,24000,2021-06-09
2874,035902,大成鋼群益12購01,0,0,0,0,0,0,0,0,0,24000,0,0,0,59000,35000,24000,24000,2021-06-09
2875,034321,大亞群益11購01,0,0,0,0,0,0,0,0,0,24000,0,0,0,24000,0,24000,24000,2021-06-09
2876,080667,康那香元大09購01,0,0,0,0,0,0,0,0,0,24000,0,0,0,24000,0,24000,24000,2021-06-09
2877,3563,牧德,36000,11000,25000,0,0,0,0,0,0,-1000,0,0,0,0,1000,-1000,24000,2021-06-09
2878,2478,大毅,138000,125000,13000,0,0,0,0,0,0,10946,0,54,-54,11000,0,11000,23946,2021-06-09
2879,9955,佳龍,80000,56000,24000,0,0,0,0,0,0,-152,0,152,-152,0,0,0,23848,2021-06-09
2880,087380,聯電元大11購01,0,0,0,0,0,0,0,0,0,23000,0,0,0,99000,76000,23000,23000,2021-06-09
2881,085235,奇鋐元大08購05,0,0,0,0,0,0,0,0,0,23000,0,0,0,23000,0,23000,23000,2021-06-09
2882,086165,亞光元大08購04,0,0,0,0,0,0,0,0,0,23000,0,0,0,23000,0,23000,23000,2021-06-09
2883,084640,和碩凱基0A購02,0,0,0,0,0,0,0,0,0,23000,0,0,0,23000,0,23000,23000,2021-06-09
2884,031834,和碩富邦0B購01,0,0,0,0,0,0,0,0,0,23000,0,0,0,33000,10000,23000,23000,2021-06-09
2885,032071,長榮中信0C購04,0,0,0,0,0,0,0,0,0,23000,0,0,0,23000,0,23000,23000,2021-06-09
2886,033068,全新凱基0C購01,0,0,0,0,0,0,0,0,0,23000,0,0,0,42000,19000,23000,23000,2021-06-09
2887,033030,京元電群益0A購02,0,0,0,0,0,0,0,0,0,23000,0,0,0,35000,12000,23000,23000,2021-06-09
2888,032375,華新統一0B購01,0,0,0,0,0,0,0,0,0,23000,0,0,0,40000,17000,23000,23000,2021-06-09
2889,00654R,富邦印度反1,0,0,0,0,0,0,0,0,0,23000,0,0,0,90000,67000,23000,23000,2021-06-09
2890,031230,道瓊反群益12購01,0,0,0,0,0,0,0,0,0,23000,0,0,0,23000,0,23000,23000,2021-06-09
2891,031493,泰豐元大0B購01,0,0,0,0,0,0,0,0,0,23000,0,0,0,23000,0,23000,23000,2021-06-09
2892,035734,大成鋼國票0C購05,0,0,0,0,0,0,0,0,0,23000,0,0,0,28000,5000,23000,23000,2021-06-09
2893,035549,友達統一0B購14,0,0,0,0,0,0,0,0,0,23000,0,0,0,23000,0,23000,23000,2021-06-09
2894,06336P,台積電凱基08售29,0,0,0,0,0,0,0,0,0,23000,0,0,0,23000,0,23000,23000,2021-06-09
2895,081026,彩晶統一09購01,0,0,0,0,0,0,0,0,0,23000,0,0,0,23000,0,23000,23000,2021-06-09
2896,082709,晶技凱基09購01,0,0,0,0,0,0,0,0,0,23000,0,0,0,28000,5000,23000,23000,2021-06-09
2897,068409,緯穎元富07購01,0,0,0,0,0,0,0,0,0,23000,0,0,0,100000,77000,23000,23000,2021-06-09
2898,07151P,聯電元大0B售03,0,0,0,0,0,0,0,0,0,23000,0,0,0,48000,25000,23000,23000,2021-06-09
2899,6591,動力-KY,45000,22000,23000,0,0,0,0,0,0,0,0,0,0,0,0,0,23000,2021-06-09
2900,2613,中櫃,145000,122000,23000,0,0,0,0,0,0,0,0,0,0,0,0,0,23000,2021-06-09
2901,1737,臺鹽,43000,20000,23000,0,0,0,0,0,0,0,0,0,0,0,0,0,23000,2021-06-09
2902,089306,友達國票0B購01,0,0,0,0,0,0,0,0,0,23000,0,0,0,39000,16000,23000,23000,2021-06-09
2903,1432,大魯閣,27000,4000,23000,0,0,0,0,0,0,0,0,0,0,0,0,0,23000,2021-06-09
2904,084741,奇鋐元大09購01,0,0,0,0,0,0,0,0,0,22000,0,0,0,28000,6000,22000,22000,2021-06-09
2905,084603,玉晶光永豐08購01,0,0,0,0,0,0,0,0,0,22000,0,0,0,22000,0,22000,22000,2021-06-09
2906,084026,致新統一09購01,0,0,0,0,0,0,0,0,0,22000,0,0,0,22000,0,22000,22000,2021-06-09
2907,085799,嘉澤元大08購02,0,0,0,0,0,0,0,0,0,22000,0,0,0,210000,188000,22000,22000,2021-06-09
2908,085078,亞光永豐08購01,0,0,0,0,0,0,0,0,0,22000,0,0,0,119000,97000,22000,22000,2021-06-09
2909,086998,冠德國票0A購01,0,0,0,0,0,0,0,0,0,22000,0,0,0,73000,51000,22000,22000,2021-06-09
2910,088565,華碩凱基0A購01,0,0,0,0,0,0,0,0,0,22000,0,0,0,22000,0,22000,22000,2021-06-09
2911,030177,華新兆豐0A購01,0,0,0,0,0,0,0,0,0,22000,0,0,0,22000,0,22000,22000,2021-06-09
2912,030188,元黃金凱基0B購01,0,0,0,0,0,0,0,0,0,22000,0,0,0,22000,0,22000,22000,2021-06-09
2913,030001,萬海中信0B購01,0,0,0,0,0,0,0,0,0,22000,0,0,0,22000,0,22000,22000,2021-06-09
2914,033145,京鼎元大0B購01,0,0,0,0,0,0,0,0,0,22000,0,0,0,63000,41000,22000,22000,2021-06-09
2915,036006,大成鋼凱基13購04,0,0,0,0,0,0,0,0,0,22000,0,0,0,22000,0,22000,22000,2021-06-09
2916,034769,長榮國票0C購02,0,0,0,0,0,0,0,0,0,22000,0,0,0,104000,82000,22000,22000,2021-06-09
2917,034405,聯發科國票0B購07,0,0,0,0,0,0,0,0,0,22000,0,0,0,50000,28000,22000,22000,2021-06-09
2918,06248P,台積電統一09售22,0,0,0,0,0,0,0,0,0,22000,0,0,0,22000,0,22000,22000,2021-06-09
2919,034542,長榮航統一0C購05,0,0,0,0,0,0,0,0,0,22000,0,0,0,22000,0,22000,22000,2021-06-09
2920,033818,台達電統一11購01,0,0,0,0,0,0,0,0,0,22000,0,0,0,471000,449000,22000,22000,2021-06-09
2921,035717,聯發科元大13購01,0,0,0,0,0,0,0,0,0,22000,0,0,0,150000,128000,22000,22000,2021-06-09
2922,034883,廣達群益0C購01,0,0,0,0,0,0,0,0,0,22000,0,0,0,84000,62000,22000,22000,2021-06-09
2923,035828,東鋼元大0B購07,0,0,0,0,0,0,0,0,0,22000,0,0,0,22000,0,22000,22000,2021-06-09
2924,035240,大成鋼群益0C購07,0,0,0,0,0,0,0,0,0,22000,0,0,0,25000,3000,22000,22000,2021-06-09
2925,03853P,大立光元富09售06,0,0,0,0,0,0,0,0,0,22000,0,0,0,22000,0,22000,22000,2021-06-09
2926,07140P,台灣50群益0B售04,0,0,0,0,0,0,0,0,0,22000,0,0,0,22000,0,22000,22000,2021-06-09
2927,06884P,臺股指群益0A售14,0,0,0,0,0,0,0,0,0,22000,0,0,0,77000,55000,22000,22000,2021-06-09
2928,075696,欣興統一07購04,0,0,0,0,0,0,0,0,0,22000,0,0,0,22000,0,22000,22000,2021-06-09
2929,07204P,友達凱基11售06,0,0,0,0,0,0,0,0,0,22000,0,0,0,22000,0,22000,22000,2021-06-09
2930,076789,國喬國票06購01,0,0,0,0,0,0,0,0,0,22000,0,0,0,22000,0,22000,22000,2021-06-09
2931,082833,南電元大08購02,0,0,0,0,0,0,0,0,0,22000,0,0,0,22000,0,22000,22000,2021-06-09
2932,082117,同欣電群益08購03,0,0,0,0,0,0,0,0,0,22000,0,0,0,22000,0,22000,22000,2021-06-09
2933,081473,燁輝康和07購01,0,0,0,0,0,0,0,0,0,22000,0,0,0,22000,0,22000,22000,2021-06-09
2934,6426,統新,23000,1000,22000,0,0,0,0,0,0,0,0,0,0,0,0,0,22000,2021-06-09
2935,088635,國巨國票0B購01,0,0,0,0,0,0,0,0,0,21000,0,0,0,21000,0,21000,21000,2021-06-09
2936,088228,矽格元富11購01,0,0,0,0,0,0,0,0,0,21000,0,0,0,21000,0,21000,21000,2021-06-09
2937,085069,恆大永豐08購01,0,0,0,0,0,0,0,0,0,21000,0,0,0,21000,0,21000,21000,2021-06-09
2938,085291,大立光凱基08購08,0,0,0,0,0,0,0,0,0,21000,0,0,0,35000,14000,21000,21000,2021-06-09
2939,085891,聯發科國票08購12,0,0,0,0,0,0,0,0,0,21000,0,0,0,43000,22000,21000,21000,2021-06-09
2940,031942,台聚元大0C購01,0,0,0,0,0,0,0,0,0,21000,0,0,0,33000,12000,21000,21000,2021-06-09
2941,032430,宏碁元大0A購03,0,0,0,0,0,0,0,0,0,21000,0,0,0,96000,75000,21000,21000,2021-06-09
2942,033127,國巨元大0A購02,0,0,0,0,0,0,0,0,0,21000,0,0,0,21000,0,21000,21000,2021-06-09
2943,020019,統一特選台灣5GN,0,0,0,0,0,0,0,0,0,21000,0,0,0,34000,13000,21000,21000,2021-06-09
2944,030056,台勝科元大12購01,0,0,0,0,0,0,0,0,0,21000,0,0,0,21000,0,21000,21000,2021-06-09
2945,030080,台勝科群益11購01,0,0,0,0,0,0,0,0,0,21000,0,0,0,73000,52000,21000,21000,2021-06-09
2946,031251,健和興群益0A購02,0,0,0,0,0,0,0,0,0,21000,0,0,0,21000,0,21000,21000,2021-06-09
2947,035172,萬海國票12購01,15000,0,15000,0,0,0,0,0,0,6000,0,0,0,128000,122000,6000,21000,2021-06-09
2948,036116,中鋼群益12購01,0,0,0,0,0,0,0,0,0,21000,0,0,0,21000,0,21000,21000,2021-06-09
2949,034331,鴻海群益0C購06,0,0,0,0,0,0,0,0,0,21000,0,0,0,21000,0,21000,21000,2021-06-09
2950,035720,欣興元大0B購08,0,0,0,0,0,0,0,0,0,21000,0,0,0,79000,58000,21000,21000,2021-06-09
2951,035501,大成鋼凱基0B購08,0,0,0,0,0,0,0,0,0,21000,0,0,0,42000,21000,21000,21000,2021-06-09
2952,080827,新興永豐06購04,0,0,0,0,0,0,0,0,0,21000,0,0,0,21000,0,21000,21000,2021-06-09
2953,080609,中纖元富08購01,0,0,0,0,0,0,0,0,0,21000,0,0,0,21000,0,21000,21000,2021-06-09
2954,082202,台表科永豐07購01,0,0,0,0,0,0,0,0,0,21000,0,0,0,31000,10000,21000,21000,2021-06-09
2955,083015,東森凱基08購01,0,0,0,0,0,0,0,0,0,21000,0,0,0,21000,0,21000,21000,2021-06-09
2956,078898,立積元大07購02,0,0,0,0,0,0,0,0,0,21000,0,0,0,21000,0,21000,21000,2021-06-09
2957,078858,台積電台新07購01,0,0,0,0,0,0,0,0,0,21000,0,0,0,230000,209000,21000,21000,2021-06-09
2958,075967,華新科統一07購02,0,0,0,0,0,0,0,0,0,21000,0,0,0,79000,58000,21000,21000,2021-06-09
2959,06872P,臺股指凱基0A售15,0,0,0,0,0,0,0,0,0,21000,0,0,0,21000,0,21000,21000,2021-06-09
2960,06580P,日月光元富09售03,0,0,0,0,0,0,0,0,0,21000,0,0,0,21000,0,21000,21000,2021-06-09
2961,06801P,群創元大0A售08,0,0,0,0,0,0,0,0,0,21000,0,0,0,68000,47000,21000,21000,2021-06-09
2962,089544,東鋼國泰0B購01,0,0,0,0,0,0,0,0,0,21000,0,0,0,107000,86000,21000,21000,2021-06-09
2963,2536,宏普,27000,6000,21000,0,0,0,0,0,0,0,0,0,0,0,0,0,21000,2021-06-09
2964,2906,高林,75000,54000,21000,0,0,0,0,0,0,0,0,0,0,0,0,0,21000,2021-06-09
2965,085786,華邦電元大0C購02,0,0,0,0,0,0,0,0,0,20000,0,0,0,20000,0,20000,20000,2021-06-09
2966,086069,精成科統一0A購01,0,0,0,0,0,0,0,0,0,20000,0,0,0,20000,0,20000,20000,2021-06-09
2967,085089,恆大凱基08購01,0,0,0,0,0,0,0,0,0,20000,0,0,0,20000,0,20000,20000,2021-06-09
2968,085193,臺指反群益0A購01,0,0,0,0,0,0,0,0,0,20000,0,0,0,20000,0,20000,20000,2021-06-09
2969,085184,美指2X元富08購01,0,0,0,0,0,0,0,0,0,20000,0,0,0,20000,0,20000,20000,2021-06-09
2970,085681,華新科元富0A購01,0,0,0,0,0,0,0,0,0,20000,0,0,0,20000,0,20000,20000,2021-06-09
2971,085553,旺宏群益08購03,0,0,0,0,0,0,0,0,0,20000,0,0,0,20000,0,20000,20000,2021-06-09
2972,085541,嘉澤永豐08購01,0,0,0,0,0,0,0,0,0,20000,0,0,0,20000,0,20000,20000,2021-06-09
2973,083987,漢唐群益07購01,0,0,0,0,0,0,0,0,0,20000,0,0,0,20000,0,20000,20000,2021-06-09
2974,083866,台積電國票07購10,0,0,0,0,0,0,0,0,0,20000,0,0,0,20000,0,20000,20000,2021-06-09
2975,083724,聯詠元大07購08,0,0,0,0,0,0,0,0,0,20000,0,0,0,70000,50000,20000,20000,2021-06-09
2976,084608,A50正2兆豐09購01,0,0,0,0,0,0,0,0,0,20000,0,0,0,20000,0,20000,20000,2021-06-09
2977,084554,凌陽元富08購01,0,0,0,0,0,0,0,0,0,20000,0,0,0,20000,0,20000,20000,2021-06-09
2978,084325,台郡凱基07購02,0,0,0,0,0,0,0,0,0,20000,0,0,0,20000,0,20000,20000,2021-06-09
2979,084743,玉晶光元大08購08,0,0,0,0,0,0,0,0,0,20000,0,0,0,20000,0,20000,20000,2021-06-09
2980,084867,可成元大08購01,0,0,0,0,0,0,0,0,0,20000,0,0,0,20000,0,20000,20000,2021-06-09
2981,088222,英業達元富09購02,0,0,0,0,0,0,0,0,0,20000,0,0,0,20000,0,20000,20000,2021-06-09
2982,087838,日月光凱基09購06,0,0,0,0,0,0,0,0,0,20000,0,0,0,20000,0,20000,20000,2021-06-09
2983,087811,緯創兆豐0A購01,0,0,0,0,0,0,0,0,0,20000,0,0,0,20000,0,20000,20000,2021-06-09
2984,087797,群創日盛0A購01,0,0,0,0,0,0,0,0,0,20000,0,0,0,20000,0,20000,20000,2021-06-09
2985,088657,為升元大09購06,0,0,0,0,0,0,0,0,0,20000,0,0,0,20000,0,20000,20000,2021-06-09
2986,088585,華碩統一0B購02,0,0,0,0,0,0,0,0,0,20000,0,0,0,20000,0,20000,20000,2021-06-09
2987,088438,華碩凱基0C購01,0,0,0,0,0,0,0,0,0,20000,0,0,0,20000,0,20000,20000,2021-06-09
2988,088737,華邦電永豐09購04,0,0,0,0,0,0,0,0,0,20000,0,0,0,20000,0,20000,20000,2021-06-09
2989,087037,為升凱基0A購01,0,0,0,0,0,0,0,0,0,20000,0,0,0,20000,0,20000,20000,2021-06-09
2990,086825,華邦電元大09購04,0,0,0,0,0,0,0,0,0,20000,0,0,0,20000,0,20000,20000,2021-06-09
2991,086635,建準凱基09購01,0,0,0,0,0,0,0,0,0,20000,0,0,0,20000,0,20000,20000,2021-06-09
2992,086695,長榮航元富0A購02,0,0,0,0,0,0,0,0,0,20000,0,0,0,20000,0,20000,20000,2021-06-09
2993,087599,道瓊銅中信0A購01,0,0,0,0,0,0,0,0,0,20000,0,0,0,20000,0,20000,20000,2021-06-09
2994,087571,聯詠國泰0B購01,0,0,0,0,0,0,0,0,0,20000,0,0,0,20000,0,20000,20000,2021-06-09
2995,087555,力成元富09購02,0,0,0,0,0,0,0,0,0,20000,0,0,0,20000,0,20000,20000,2021-06-09
2996,087143,長榮航國票0B購01,0,0,0,0,0,0,0,0,0,20000,0,0,0,20000,0,20000,20000,2021-06-09
2997,087078,宏達電統一0B購01,0,0,0,0,0,0,0,0,0,20000,0,0,0,20000,0,20000,20000,2021-06-09
2998,031475,大成鋼國票0B購01,0,0,0,0,0,0,0,0,0,20000,0,0,0,20000,0,20000,20000,2021-06-09
2999,031465,新日興群益0B購01,0,0,0,0,0,0,0,0,0,20000,0,0,0,20000,0,20000,20000,2021-06-09
3000,031467,臻鼎群益0C購01,0,0,0,0,0,0,0,0,0,20000,0,0,0,20000,0,20000,20000,2021-06-09
3001,030480,大成鋼永豐0A購01,0,0,0,0,0,0,0,0,0,20000,0,0,0,20000,0,20000,20000,2021-06-09
3002,030356,東森群益0B購01,0,0,0,0,0,0,0,0,0,20000,0,0,0,30000,10000,20000,20000,2021-06-09
3003,030052,玉晶光元大0A購03,0,0,0,0,0,0,0,0,0,20000,0,0,0,37000,17000,20000,20000,2021-06-09
3004,00641R,富邦日本反1,0,0,0,0,0,0,0,0,0,20000,0,0,0,26000,6000,20000,20000,2021-06-09
3005,031051,光磊元大0C購01,0,0,0,0,0,0,0,0,0,20000,0,0,0,20000,0,20000,20000,2021-06-09
3006,031089,新纖群益0A購01,0,0,0,0,0,0,0,0,0,20000,0,0,0,20000,0,20000,20000,2021-06-09
3007,032543,台航凱基12購01,0,0,0,0,0,0,0,0,0,20000,0,0,0,20000,0,20000,20000,2021-06-09
3008,030952,禾伸堂富邦0C購01,0,0,0,0,0,0,0,0,0,20000,0,0,0,40000,20000,20000,20000,2021-06-09
3009,030654,東鋼永豐0A購01,0,0,0,0,0,0,0,0,0,20000,0,0,0,20000,0,20000,20000,2021-06-09
3010,031612,華邦電康和0A購01,0,0,0,0,0,0,0,0,0,20000,0,0,0,21000,1000,20000,20000,2021-06-09
3011,031593,直得國票0B購01,0,0,0,0,0,0,0,0,0,20000,0,0,0,20000,0,20000,20000,2021-06-09
3012,032258,長榮元大12購05,0,0,0,0,0,0,0,0,0,20000,0,0,0,20000,0,20000,20000,2021-06-09
3013,033262,臻鼎元大11購01,0,0,0,0,0,0,0,0,0,20000,0,0,0,50000,30000,20000,20000,2021-06-09
3014,032999,長榮元富0A購16,0,0,0,0,0,0,0,0,0,20000,0,0,0,20000,0,20000,20000,2021-06-09
3015,032391,新興統一0C購02,0,0,0,0,0,0,0,0,0,20000,0,0,0,20000,0,20000,20000,2021-06-09
3016,031869,東鋼凱基14購01,0,0,0,0,0,0,0,0,0,20000,0,0,0,20000,0,20000,20000,2021-06-09
3017,033302,矽創中信0B購02,0,0,0,0,0,0,0,0,0,20000,0,0,0,30000,10000,20000,20000,2021-06-09
3018,033356,中纖群益0B購01,0,0,0,0,0,0,0,0,0,20000,0,0,0,70000,50000,20000,20000,2021-06-09
3019,031927,台聚元富11購02,0,0,0,0,0,0,0,0,0,20000,0,0,0,20000,0,20000,20000,2021-06-09
3020,032067,燁輝中信0A購01,0,0,0,0,0,0,0,0,0,20000,0,0,0,20000,0,20000,20000,2021-06-09
3021,032074,慧洋中信0A購02,0,0,0,0,0,0,0,0,0,20000,0,0,0,20000,0,20000,20000,2021-06-09
3022,032048,華邦電國票0B購02,0,0,0,0,0,0,0,0,0,20000,0,0,0,20000,0,20000,20000,2021-06-09
3023,032134,燁輝凱基12購01,0,0,0,0,0,0,0,0,0,20000,0,0,0,31000,11000,20000,20000,2021-06-09
3024,032161,燁輝元富0A購02,0,0,0,0,0,0,0,0,0,20000,0,0,0,20000,0,20000,20000,2021-06-09
3025,032162,大成鋼元富0A購04,0,0,0,0,0,0,0,0,0,20000,0,0,0,20000,0,20000,20000,2021-06-09
3026,032225,富邦金統一0C購01,0,0,0,0,0,0,0,0,0,20000,0,0,0,20000,0,20000,20000,2021-06-09
3027,032510,新興永豐0A購05,0,0,0,0,0,0,0,0,0,20000,0,0,0,20000,0,20000,20000,2021-06-09
3028,031733,亞聚凱基14購01,0,0,0,0,0,0,0,0,0,20000,0,0,0,20000,0,20000,20000,2021-06-09
3029,031828,上証2X富邦0B購01,0,0,0,0,0,0,0,0,0,20000,0,0,0,20000,0,20000,20000,2021-06-09
3030,031817,技嘉元大0C購02,0,0,0,0,0,0,0,0,0,20000,0,0,0,20000,0,20000,20000,2021-06-09
3031,031674,晶技元大0C購01,0,0,0,0,0,0,0,0,0,20000,0,0,0,20000,0,20000,20000,2021-06-09
3032,031698,力麗永豐0A購01,0,0,0,0,0,0,0,0,0,20000,0,0,0,20000,0,20000,20000,2021-06-09
3033,036379,群創國票12購01,0,0,0,0,0,0,0,0,0,20000,0,0,0,20000,0,20000,20000,2021-06-09
3034,035497,聯發科國泰14購01,0,0,0,0,0,0,0,0,0,20000,0,0,0,21000,1000,20000,20000,2021-06-09
3035,035620,榮成國票0C購01,0,0,0,0,0,0,0,0,0,20000,0,0,0,20000,0,20000,20000,2021-06-09
3036,035630,臺股指國票0B購18,0,0,0,0,0,0,0,0,0,20000,0,0,0,20000,0,20000,20000,2021-06-09
3037,05812P,台積電國泰09售05,0,0,0,0,0,0,0,0,0,20000,0,0,0,20000,0,20000,20000,2021-06-09
3038,05814P,台灣50中信0A售02,0,0,0,0,0,0,0,0,0,20000,0,0,0,20000,0,20000,20000,2021-06-09
3039,034860,台驊控元大0C購01,0,0,0,0,0,0,0,0,0,20000,0,0,0,20000,0,20000,20000,2021-06-09
3040,035848,儒鴻統一0B購03,0,0,0,0,0,0,0,0,0,20000,0,0,0,20000,0,20000,20000,2021-06-09
3041,035957,東鋼元大0C購04,0,0,0,0,0,0,0,0,0,20000,0,0,0,20000,0,20000,20000,2021-06-09
3042,035133,大成鋼統一0C購05,0,0,0,0,0,0,0,0,0,20000,0,0,0,20000,0,20000,20000,2021-06-09
3043,035039,華新國票0B購02,0,0,0,0,0,0,0,0,0,20000,0,0,0,73000,53000,20000,20000,2021-06-09
3044,04075P,南亞科元富09售02,0,0,0,0,0,0,0,0,0,20000,0,0,0,20000,0,20000,20000,2021-06-09
3045,035385,台郡凱基0C購01,0,0,0,0,0,0,0,0,0,20000,0,0,0,30000,10000,20000,20000,2021-06-09
3046,035409,群創康和0C購01,0,0,0,0,0,0,0,0,0,20000,0,0,0,31000,11000,20000,20000,2021-06-09
3047,033796,台郡元大0C購02,0,0,0,0,0,0,0,0,0,20000,0,0,0,20000,0,20000,20000,2021-06-09
3048,05863P,臺股指凱基07售15,0,0,0,0,0,0,0,0,0,20000,0,0,0,20000,0,20000,20000,2021-06-09
3049,034256,萬海統一0C購04,0,0,0,0,0,0,0,0,0,20000,0,0,0,35000,15000,20000,20000,2021-06-09
3050,034162,群光永豐0B購02,0,0,0,0,0,0,0,0,0,20000,0,0,0,20000,0,20000,20000,2021-06-09
3051,034062,裕民國票0C購01,0,0,0,0,0,0,0,0,0,20000,0,0,0,20000,0,20000,20000,2021-06-09
3052,034451,群創中信0B購09,0,0,0,0,0,0,0,0,0,20000,0,0,0,20000,0,20000,20000,2021-06-09
3053,06297P,臺股指凱基08售08,0,0,0,0,0,0,0,0,0,20000,0,0,0,20000,0,20000,20000,2021-06-09
3054,06188P,台灣50凱基09售01,0,0,0,0,0,0,0,0,0,20000,0,0,0,20000,0,20000,20000,2021-06-09
3055,034439,國巨凱基0B購04,0,0,0,0,0,0,0,0,0,20000,0,0,0,20000,0,20000,20000,2021-06-09
3056,034981,南紡群益0B購03,0,0,0,0,0,0,0,0,0,20000,0,0,0,29000,9000,20000,20000,2021-06-09
3057,03497B,臺股指元大0A熊18,0,0,0,0,0,0,0,0,0,20000,0,0,0,266000,246000,20000,20000,2021-06-09
3058,05904P,臺股指國票08售01,0,0,0,0,0,0,0,0,0,20000,0,0,0,45000,25000,20000,20000,2021-06-09
3059,035553,聯詠統一0B購08,0,0,0,0,0,0,0,0,0,20000,0,0,0,40000,20000,20000,20000,2021-06-09
3060,06364P,台灣50凱基08售04,0,0,0,0,0,0,0,0,0,20000,0,0,0,20000,0,20000,20000,2021-06-09
3061,068398,上証2X元富07購04,0,0,0,0,0,0,0,0,0,20000,0,0,0,40000,20000,20000,20000,2021-06-09
3062,06816P,玉晶光兆豐0B售02,0,0,0,0,0,0,0,0,0,20000,0,0,0,20000,0,20000,20000,2021-06-09
3063,06608P,台灣50凱基09售10,0,0,0,0,0,0,0,0,0,20000,0,0,0,20000,0,20000,20000,2021-06-09
3064,06520P,台積電元富13售02,0,0,0,0,0,0,0,0,0,20000,0,0,0,40000,20000,20000,20000,2021-06-09
3065,06873P,臺股指凱基0A售16,0,0,0,0,0,0,0,0,0,20000,0,0,0,40000,20000,20000,20000,2021-06-09
3066,068406,同欣電元富07購01,0,0,0,0,0,0,0,0,0,20000,0,0,0,20000,0,20000,20000,2021-06-09
3067,07012P,聯發科中信0B售06,0,0,0,0,0,0,0,0,0,20000,0,0,0,20000,0,20000,20000,2021-06-09
3068,07114P,台灣50麥證0B售03,0,0,0,20000,0,20000,0,0,0,20000,0,0,0,20000,0,20000,20000,2021-06-09
3069,07029P,群創群益0C售06,0,0,0,0,0,0,0,0,0,20000,0,0,0,20000,0,20000,20000,2021-06-09
3070,070169,國泰金中信06購01,0,0,0,0,0,0,0,0,0,20000,0,0,0,20000,0,20000,20000,2021-06-09
3071,07062P,臺股指國票0B售16,0,0,0,0,0,0,0,0,0,20000,0,0,0,20000,0,20000,20000,2021-06-09
3072,075924,嘉聯益元大06購01,0,0,0,0,0,0,0,0,0,20000,0,0,0,20000,0,20000,20000,2021-06-09
3073,076471,祥碩元大07購01,0,0,0,0,0,0,0,0,0,20000,0,0,0,30000,10000,20000,20000,2021-06-09
3074,074457,國喬元富0A購01,0,0,0,0,0,0,0,0,0,20000,0,0,0,100000,80000,20000,20000,2021-06-09
3075,074044,國巨元大07購01,0,0,0,0,0,0,0,0,0,20000,0,0,0,30000,10000,20000,20000,2021-06-09
3076,07201P,玉晶光群益0C售06,0,0,0,0,0,0,0,0,0,20000,0,0,0,20000,0,20000,20000,2021-06-09
3077,073557,滬深2X元大07購01,0,0,0,0,0,0,0,0,0,20000,0,0,0,20000,0,20000,20000,2021-06-09
3078,078838,華新科兆豐07購01,0,0,0,0,0,0,0,0,0,20000,0,0,0,20000,0,20000,20000,2021-06-09
3079,078906,GIS元大08購01,0,0,0,0,0,0,0,0,0,20000,0,0,0,20000,0,20000,20000,2021-06-09
3080,078888,宏達電元大06購01,0,0,0,0,0,0,0,0,0,20000,0,0,0,30000,10000,20000,20000,2021-06-09
3081,078769,台苯群益07購01,0,0,0,0,0,0,0,0,0,20000,0,0,0,20000,0,20000,20000,2021-06-09
3082,078277,玉晶光國票08購06,0,0,0,0,0,0,0,0,0,20000,0,0,0,20000,0,20000,20000,2021-06-09
3083,082935,嘉聯益統一09購01,0,0,0,0,0,0,0,0,0,20000,0,0,0,20000,0,20000,20000,2021-06-09
3084,082752,上銀統一09購02,0,0,0,0,0,0,0,0,0,20000,0,0,0,20000,0,20000,20000,2021-06-09
3085,082720,上証2X群益07購02,0,0,0,0,0,0,0,0,0,20000,0,0,0,20000,0,20000,20000,2021-06-09
3086,082776,南茂統一09購01,0,0,0,0,0,0,0,0,0,20000,0,0,0,20000,0,20000,20000,2021-06-09
3087,082661,愛普永豐07購02,0,0,0,0,0,0,0,0,0,20000,0,0,0,341000,321000,20000,20000,2021-06-09
3088,082603,凌陽元大08購01,0,0,0,0,0,0,0,0,0,20000,0,0,0,210000,190000,20000,20000,2021-06-09
3089,082134,義隆統一0A購01,0,0,0,0,0,0,0,0,0,20000,0,0,0,20000,0,20000,20000,2021-06-09
3090,082339,世紀鋼統一09購02,0,0,0,0,0,0,0,0,0,20000,0,0,0,20000,0,20000,20000,2021-06-09
3091,082331,乙盛統一08購01,0,0,0,0,0,0,0,0,0,20000,0,0,0,20000,0,20000,20000,2021-06-09
3092,081935,廣宇國票08購01,0,0,0,0,0,0,0,0,0,20000,0,0,0,20000,0,20000,20000,2021-06-09
3093,081804,春源凱基07購01,0,0,0,0,0,0,0,0,0,20000,0,0,0,20000,0,20000,20000,2021-06-09
3094,081534,中橡永豐07購01,0,0,0,0,0,0,0,0,0,20000,0,0,0,20000,0,20000,20000,2021-06-09
3095,081583,台玻元大07購03,0,0,0,0,0,0,0,0,0,20000,0,0,0,20000,0,20000,20000,2021-06-09
3096,081601,華泰元大07購01,0,0,0,0,0,0,0,0,0,20000,0,0,0,20000,0,20000,20000,2021-06-09
3097,080706,長榮凱基08購05,0,0,0,0,0,0,0,0,0,20000,0,0,0,20000,0,20000,20000,2021-06-09
3098,080824,億光永豐06購01,0,0,0,0,0,0,0,0,0,20000,0,0,0,20000,0,20000,20000,2021-06-09
3099,080860,裕隆統一08購01,0,0,0,0,0,0,0,0,0,20000,0,0,0,20000,0,20000,20000,2021-06-09
3100,080996,群光永豐07購01,0,0,0,0,0,0,0,0,0,20000,0,0,0,20000,0,20000,20000,2021-06-09
3101,081353,國巨凱基08購04,0,0,0,0,0,0,0,0,0,20000,0,0,0,20000,0,20000,20000,2021-06-09
3102,081288,矽創統一09購01,0,0,0,0,0,0,0,0,0,20000,0,0,0,20000,0,20000,20000,2021-06-09
3103,081039,華邦電富邦07購02,0,0,0,0,0,0,0,0,0,20000,0,0,0,20000,0,20000,20000,2021-06-09
3104,081033,大成富邦08購01,0,0,0,0,0,0,0,0,0,20000,0,0,0,30000,10000,20000,20000,2021-06-09
3105,081119,和鑫群益0A購02,0,0,0,0,0,0,0,0,0,20000,0,0,0,20000,0,20000,20000,2021-06-09
3106,081193,國巨元大07購08,0,0,0,0,0,0,0,0,0,20000,0,0,0,30000,10000,20000,20000,2021-06-09
3107,080346,台光電統一08購01,0,0,0,0,0,0,0,0,0,20000,0,0,0,20000,0,20000,20000,2021-06-09
3108,080232,台積電元大06購14,0,0,0,0,0,0,0,0,0,20000,0,0,0,20000,0,20000,20000,2021-06-09
3109,080490,國巨元大08購03,0,0,0,0,0,0,0,0,0,20000,0,0,0,20000,0,20000,20000,2021-06-09
3110,080405,健鼎元大09購01,0,0,0,0,0,0,0,0,0,20000,0,0,0,20000,0,20000,20000,2021-06-09
3111,079289,元大金統一06購01,0,0,0,0,0,0,0,0,0,20000,0,0,0,20000,0,20000,20000,2021-06-09
3112,079072,新光鋼永豐06購01,0,0,0,0,0,0,0,0,0,20000,0,0,0,20000,0,20000,20000,2021-06-09
3113,2836A,高雄銀甲特,0,0,0,0,0,0,0,0,0,20000,20000,0,20000,0,0,0,20000,2021-06-09
3114,4722,國精化,129000,109000,20000,0,0,0,0,0,0,0,0,0,0,0,0,0,20000,2021-06-09
3115,089727,華邦電永豐09購05,0,0,0,0,0,0,0,0,0,20000,0,0,0,20000,0,20000,20000,2021-06-09
3116,089699,A50正2元富09購05,0,0,0,0,0,0,0,0,0,20000,0,0,0,20000,0,20000,20000,2021-06-09
3117,089691,景碩元大09購04,0,0,0,0,0,0,0,0,0,20000,0,0,0,66000,46000,20000,20000,2021-06-09
3118,089374,立積元大0B購01,0,0,0,0,0,0,0,0,0,20000,0,0,0,20000,0,20000,20000,2021-06-09
3119,1338,廣華-KY,43000,27000,16000,0,0,0,0,0,0,4000,4000,0,4000,0,0,0,20000,2021-06-09
3120,089936,健和興永豐0A購01,0,0,0,0,0,0,0,0,0,20000,0,0,0,25000,5000,20000,20000,2021-06-09
3121,089915,彩晶凱基0B購03,0,0,0,0,0,0,0,0,0,20000,0,0,0,20000,0,20000,20000,2021-06-09
3122,089877,美利達群益0A購01,0,0,0,0,0,0,0,0,0,20000,0,0,0,20000,0,20000,20000,2021-06-09
3123,00652,富邦印度,7000,3597,3403,0,0,0,0,0,0,15940,0,0,0,34940,19000,15940,19343,2021-06-09
3124,086604,聯發科中信09購03,0,0,0,0,0,0,0,0,0,19000,0,0,0,19000,0,19000,19000,2021-06-09
3125,086487,日月光統一0B購01,0,0,0,0,0,0,0,0,0,19000,0,0,0,82000,63000,19000,19000,2021-06-09
3126,086791,和碩兆豐09購01,0,0,0,0,0,0,0,0,0,19000,0,0,0,19000,0,19000,19000,2021-06-09
3127,088414,國巨群益09購03,0,0,0,0,0,0,0,0,0,19000,0,0,0,19000,0,19000,19000,2021-06-09
3128,088597,英業達日盛09購01,0,0,0,0,0,0,0,0,0,19000,0,0,0,19000,0,19000,19000,2021-06-09
3129,084359,大立光元大07購14,0,0,0,0,0,0,0,0,0,19000,0,0,0,19000,0,19000,19000,2021-06-09
3130,084117,台光電群益07購01,0,0,0,0,0,0,0,0,0,19000,0,0,0,19000,0,19000,19000,2021-06-09
3131,020018,統一價值成長30N,0,0,0,0,0,0,0,0,0,19000,0,0,0,26000,7000,19000,19000,2021-06-09
3132,030531,大成鋼凱基0A購02,0,0,0,0,0,0,0,0,0,19000,0,0,0,20000,1000,19000,19000,2021-06-09
3133,033190,矽統凱基11購01,0,0,0,0,0,0,0,0,0,19000,0,0,0,246000,227000,19000,19000,2021-06-09
3134,032713,東鋼群益11購01,0,0,0,0,0,0,0,0,0,19000,0,0,0,43000,24000,19000,19000,2021-06-09
3135,036274,榮成元大0C購02,0,0,0,0,0,0,0,0,0,19000,0,0,0,30000,11000,19000,19000,2021-06-09
3136,033540,中石化元富12購01,0,0,0,0,0,0,0,0,0,19000,0,0,0,19000,0,19000,19000,2021-06-09
3137,033621,金寶元富0B購01,0,0,0,0,0,0,0,0,0,19000,0,0,0,19000,0,19000,19000,2021-06-09
3138,034745,國泰金元大0B購03,0,0,0,0,0,0,0,0,0,19000,0,0,0,229000,210000,19000,19000,2021-06-09
3139,033878,華新元富0B購02,0,0,0,0,0,0,0,0,0,19000,0,0,0,19000,0,19000,19000,2021-06-09
3140,034526,宏碁康和0C購01,0,0,0,0,0,0,0,0,0,19000,0,0,0,118000,99000,19000,19000,2021-06-09
3141,034547,開發金統一0C購01,0,0,0,0,0,0,0,0,0,19000,0,0,0,259000,240000,19000,19000,2021-06-09
3142,034235,聯成統一13購01,0,0,0,0,0,0,0,0,0,19000,0,0,0,520000,501000,19000,19000,2021-06-09
3143,035512,華夏永豐0B購01,0,0,0,0,0,0,0,0,0,19000,0,0,0,20000,1000,19000,19000,2021-06-09
3144,033994,新光金兆豐12購01,0,0,0,0,0,0,0,0,0,19000,0,0,0,20000,1000,19000,19000,2021-06-09
3145,081592,中橡元大07購02,0,0,0,0,0,0,0,0,0,19000,0,0,0,19000,0,19000,19000,2021-06-09
3146,082482,鴻海統一09購07,0,0,0,0,0,0,0,0,0,19000,0,0,0,19000,0,19000,19000,2021-06-09
3147,078075,惠特國票08購01,0,0,0,0,0,0,0,0,0,19000,0,0,0,20000,1000,19000,19000,2021-06-09
3148,07197P,大立光富邦13售02,0,0,0,0,0,0,0,0,0,19000,0,0,0,20000,1000,19000,19000,2021-06-09
3149,06443P,大立光元大09售09,0,0,0,0,0,0,0,0,0,19000,0,0,0,50000,31000,19000,19000,2021-06-09
3150,9933,中鼎,149000,128000,21000,0,0,0,0,0,0,-2000,0,2000,-2000,0,0,0,19000,2021-06-09
3151,6409,旭隼,34500,16000,18500,0,0,0,0,0,0,-15,0,15,-15,0,0,0,18485,2021-06-09
3152,085046,華擎元富08購01,0,0,0,0,0,0,0,0,0,18000,0,0,0,18000,0,18000,18000,2021-06-09
3153,084786,和碩凱基0A購03,0,0,0,0,0,0,0,0,0,18000,0,0,0,20000,2000,18000,18000,2021-06-09
3154,085309,大立光元大08購04,0,0,0,0,0,0,0,0,0,18000,0,0,0,21000,3000,18000,18000,2021-06-09
3155,085988,華邦電元大0C購03,0,0,0,0,0,0,0,0,0,18000,0,0,0,28000,10000,18000,18000,2021-06-09
3156,085837,同欣電群益08購07,0,0,0,0,0,0,0,0,0,18000,0,0,0,18000,0,18000,18000,2021-06-09
3157,086156,聯發科元大08購16,0,0,0,0,0,0,0,0,0,18000,0,0,0,85000,67000,18000,18000,2021-06-09
3158,088696,惠特元富0C購01,0,0,0,0,0,0,0,0,0,18000,0,0,0,23000,5000,18000,18000,2021-06-09
3159,036305,愛普元大0C購05,0,0,0,0,0,0,0,0,0,18000,0,0,0,28000,10000,18000,18000,2021-06-09
3160,031743,台橡凱基12購01,0,0,0,0,0,0,0,0,0,18000,0,0,0,18000,0,18000,18000,2021-06-09
3161,032065,中石化中信0A購03,0,0,0,0,0,0,0,0,0,18000,0,0,0,84000,66000,18000,18000,2021-06-09
3162,030471,強茂國泰0C購01,0,0,0,0,0,0,0,0,0,18000,0,0,0,18000,0,18000,18000,2021-06-09
3163,031401,宏碁兆豐0A購01,0,0,0,0,0,0,0,0,0,18000,0,0,0,21000,3000,18000,18000,2021-06-09
3164,034278,國巨富邦11購02,0,0,0,0,0,0,0,0,0,18000,0,0,0,18000,0,18000,18000,2021-06-09
3165,036402,長榮航永豐0C購01,0,0,0,0,0,0,0,0,0,18000,0,0,0,21000,3000,18000,18000,2021-06-09
3166,034486,裕民元大0B購04,0,0,0,0,0,0,0,0,0,18000,0,0,0,20000,2000,18000,18000,2021-06-09
3167,034389,新光金元大12購02,0,0,0,0,0,0,0,0,0,18000,0,0,0,20000,2000,18000,18000,2021-06-09
3168,06024P,台積電凱基07售17,0,0,0,0,0,0,0,0,0,18000,0,0,0,18000,0,18000,18000,2021-06-09
3169,06692P,聯發科凱基13售02,0,0,0,0,0,0,0,0,0,18000,0,0,0,18000,0,18000,18000,2021-06-09
3170,07112P,中鋼康和0B售01,0,0,0,0,0,0,0,0,0,18000,0,0,0,30000,12000,18000,18000,2021-06-09
3171,071133,為升元富09購01,0,0,0,0,0,0,0,0,0,18000,0,0,0,24000,6000,18000,18000,2021-06-09
3172,07265P,群創元大0C售09,0,0,0,0,0,0,0,0,0,18000,0,0,0,30000,12000,18000,18000,2021-06-09
3173,07270P,臺股指凱基0C售31,0,0,0,0,0,0,0,0,0,18000,0,0,0,18000,0,18000,18000,2021-06-09
3174,073809,大亞統一06購02,0,0,0,0,0,0,0,0,0,18000,0,0,0,18000,0,18000,18000,2021-06-09
3175,078488,華邦電國票08購03,0,0,0,0,0,0,0,0,0,18000,0,0,0,18000,0,18000,18000,2021-06-09
3176,082479,台達電統一08購02,0,0,0,0,0,0,0,0,0,18000,0,0,0,28000,10000,18000,18000,2021-06-09
3177,082600,華碩元大07購03,0,0,0,0,0,0,0,0,0,18000,0,0,0,18000,0,18000,18000,2021-06-09
3178,081973,台積電元大08購05,0,0,0,0,0,0,0,0,0,18000,0,0,0,18000,0,18000,18000,2021-06-09
3179,079358,長榮航凱基07購01,0,0,0,0,0,0,0,0,0,18000,0,0,0,18000,0,18000,18000,2021-06-09
3180,080063,榮成元大06購04,0,0,0,0,0,0,0,0,0,18000,0,0,0,18000,0,18000,18000,2021-06-09
3181,081202,玉山金元大07購01,0,0,0,0,0,0,0,0,0,18000,0,0,0,18000,0,18000,18000,2021-06-09
3182,081065,台化中信09購01,0,0,0,0,0,0,0,0,0,18000,0,0,0,18000,0,18000,18000,2021-06-09
3183,080894,百和中信0B購01,0,0,0,0,0,0,0,0,0,18000,0,0,0,18000,0,18000,18000,2021-06-09
3184,080763,華邦電元大06購17,0,0,0,0,0,0,0,0,0,18000,0,0,0,18000,0,18000,18000,2021-06-09
3185,6451,訊芯-KY,154000,141000,13000,0,0,0,0,0,0,5000,0,0,0,7000,2000,5000,18000,2021-06-09
3186,8039,台虹,170000,152000,18000,0,0,0,0,0,0,0,0,0,0,0,0,0,18000,2021-06-09
3187,089407,華新科凱基09購06,0,0,0,0,0,0,0,0,0,18000,0,0,0,19000,1000,18000,18000,2021-06-09
3188,089424,美食永豐09購01,0,0,0,0,0,0,0,0,0,18000,0,0,0,24000,6000,18000,18000,2021-06-09
3189,089336,南帝元大09購07,0,0,0,0,0,0,0,0,0,18000,0,0,0,19000,1000,18000,18000,2021-06-09
3190,089502,南帝元大09購08,0,0,0,0,0,0,0,0,0,18000,0,0,0,18000,0,18000,18000,2021-06-09
3191,00861,元大全球未來通訊,41000,4000,37000,0,0,0,0,0,0,-19837,0,0,0,12163,32000,-19837,17163,2021-06-09
3192,088212,順德統一0A購01,0,0,0,0,0,0,0,0,0,17000,0,0,0,17000,0,17000,17000,2021-06-09
3193,086992,中鴻國票0A購02,0,0,0,0,0,0,0,0,0,17000,0,0,0,17000,0,17000,17000,2021-06-09
3194,086728,友達康和09購01,0,0,0,0,0,0,0,0,0,17000,0,0,0,260000,243000,17000,17000,2021-06-09
3195,087553,玉晶光元富13購01,0,0,0,0,0,0,0,0,0,17000,0,0,0,17000,0,17000,17000,2021-06-09
3196,084485,凌陽凱基08購03,0,0,0,0,0,0,0,0,0,17000,0,0,0,17000,0,17000,17000,2021-06-09
3197,084120,義隆群益08購01,0,0,0,0,0,0,0,0,0,17000,0,0,0,17000,0,17000,17000,2021-06-09
3198,030099,立隆電永豐0A購01,0,0,0,0,0,0,0,0,0,17000,0,0,0,20000,3000,17000,17000,2021-06-09
3199,032743,富邦金凱基0A購03,0,0,0,0,0,0,0,0,0,17000,0,0,0,20000,3000,17000,17000,2021-06-09
3200,031084,臺股指元大11購08,0,0,0,0,0,0,0,0,0,17000,0,0,0,30000,13000,17000,17000,2021-06-09
3201,030798,長榮凱基0A購08,0,0,0,0,0,0,0,0,0,17000,0,0,0,18000,1000,17000,17000,2021-06-09
3202,031670,長榮航元大0A購03,0,0,0,0,0,0,0,0,0,17000,0,0,0,18000,1000,17000,17000,2021-06-09
3203,031771,技嘉統一0B購03,0,0,0,0,0,0,0,0,0,17000,0,0,0,17000,0,17000,17000,2021-06-09
3204,033037,光罩兆豐0B購01,0,0,0,0,0,0,0,0,0,17000,0,0,0,288000,271000,17000,17000,2021-06-09
3205,05905P,臺股指國票08售02,0,0,0,0,0,0,0,0,0,17000,0,0,0,20000,3000,17000,17000,2021-06-09
3206,034932,大成鋼永豐0B購02,0,0,0,0,0,0,0,0,0,17000,0,0,0,17000,0,17000,17000,2021-06-09
3207,034195,友達元大0B購12,0,0,0,0,0,0,0,0,0,17000,0,0,0,27000,10000,17000,17000,2021-06-09
3208,05711P,奇鋐元大07售01,0,0,0,0,0,0,0,0,0,17000,0,0,0,23000,6000,17000,17000,2021-06-09
3209,035752,中鋼元富0B購07,0,0,0,0,0,0,0,0,0,17000,0,0,0,168000,151000,17000,17000,2021-06-09
3210,081167,同欣電富邦07購02,0,0,0,0,0,0,0,0,0,17000,0,0,0,17000,0,17000,17000,2021-06-09
3211,079261,世芯元大06購05,0,0,0,0,0,0,0,0,0,17000,0,0,0,17000,0,17000,17000,2021-06-09
3212,081482,台揚凱基07購01,0,0,0,0,0,0,0,0,0,17000,0,0,0,17000,0,17000,17000,2021-06-09
3213,078852,長榮統一07購01,0,0,0,0,0,0,0,0,0,17000,0,0,0,28000,11000,17000,17000,2021-06-09
3214,06486P,台積電元大0B售04,0,0,0,0,0,0,0,0,0,17000,0,0,0,17000,0,17000,17000,2021-06-09
3215,1597,直得,85000,66000,19000,0,0,0,0,0,0,-2000,0,0,0,0,2000,-2000,17000,2021-06-09
3216,2102,泰豐,3049000,3030000,19000,0,0,0,0,0,0,-2000,0,0,0,49000,51000,-2000,17000,2021-06-09
3217,2348,海悅,48000,30000,18000,0,0,0,0,0,0,-1000,0,0,0,0,1000,-1000,17000,2021-06-09
3218,083464,台積電統一09購09,0,0,0,0,0,0,0,0,0,16000,0,0,0,30000,14000,16000,16000,2021-06-09
3219,084290,晶技永豐07購03,0,0,0,0,0,0,0,0,0,16000,0,0,0,20000,4000,16000,16000,2021-06-09
3220,085994,友達元大0B購01,0,0,0,0,0,0,0,0,0,16000,0,0,0,16000,0,16000,16000,2021-06-09
3221,085300,恆大元大08購02,0,0,0,0,0,0,0,0,0,16000,0,0,0,16000,0,16000,16000,2021-06-09
3222,085619,T50反1凱基0B購02,10000,0,10000,0,0,0,0,0,0,6000,0,0,0,370000,364000,6000,16000,2021-06-09
3223,086721,日月光元大0B購01,0,0,0,0,0,0,0,0,0,16000,0,0,0,16000,0,16000,16000,2021-06-09
3224,086929,海悅元大09購01,0,0,0,0,0,0,0,0,0,16000,0,0,0,16000,0,16000,16000,2021-06-09
3225,087844,臺股指凱基09購29,0,0,0,0,0,0,0,0,0,16000,0,0,0,16000,0,16000,16000,2021-06-09
3226,088896,立積凱基0B購01,0,0,0,0,0,0,0,0,0,16000,0,0,0,36000,20000,16000,16000,2021-06-09
3227,088617,玉晶光永豐09購02,0,0,0,0,0,0,0,0,0,16000,0,0,0,24000,8000,16000,16000,2021-06-09
3228,032443,富邦金元大0A購03,0,0,0,0,0,0,0,0,0,16000,0,0,0,16000,0,16000,16000,2021-06-09
3229,031295,聯陽康和11購01,0,0,0,0,0,0,0,0,0,16000,0,0,0,17000,1000,16000,16000,2021-06-09
3230,030883,宏碁麥證0A購02,0,0,0,17000,1000,16000,0,0,0,16000,0,0,0,17000,1000,16000,16000,2021-06-09
3231,030133,長榮凱基13購01,0,0,0,0,0,0,0,0,0,16000,0,0,0,16000,0,16000,16000,2021-06-09
3232,035711,鴻海元大13購01,0,0,0,0,0,0,0,0,0,16000,0,0,0,30000,14000,16000,16000,2021-06-09
3233,034855,長榮元大0B購19,0,0,0,0,0,0,0,0,0,16000,0,0,0,16000,0,16000,16000,2021-06-09
3234,034017,聯電統一11購02,0,0,0,0,0,0,0,0,0,16000,0,0,0,32000,16000,16000,16000,2021-06-09
3235,035870,亞光元富13購01,0,0,0,0,0,0,0,0,0,16000,0,0,0,32000,16000,16000,16000,2021-06-09
3236,035810,裕民凱基13購01,0,0,0,0,0,0,0,0,0,16000,0,0,0,16000,0,16000,16000,2021-06-09
3237,035012,鴻海第一15購01,0,0,0,0,0,0,0,0,0,16000,0,0,0,16000,0,16000,16000,2021-06-09
3238,034026,富邦金中信0B購02,0,0,0,0,0,0,0,0,0,16000,0,0,0,20000,4000,16000,16000,2021-06-09
3239,033823,富邦金統一12購01,0,0,0,0,0,0,0,0,0,16000,0,0,0,16000,0,16000,16000,2021-06-09
3240,034487,裕民元大0B購05,0,0,0,0,0,0,0,0,0,16000,0,0,0,16000,0,16000,16000,2021-06-09
3241,06241P,聯電元大08售06,0,0,0,0,0,0,0,0,0,16000,0,0,0,70000,54000,16000,16000,2021-06-09
3242,034438,華通凱基0B購02,0,0,0,0,0,0,0,0,0,16000,0,0,0,16000,0,16000,16000,2021-06-09
3243,06434P,大立光元大09售08,0,0,0,0,0,0,0,0,0,16000,0,0,0,20000,4000,16000,16000,2021-06-09
3244,06643P,聯電元大09售06,0,0,0,0,0,0,0,0,0,16000,0,0,0,17000,1000,16000,16000,2021-06-09
3245,07024P,臺股指麥證0B售01,0,0,0,20000,4000,16000,0,0,0,16000,0,0,0,20000,4000,16000,16000,2021-06-09
3246,079010,精成科凱基06購01,0,0,0,0,0,0,0,0,0,16000,0,0,0,16000,0,16000,16000,2021-06-09
3247,073394,台達電元富0A購01,0,0,0,0,0,0,0,0,0,16000,0,0,0,16000,0,16000,16000,2021-06-09
3248,081891,嘉澤群益08購01,0,0,0,0,0,0,0,0,0,16000,0,0,0,90000,74000,16000,16000,2021-06-09
3249,080826,長榮永豐06購12,0,0,0,0,0,0,0,0,0,16000,0,0,0,146000,130000,16000,16000,2021-06-09
3250,2228,劍麟,24000,8000,16000,0,0,0,0,0,0,0,0,0,0,0,0,0,16000,2021-06-09
3251,4545,銘鈺,24000,8000,16000,0,0,0,0,0,0,0,0,0,0,0,0,0,16000,2021-06-09
3252,088653,元石油元大0C購01,0,0,0,0,0,0,0,0,0,15000,0,0,0,15000,0,15000,15000,2021-06-09
3253,088557,A50正2凱基0C購01,0,0,0,0,0,0,0,0,0,15000,0,0,0,15000,0,15000,15000,2021-06-09
3254,088489,滬深2X元大11購02,0,0,0,0,0,0,0,0,0,15000,0,0,0,15000,0,15000,15000,2021-06-09
3255,088676,晶碩元大0A購01,0,0,0,0,0,0,0,0,0,15000,0,0,0,15000,0,15000,15000,2021-06-09
3256,087971,儒鴻凱基09購01,0,0,0,0,0,0,0,0,0,15000,0,0,0,43000,28000,15000,15000,2021-06-09
3257,087685,旺宏元大11購03,0,0,0,0,0,0,0,0,0,15000,0,0,0,15000,0,15000,15000,2021-06-09
3258,086729,群創富邦0A購01,0,0,0,0,0,0,0,0,0,15000,0,0,0,15000,0,15000,15000,2021-06-09
3259,087542,滬深2X元富09購08,0,0,0,0,0,0,0,0,0,15000,0,0,0,15000,0,15000,15000,2021-06-09
3260,087265,臺股指國票09購21,0,0,0,0,0,0,0,0,0,15000,0,0,0,27000,12000,15000,15000,2021-06-09
3261,085840,世紀鋼群益09購01,0,0,0,0,0,0,0,0,0,15000,0,0,0,15000,0,15000,15000,2021-06-09
3262,085927,和碩兆豐08購01,0,0,0,0,0,0,0,0,0,15000,0,0,0,15000,0,15000,15000,2021-06-09
3263,086162,聯陽元大08購03,0,0,0,0,0,0,0,0,0,15000,0,0,0,15000,0,15000,15000,2021-06-09
3264,086168,聯詠元大0C購02,0,0,0,0,0,0,0,0,0,15000,0,0,0,45000,30000,15000,15000,2021-06-09
3265,086276,T50正2群益09購05,0,0,0,0,0,0,0,0,0,15000,0,0,0,15000,0,15000,15000,2021-06-09
3266,084583,和碩國泰09購01,0,0,0,0,0,0,0,0,0,15000,0,0,0,15000,0,15000,15000,2021-06-09
3267,083719,台積電元大07購32,0,0,0,0,0,0,0,0,0,15000,0,0,0,15000,0,15000,15000,2021-06-09
3268,089034,台泥兆豐0A購01,0,0,0,0,0,0,0,0,0,15000,0,0,0,210000,195000,15000,15000,2021-06-09
3269,089024,立積元大0C購01,0,0,0,0,0,0,0,0,0,15000,0,0,0,15000,0,15000,15000,2021-06-09
3270,030205,超豐凱基0A購01,0,0,0,0,0,0,0,0,0,15000,0,0,0,79000,64000,15000,15000,2021-06-09
3271,031483,國喬元大0C購02,0,0,0,0,0,0,0,0,0,15000,0,0,0,60000,45000,15000,15000,2021-06-09
3272,030436,聯德元大0A購01,0,0,0,0,0,0,0,0,0,15000,0,0,0,25000,10000,15000,15000,2021-06-09
3273,030422,聯詠元大11購02,0,0,0,0,0,0,0,0,0,15000,0,0,0,15000,0,15000,15000,2021-06-09
3274,030934,聯陽群益0A購02,0,0,0,0,0,0,0,0,0,15000,0,0,0,21000,6000,15000,15000,2021-06-09
3275,030642,大成鋼日盛0A購02,0,0,0,0,0,0,0,0,0,15000,0,0,0,15000,0,15000,15000,2021-06-09
3276,031310,滬深2X元大0A購06,0,0,0,0,0,0,0,0,0,15000,0,0,0,15000,0,15000,15000,2021-06-09
3277,032392,新興統一12購01,0,0,0,0,0,0,0,0,0,15000,0,0,0,15000,0,15000,15000,2021-06-09
3278,033543,國巨元富12購01,0,0,0,0,0,0,0,0,0,15000,0,0,0,15000,0,15000,15000,2021-06-09
3279,033582,大成鋼凱基0B購03,0,0,0,0,0,0,0,0,0,15000,0,0,0,15000,0,15000,15000,2021-06-09
3280,033047,矽創兆豐0B購02,0,0,0,0,0,0,0,0,0,15000,0,0,0,15000,0,15000,15000,2021-06-09
3281,032991,旺宏元富0B購02,0,0,0,0,0,0,0,0,0,15000,0,0,0,15000,0,15000,15000,2021-06-09
3282,033252,奇鋐元大0B購01,0,0,0,0,0,0,0,0,0,15000,0,0,0,15000,0,15000,15000,2021-06-09
3283,033230,滬深2X元大0B購03,0,0,0,0,0,0,0,0,0,15000,0,0,0,45000,30000,15000,15000,2021-06-09
3284,031758,百和凱基12購01,0,0,0,0,0,0,0,0,0,15000,0,0,0,15000,0,15000,15000,2021-06-09
3285,03194P,國巨元富07售14,0,0,0,0,0,0,0,0,0,15000,0,0,0,40000,25000,15000,15000,2021-06-09
3286,032472,萬海中信0C購01,0,0,0,0,0,0,0,0,0,15000,0,0,0,20000,5000,15000,15000,2021-06-09
3287,032117,台聚凱基0A購03,0,0,0,0,0,0,0,0,0,15000,0,0,0,15000,0,15000,15000,2021-06-09
3288,035604,欣興元大0B購05,0,0,0,0,0,0,0,0,0,15000,0,0,0,75000,60000,15000,15000,2021-06-09
3289,035587,中鋼元大0C購04,0,0,0,0,0,0,0,0,0,15000,0,0,0,15000,0,15000,15000,2021-06-09
3290,06222P,台積電元大09售10,0,0,0,0,0,0,0,0,0,15000,0,0,0,15000,0,15000,15000,2021-06-09
3291,05954P,台積電國票08售10,0,0,0,0,0,0,0,0,0,15000,0,0,0,15000,0,15000,15000,2021-06-09
3292,035536,南電兆豐13購01,0,0,0,0,0,0,0,0,0,15000,0,0,0,35000,20000,15000,15000,2021-06-09
3293,034489,萬海元大0B購07,0,0,0,0,0,0,0,0,0,15000,0,0,0,15000,0,15000,15000,2021-06-09
3294,034359,大亞麥證0B購02,0,0,0,15000,0,15000,0,0,0,15000,0,0,0,15000,0,15000,15000,2021-06-09
3295,035402,華邦電元富0C購04,0,0,0,0,0,0,0,0,0,15000,0,0,0,15000,0,15000,15000,2021-06-09
3296,035379,裕民凱基0B購02,0,0,0,0,0,0,0,0,0,15000,0,0,0,15000,0,15000,15000,2021-06-09
3297,035072,華邦電群益0B購10,0,0,0,0,0,0,0,0,0,15000,0,0,0,28000,13000,15000,15000,2021-06-09
3298,035855,祥碩統一13購01,0,0,0,0,0,0,0,0,0,15000,0,0,0,15000,0,15000,15000,2021-06-09
3299,035857,華新科台新0B購01,0,0,0,0,0,0,0,0,0,15000,0,0,0,21000,6000,15000,15000,2021-06-09
3300,035832,聯電元大0B購08,0,0,0,0,0,0,0,0,0,15000,0,0,0,21000,6000,15000,15000,2021-06-09
3301,035917,中鋼統一0C購15,0,0,0,0,0,0,0,0,0,15000,0,0,0,15000,0,15000,15000,2021-06-09
3302,036125,安集群益0C購01,0,0,0,0,0,0,0,0,0,15000,0,0,0,15000,0,15000,15000,2021-06-09
3303,034316,台聚群益0B購02,0,0,0,0,0,0,0,0,0,15000,0,0,0,15000,0,15000,15000,2021-06-09
3304,080853,華擎元富06購01,0,0,0,0,0,0,0,0,0,15000,0,0,0,15000,0,15000,15000,2021-06-09
3305,080964,華城元大07購01,0,0,0,0,0,0,0,0,0,15000,0,0,0,15000,0,15000,15000,2021-06-09
3306,080971,台船元大07購01,0,0,0,0,0,0,0,0,0,15000,0,0,0,15000,0,15000,15000,2021-06-09
3307,080769,長榮元大06購25,0,0,0,0,0,0,0,0,0,15000,0,0,0,15000,0,15000,15000,2021-06-09
3308,079641,群創兆豐06購03,0,0,0,0,0,0,0,0,0,15000,0,0,0,15000,0,15000,15000,2021-06-09
3309,079815,世紀鋼凱基06購02,0,0,0,0,0,0,0,0,0,15000,0,0,0,15000,0,15000,15000,2021-06-09
3310,080083,新興元大06購02,0,0,0,0,0,0,0,0,0,15000,0,0,0,15000,0,15000,15000,2021-06-09
3311,080320,台泥凱基07購01,0,0,0,0,0,0,0,0,0,15000,0,0,0,15000,0,15000,15000,2021-06-09
3312,081839,欣興凱基08購03,0,0,0,0,0,0,0,0,0,15000,0,0,0,15000,0,15000,15000,2021-06-09
3313,081492,長榮凱基0A購03,0,0,0,0,0,0,0,0,0,15000,0,0,0,15000,0,15000,15000,2021-06-09
3314,083218,樺漢統一09購01,0,0,0,0,0,0,0,0,0,15000,0,0,0,16000,1000,15000,15000,2021-06-09
3315,073477,玉晶光元大07購01,0,0,0,0,0,0,0,0,0,15000,0,0,0,15000,0,15000,15000,2021-06-09
3316,072705,超眾元富09購01,0,0,0,0,0,0,0,0,0,15000,0,0,0,15000,0,15000,15000,2021-06-09
3317,075597,SGBR2X凱基07購01,0,0,0,0,0,0,0,0,0,15000,0,0,0,15000,0,15000,15000,2021-06-09
3318,078211,旺宏國泰08購02,0,0,0,0,0,0,0,0,0,15000,0,0,0,193000,178000,15000,15000,2021-06-09
3319,077471,聯發科國票08購05,0,0,0,0,0,0,0,0,0,15000,0,0,0,18000,3000,15000,15000,2021-06-09
3320,07124P,臺股指元大0C售23,0,0,0,0,0,0,0,0,0,15000,0,0,0,15000,0,15000,15000,2021-06-09
3321,07010P,臺股指凱基0B售07,0,0,0,0,0,0,0,0,0,15000,0,0,0,15000,0,15000,15000,2021-06-09
3322,06840P,台灣50元大11售02,0,0,0,0,0,0,0,0,0,15000,0,0,0,15000,0,15000,15000,2021-06-09
3323,06650P,榮成元大09售04,0,0,0,0,0,0,0,0,0,15000,0,0,0,39000,24000,15000,15000,2021-06-09
3324,06781P,聯發科中信0A售06,0,0,0,0,0,0,0,0,0,15000,0,0,0,15000,0,15000,15000,2021-06-09
3325,2701,萬企,24000,9000,15000,0,0,0,0,0,0,0,0,0,0,0,0,0,15000,2021-06-09
3326,2241,艾姆勒,17000,2000,15000,0,0,0,0,0,0,0,0,0,0,0,0,0,15000,2021-06-09
3327,2358,廷鑫,49000,34000,15000,0,0,0,0,0,0,0,0,0,0,0,0,0,15000,2021-06-09
3328,2482,連宇,17000,2000,15000,0,0,0,0,0,0,0,0,0,0,0,0,0,15000,2021-06-09
3329,1454,台富,23000,8000,15000,0,0,0,0,0,0,0,0,0,0,0,0,0,15000,2021-06-09
3330,089876,中石化群益0B購01,0,0,0,0,0,0,0,0,0,15000,0,0,0,15000,0,15000,15000,2021-06-09
3331,089999,裕民中信0A購01,0,0,0,0,0,0,0,0,0,15000,0,0,0,15000,0,15000,15000,2021-06-09
3332,9924,福興,23000,8000,15000,0,0,0,0,0,0,0,0,0,0,0,0,0,15000,2021-06-09
3333,083597,志超國票08購01,0,0,0,0,0,0,0,0,0,14000,0,0,0,14000,0,14000,14000,2021-06-09
3334,084642,南茂凱基08購01,0,0,0,0,0,0,0,0,0,14000,0,0,0,15000,1000,14000,14000,2021-06-09
3335,086347,長榮航元大0B購01,0,0,0,0,0,0,0,0,0,14000,0,0,0,14000,0,14000,14000,2021-06-09
3336,085253,欣興國票09購02,0,0,0,0,0,0,0,0,0,14000,0,0,0,14000,0,14000,14000,2021-06-09
3337,087670,滬深2X元大0A購03,0,0,0,0,0,0,0,0,0,14000,0,0,0,14000,0,14000,14000,2021-06-09
3338,086544,大亞元大09購01,0,0,0,0,0,0,0,0,0,14000,0,0,0,14000,0,14000,14000,2021-06-09
3339,087776,群創中信0B購05,0,0,0,0,0,0,0,0,0,14000,0,0,0,14000,0,14000,14000,2021-06-09
3340,087867,上証2X元大09購03,0,0,0,0,0,0,0,0,0,14000,0,0,0,30000,16000,14000,14000,2021-06-09
3341,088925,宏碁統一0B購02,0,0,0,0,0,0,0,0,0,14000,0,0,0,14000,0,14000,14000,2021-06-09
3342,032104,長榮永豐0A購09,0,0,0,0,0,0,0,0,0,14000,0,0,0,24000,10000,14000,14000,2021-06-09
3343,031810,東鋼元大0B購02,0,0,0,0,0,0,0,0,0,14000,0,0,0,14000,0,14000,14000,2021-06-09
3344,05484P,台灣50元富09售02,0,0,0,0,0,0,0,0,0,14000,0,0,0,14000,0,14000,14000,2021-06-09
3345,036325,榮成麥證0C購01,0,0,0,14000,0,14000,0,0,0,14000,0,0,0,14000,0,14000,14000,2021-06-09
3346,032748,南茂凱基0A購02,0,0,0,0,0,0,0,0,0,14000,0,0,0,520000,506000,14000,14000,2021-06-09
3347,034306,大毅永豐0B購01,0,0,0,0,0,0,0,0,0,14000,0,0,0,14000,0,14000,14000,2021-06-09
3348,036117,國巨群益0C購02,0,0,0,0,0,0,0,0,0,14000,0,0,0,14000,0,14000,14000,2021-06-09
3349,036005,東鋼凱基0C購03,0,0,0,0,0,0,0,0,0,14000,0,0,0,14000,0,14000,14000,2021-06-09
3350,033961,南亞科國泰11購01,0,0,0,0,0,0,0,0,0,14000,0,0,0,34000,20000,14000,14000,2021-06-09
3351,035791,華通中信0B購01,0,0,0,0,0,0,0,0,0,14000,0,0,0,14000,0,14000,14000,2021-06-09
3352,035374,東鋼凱基0C購02,0,0,0,0,0,0,0,0,0,14000,0,0,0,88000,74000,14000,14000,2021-06-09
3353,035237,台塑群益0C購01,0,0,0,0,0,0,0,0,0,14000,0,0,0,14000,0,14000,14000,2021-06-09
3354,05896P,台積電國票08售09,0,0,0,0,0,0,0,0,0,14000,0,0,0,14000,0,14000,14000,2021-06-09
3355,034057,T50反1國票0C購01,0,0,0,0,0,0,0,0,0,14000,0,0,0,555000,541000,14000,14000,2021-06-09
3356,036162,GIS元大0C購03,0,0,0,0,0,0,0,0,0,14000,0,0,0,14000,0,14000,14000,2021-06-09
3357,033889,華新統一13購02,0,0,0,0,0,0,0,0,0,14000,0,0,0,30000,16000,14000,14000,2021-06-09
3358,06737P,聯詠元大09售16,0,0,0,0,0,0,0,0,0,14000,0,0,0,14000,0,14000,14000,2021-06-09
3359,06493P,國巨凱基09售10,0,0,0,0,0,0,0,0,0,14000,0,0,0,42000,28000,14000,14000,2021-06-09
3360,077549,欣興國票06購05,0,0,0,0,0,0,0,0,0,14000,0,0,0,14000,0,14000,14000,2021-06-09
3361,078773,光罩群益06購03,0,0,0,0,0,0,0,0,0,14000,0,0,0,14000,0,14000,14000,2021-06-09
3362,081634,台勝科元大07購04,0,0,0,0,0,0,0,0,0,14000,0,0,0,14000,0,14000,14000,2021-06-09
3363,080559,國巨富邦07購05,0,0,0,0,0,0,0,0,0,14000,0,0,0,14000,0,14000,14000,2021-06-09
3364,8222,寶一,23000,9000,14000,0,0,0,0,0,0,0,0,0,0,0,0,0,14000,2021-06-09
3365,6754,匯僑設計,23000,9000,14000,0,0,0,0,0,0,0,0,0,0,0,0,0,14000,2021-06-09
3366,089984,玉晶光元大12購01,0,0,0,0,0,0,0,0,0,14000,0,0,0,14000,0,14000,14000,2021-06-09
3367,089843,燿華元大09購01,0,0,0,0,0,0,0,0,0,14000,0,0,0,100000,86000,14000,14000,2021-06-09
3368,089351,宏碁元大12購01,0,0,0,0,0,0,0,0,0,14000,0,0,0,17000,3000,14000,14000,2021-06-09
3369,5215,科嘉-KY,48000,34000,14000,0,0,0,0,0,0,0,0,0,0,0,0,0,14000,2021-06-09
3370,5269,祥碩,82000,76000,6000,0,0,0,10000,0,10000,-2075,1,76,-75,0,2000,-2000,13925,2021-06-09
3371,088695,晶碩元富09購02,0,0,0,0,0,0,0,0,0,13000,0,0,0,13000,0,13000,13000,2021-06-09
3372,088479,晶碩國票0A購02,0,0,0,0,0,0,0,0,0,13000,0,0,0,29000,16000,13000,13000,2021-06-09
3373,086533,啟碁凱基09購01,0,0,0,0,0,0,0,0,0,13000,0,0,0,20000,7000,13000,13000,2021-06-09
3374,087382,國巨元大11購01,0,0,0,0,0,0,0,0,0,13000,0,0,0,13000,0,13000,13000,2021-06-09
3375,085120,致伸元大08購01,0,0,0,0,0,0,0,0,0,13000,0,0,0,13000,0,13000,13000,2021-06-09
3376,085502,玉晶光凱基08購08,0,0,0,0,0,0,0,0,0,13000,0,0,0,22000,9000,13000,13000,2021-06-09
3377,086260,台橡永豐09購01,0,0,0,0,0,0,0,0,0,13000,0,0,0,13000,0,13000,13000,2021-06-09
3378,086030,美食永豐08購01,0,0,0,0,0,0,0,0,0,13000,0,0,0,75000,62000,13000,13000,2021-06-09
3379,031111,亞光群益0B購01,0,0,0,0,0,0,0,0,0,13000,0,0,0,13000,0,13000,13000,2021-06-09
3380,031587,晶技凱基0B購02,0,0,0,0,0,0,0,0,0,13000,0,0,0,13000,0,13000,13000,2021-06-09
3381,030895,南紡凱基11購01,0,0,0,0,0,0,0,0,0,13000,0,0,0,13000,0,13000,13000,2021-06-09
3382,030901,大成鋼凱基14購01,0,0,0,0,0,0,0,0,0,13000,0,0,0,13000,0,13000,13000,2021-06-09
3383,030241,鴻海永豐0A購03,0,0,0,0,0,0,0,0,0,13000,0,0,0,125000,112000,13000,13000,2021-06-09
3384,030067,岱宇群益0B購01,0,0,0,0,0,0,0,0,0,13000,0,0,0,13000,0,13000,13000,2021-06-09
3385,020012,富邦行動通訊N,0,0,0,0,0,0,0,0,0,13000,0,0,0,13000,0,13000,13000,2021-06-09
3386,031459,矽統群益0B購02,0,0,0,0,0,0,0,0,0,13000,0,0,0,13000,0,13000,13000,2021-06-09
3387,031691,華通兆豐0A購01,0,0,0,0,0,0,0,0,0,13000,0,0,0,13000,0,13000,13000,2021-06-09
3388,032008,臺股指群益0A購10,0,0,0,0,0,0,0,0,0,13000,0,0,0,13000,0,13000,13000,2021-06-09
3389,031898,亞聚永豐0A購02,0,0,0,0,0,0,0,0,0,13000,0,0,0,14000,1000,13000,13000,2021-06-09
3390,032481,國喬兆豐0C購01,0,0,0,0,0,0,0,0,0,13000,0,0,0,240000,227000,13000,13000,2021-06-09
3391,033040,聯發科兆豐0A購07,0,0,0,0,0,0,0,0,0,13000,0,0,0,15000,2000,13000,13000,2021-06-09
3392,033566,萬海永豐0B購02,0,0,0,0,0,0,0,0,0,13000,0,0,0,13000,0,13000,13000,2021-06-09
3393,031867,中鋼凱基13購01,0,0,0,0,0,0,0,0,0,13000,0,0,0,15000,2000,13000,13000,2021-06-09
3394,033372,滬深2X元大13購02,0,0,0,0,0,0,0,0,0,13000,0,0,0,18000,5000,13000,13000,2021-06-09
3395,034415,大亞統一15購01,0,0,0,0,0,0,0,0,0,13000,0,0,0,18000,5000,13000,13000,2021-06-09
3396,06299P,臺股指凱基08售10,0,0,0,0,0,0,0,0,0,13000,0,0,0,13000,0,13000,13000,2021-06-09
3397,033754,玉晶光永豐0B購02,0,0,0,0,0,0,0,0,0,13000,0,0,0,14000,1000,13000,13000,2021-06-09
3398,034801,友達凱基11購04,0,0,0,0,0,0,0,0,0,13000,0,0,0,33000,20000,13000,13000,2021-06-09
3399,034067,華碩富邦11購01,0,0,0,0,0,0,0,0,0,13000,0,0,0,13000,0,13000,13000,2021-06-09
3400,034136,台聚凱基0C購02,0,0,0,0,0,0,0,0,0,13000,0,0,0,21000,8000,13000,13000,2021-06-09
3401,034401,永冠國票11購01,0,0,0,0,0,0,0,0,0,13000,0,0,0,13000,0,13000,13000,2021-06-09
3402,034724,中石化元大0B購04,0,0,0,0,0,0,0,0,0,13000,0,0,0,114000,101000,13000,13000,2021-06-09
3403,035067,上証2X群益0B購03,0,0,0,0,0,0,0,0,0,13000,0,0,0,13000,0,13000,13000,2021-06-09
3404,03860P,大立光國泰07售01,0,0,0,0,0,0,0,0,0,13000,0,0,0,13000,0,13000,13000,2021-06-09
3405,033959,友達富邦11購02,0,0,0,0,0,0,0,0,0,13000,0,0,0,25000,12000,13000,13000,2021-06-09
3406,080033,TPK富邦08購01,0,0,0,0,0,0,0,0,0,13000,0,0,0,13000,0,13000,13000,2021-06-09
3407,079514,恆大元大06購03,0,0,0,0,0,0,0,0,0,13000,0,0,0,13000,0,13000,13000,2021-06-09
3408,081832,長榮凱基09購02,0,0,0,0,0,0,0,0,0,13000,0,0,0,13000,0,13000,13000,2021-06-09
3409,082145,世紀鋼統一09購01,0,0,0,0,0,0,0,0,0,13000,0,0,0,13000,0,13000,13000,2021-06-09
3410,082005,聯發科中信07購04,0,0,0,0,0,0,0,0,0,13000,0,0,0,13000,0,13000,13000,2021-06-09
3411,075839,強茂元富08購01,0,0,0,0,0,0,0,0,0,13000,0,0,0,80000,67000,13000,13000,2021-06-09
3412,06888P,電子類群益0A售02,0,0,0,0,0,0,0,0,0,13000,0,0,0,16000,3000,13000,13000,2021-06-09
3413,083350,百和統一09購01,0,0,0,0,0,0,0,0,0,13000,0,0,0,13000,0,13000,13000,2021-06-09
3414,2427,三商電,36000,23000,13000,0,0,0,0,0,0,0,0,0,0,0,0,0,13000,2021-06-09
3415,089526,新唐元大09購02,0,0,0,0,0,0,0,0,0,13000,0,0,0,13000,0,13000,13000,2021-06-09
3416,00728,第一金工業30,0,0,0,0,0,0,0,0,0,12256,0,0,0,52000,39744,12256,12256,2021-06-09
3417,085987,華邦電元大08購06,0,0,0,0,0,0,0,0,0,12000,0,0,0,14000,2000,12000,12000,2021-06-09
3418,085998,健和興元大08購01,0,0,0,0,0,0,0,0,0,12000,0,0,0,36000,24000,12000,12000,2021-06-09
3419,083428,美利達永豐07購01,0,0,0,0,0,0,0,0,0,12000,0,0,0,32000,20000,12000,12000,2021-06-09
3420,083681,京元電統一08購02,0,0,0,0,0,0,0,0,0,12000,0,0,0,13000,1000,12000,12000,2021-06-09
3421,086665,台表科國票0A購01,0,0,0,0,0,0,0,0,0,12000,0,0,0,42000,30000,12000,12000,2021-06-09
3422,087964,國泰金中信0C購01,0,0,0,0,0,0,0,0,0,12000,0,0,0,12000,0,12000,12000,2021-06-09
3423,088073,國巨統一0C購01,0,0,0,0,0,0,0,0,0,12000,0,0,0,12000,0,12000,12000,2021-06-09
3424,00709,富邦歐洲,0,0,0,0,0,0,0,0,0,12000,0,0,0,113000,101000,12000,12000,2021-06-09
3425,030292,國光生元富11購01,0,0,0,0,0,0,0,0,0,12000,0,0,0,12000,0,12000,12000,2021-06-09
3426,030230,威鋒電凱基0C購01,0,0,0,0,0,0,0,0,0,12000,0,0,0,12000,0,12000,12000,2021-06-09
3427,031212,凌陽凱基0A購03,0,0,0,0,0,0,0,0,0,12000,0,0,0,269000,257000,12000,12000,2021-06-09
3428,030521,威鋒電群益0B購01,0,0,0,0,0,0,0,0,0,12000,0,0,0,12000,0,12000,12000,2021-06-09
3429,030522,昇陽半群益0A購01,0,0,0,0,0,0,0,0,0,12000,0,0,0,20000,8000,12000,12000,2021-06-09
3430,030600,大成鋼元大0A購03,0,0,0,0,0,0,0,0,0,12000,0,0,0,91000,79000,12000,12000,2021-06-09
3431,031128,嘉晶統一0C購01,0,0,0,0,0,0,0,0,0,12000,0,0,0,13000,1000,12000,12000,2021-06-09
3432,030731,旺宏元大0A購01,0,0,0,0,0,0,0,0,0,12000,0,0,0,12000,0,12000,12000,2021-06-09
3433,032894,長榮航統一0C購04,0,0,0,0,0,0,0,0,0,12000,0,0,0,15000,3000,12000,12000,2021-06-09
3434,035933,大成鋼凱基11購03,0,0,0,0,0,0,0,0,0,12000,0,0,0,12000,0,12000,12000,2021-06-09
3435,035968,友達元大13購01,0,0,0,0,0,0,0,0,0,12000,0,0,0,43000,31000,12000,12000,2021-06-09
3436,035759,健鼎元富13購01,0,0,0,0,0,0,0,0,0,12000,0,0,0,12000,0,12000,12000,2021-06-09
3437,035406,帆宣元富13購01,0,0,0,0,0,0,0,0,0,12000,0,0,0,12000,0,12000,12000,2021-06-09
3438,035234,友達永豐0B購04,0,0,0,0,0,0,0,0,0,12000,0,0,0,37000,25000,12000,12000,2021-06-09
3439,035280,東鋼國票0C購01,0,0,0,0,0,0,0,0,0,12000,0,0,0,112000,100000,12000,12000,2021-06-09
3440,034139,中鋼凱基13購02,0,0,0,0,0,0,0,0,0,12000,0,0,0,52000,40000,12000,12000,2021-06-09
3441,034243,新光鋼統一0C購03,0,0,0,0,0,0,0,0,0,12000,0,0,0,34000,22000,12000,12000,2021-06-09
3442,034782,長榮第一15購02,0,0,0,0,0,0,0,0,0,12000,0,0,0,12000,0,12000,12000,2021-06-09
3443,035571,裕民元富13購01,0,0,0,0,0,0,0,0,0,12000,0,0,0,22000,10000,12000,12000,2021-06-09
3444,036167,惠特元富0C購02,0,0,0,0,0,0,0,0,0,12000,0,0,0,22000,10000,12000,12000,2021-06-09
3445,033733,新唐國票0C購01,0,0,0,0,0,0,0,0,0,12000,0,0,0,136000,124000,12000,12000,2021-06-09
3446,05928P,台灣50元大07售22,0,0,0,0,0,0,0,0,0,12000,0,0,0,12000,0,12000,12000,2021-06-09
3447,083408,台揚永豐07購02,0,0,0,0,0,0,0,0,0,12000,0,0,0,12000,0,12000,12000,2021-06-09
3448,06882P,臺股指群益0A售12,0,0,0,0,0,0,0,0,0,12000,0,0,0,12000,0,12000,12000,2021-06-09
3449,075866,S&P正2中信07購01,0,0,0,0,0,0,0,0,0,12000,0,0,0,12000,0,12000,12000,2021-06-09
3450,072423,世紀鋼元富09購02,0,0,0,0,0,0,0,0,0,12000,0,0,0,12000,0,12000,12000,2021-06-09
3451,077422,台郡元富0B購01,0,0,0,0,0,0,0,0,0,12000,0,0,0,12000,0,12000,12000,2021-06-09
3452,082457,台積電元大07購16,0,0,0,0,0,0,0,0,0,12000,0,0,0,12000,0,12000,12000,2021-06-09
3453,080660,世芯元大06購07,0,0,0,0,0,0,0,0,0,12000,0,0,0,12000,0,12000,12000,2021-06-09
3454,081476,瑞軒康和07購01,0,0,0,0,0,0,0,0,0,12000,0,0,0,39000,27000,12000,12000,2021-06-09
3455,089432,上銀群益09購01,0,0,0,0,0,0,0,0,0,12000,0,0,0,12000,0,12000,12000,2021-06-09
3456,08927P,技嘉元富07售04,0,0,0,0,0,0,0,0,0,12000,0,0,0,62000,50000,12000,12000,2021-06-09
3457,089417,泰山永豐09購01,0,0,0,0,0,0,0,0,0,12000,0,0,0,17000,5000,12000,12000,2021-06-09
3458,089750,華新科統一0B購02,0,0,0,0,0,0,0,0,0,12000,0,0,0,40000,28000,12000,12000,2021-06-09
3459,089931,全新永豐0A購01,0,0,0,0,0,0,0,0,0,12000,0,0,0,75000,63000,12000,12000,2021-06-09
3460,1341,富林-KY,13000,1000,12000,0,0,0,0,0,0,0,0,0,0,0,0,0,12000,2021-06-09
3461,2059,川湖,38000,20000,18000,0,0,0,0,0,0,-6000,0,5000,-5000,0,1000,-1000,12000,2021-06-09
3462,3501,維熹,25000,13000,12000,0,0,0,0,0,0,0,0,0,0,0,0,0,12000,2021-06-09
3463,2809,京城銀,746000,590000,156000,0,0,0,0,238000,-238000,94000,0,0,0,94000,0,94000,12000,2021-06-09
3464,3167,大量,23000,11000,12000,0,0,0,0,0,0,0,0,0,0,0,0,0,12000,2021-06-09
3465,6768,志強-KY,30000,18000,12000,0,0,0,0,0,0,0,0,0,0,0,0,0,12000,2021-06-09
3466,6177,達麗,52000,40000,12000,0,0,0,0,0,0,0,0,0,0,0,0,0,12000,2021-06-09
3467,087675,榮成元大09購03,0,0,0,0,0,0,0,0,0,11000,0,0,0,11000,0,11000,11000,2021-06-09
3468,088708,仁寶中信0B購01,0,0,0,0,0,0,0,0,0,11000,0,0,0,17000,6000,11000,11000,2021-06-09
3469,088926,宏碁統一0B購03,0,0,0,0,0,0,0,0,0,11000,0,0,0,17000,6000,11000,11000,2021-06-09
3470,088934,玉晶光統一0B購06,0,0,0,0,0,0,0,0,0,11000,0,0,0,19000,8000,11000,11000,2021-06-09
3471,087198,晶技麥證09購02,0,0,0,21000,0,21000,0,0,0,11000,0,0,0,21000,10000,11000,11000,2021-06-09
3472,086035,景碩永豐08購02,0,0,0,0,0,0,0,0,0,11000,0,0,0,11000,0,11000,11000,2021-06-09
3473,086170,景碩元大09購01,0,0,0,0,0,0,0,0,0,11000,0,0,0,70000,59000,11000,11000,2021-06-09
3474,032969,長榮元大0A購31,0,0,0,0,0,0,0,0,0,11000,0,0,0,11000,0,11000,11000,2021-06-09
3475,032085,台達化永豐0A購02,0,0,0,0,0,0,0,0,0,11000,0,0,0,11000,0,11000,11000,2021-06-09
3476,032611,群創元大12購05,0,0,0,0,0,0,0,0,0,11000,0,0,0,11000,0,11000,11000,2021-06-09
3477,031132,群創統一0C購05,0,0,0,0,0,0,0,0,0,11000,0,0,0,11000,0,11000,11000,2021-06-09
3478,031083,臺股指元大11購07,0,0,0,0,0,0,0,0,0,11000,0,0,0,23000,12000,11000,11000,2021-06-09
3479,031042,祥碩凱基0A購01,0,0,0,0,0,0,0,0,0,11000,0,0,0,11000,0,11000,11000,2021-06-09
3480,031025,致茂凱基0B購01,0,0,0,0,0,0,0,0,0,11000,0,0,0,48000,37000,11000,11000,2021-06-09
3481,032784,裕民元大0A購03,0,0,0,0,0,0,0,0,0,11000,0,0,0,11000,0,11000,11000,2021-06-09
3482,030128,凌陽凱基0A購02,0,0,0,0,0,0,0,0,0,11000,0,0,0,364000,353000,11000,11000,2021-06-09
3483,030362,健鼎群益0B購01,0,0,0,0,0,0,0,0,0,11000,0,0,0,11000,0,11000,11000,2021-06-09
3484,06293P,聯電台新08售02,0,0,0,0,0,0,0,0,0,11000,0,0,0,11000,0,11000,11000,2021-06-09
3485,06158P,台積電國票09售08,0,0,0,0,0,0,0,0,0,11000,0,0,0,11000,0,11000,11000,2021-06-09
3486,06138P,台灣50國票07售05,0,0,0,0,0,0,0,0,0,11000,0,0,0,11000,0,11000,11000,2021-06-09
3487,033712,光寶科國票0C購01,0,0,0,0,0,0,0,0,0,11000,0,0,0,11000,0,11000,11000,2021-06-09
3488,034896,大立光凱基0B購04,0,0,0,0,0,0,0,0,0,11000,0,0,0,41000,30000,11000,11000,2021-06-09
3489,034244,新光鋼統一11購01,0,0,0,0,0,0,0,0,0,11000,0,0,0,25000,14000,11000,11000,2021-06-09
3490,034090,美律元大0B購03,0,0,0,0,0,0,0,0,0,11000,0,0,0,20000,9000,11000,11000,2021-06-09
3491,034364,合勤控麥證0B購02,0,0,0,14000,3000,11000,0,0,0,11000,0,0,0,14000,3000,11000,11000,2021-06-09
3492,035301,台灣50元大11購09,0,0,0,0,0,0,0,0,0,11000,0,0,0,11000,0,11000,11000,2021-06-09
3493,035221,東鋼國泰11購01,0,0,0,0,0,0,0,0,0,11000,0,0,0,104000,93000,11000,11000,2021-06-09
3494,05163P,亞德客元富07售02,0,0,0,0,0,0,0,0,0,11000,0,0,0,11000,0,11000,11000,2021-06-09
3495,034024,大成鋼中信0B購01,0,0,0,0,0,0,0,0,0,11000,0,0,0,11000,0,11000,11000,2021-06-09
3496,080250,材料元大09購01,0,0,0,0,0,0,0,0,0,11000,0,0,0,39000,28000,11000,11000,2021-06-09
3497,078846,亞德客統一07購02,0,0,0,0,0,0,0,0,0,11000,0,0,0,11000,0,11000,11000,2021-06-09
3498,078391,華邦電富邦07購01,0,0,0,0,0,0,0,0,0,11000,0,0,0,11000,0,11000,11000,2021-06-09
3499,078545,精成科富邦08購01,0,0,0,0,0,0,0,0,0,11000,0,0,0,180000,169000,11000,11000,2021-06-09
3500,075267,台郡國泰07購01,0,5000,-5000,0,0,0,0,0,0,16000,0,0,0,16000,0,16000,11000,2021-06-09
3501,06995P,宏達電凱基0B售01,0,0,0,0,0,0,0,0,0,11000,0,0,0,18000,7000,11000,11000,2021-06-09
3502,8940,新天地,11000,0,11000,0,0,0,0,0,0,0,0,0,0,0,0,0,11000,2021-06-09
3503,1560,中砂,21000,9000,12000,0,0,0,0,0,0,-1000,0,0,0,0,1000,-1000,11000,2021-06-09
3504,08929P,可成元富07售04,0,0,0,0,0,0,0,0,0,11000,0,0,0,11000,0,11000,11000,2021-06-09
3505,089632,華邦電凱基13購01,0,0,0,0,0,0,0,0,0,11000,0,0,0,20000,9000,11000,11000,2021-06-09
3506,086264,英業達永豐09購01,0,0,0,0,0,0,0,0,0,10000,0,0,0,20000,10000,10000,10000,2021-06-09
3507,086308,華邦電凱基12購01,0,0,0,0,0,0,0,0,0,10000,0,0,0,10000,0,10000,10000,2021-06-09
3508,086395,廣宇統一0B購02,0,0,0,0,0,0,0,0,0,10000,0,0,0,10000,0,10000,10000,2021-06-09
3509,086022,光罩永豐08購03,0,0,0,0,0,0,0,0,0,10000,0,0,0,10000,0,10000,10000,2021-06-09
3510,085960,華邦電凱基08購08,0,0,0,0,0,0,0,0,0,10000,0,0,0,10000,0,10000,10000,2021-06-09
3511,085951,志超群益09購01,0,0,0,0,0,0,0,0,0,10000,0,0,0,310000,300000,10000,10000,2021-06-09
3512,085411,聯詠元大08購03,0,0,0,0,0,0,0,0,0,10000,0,0,0,10000,0,10000,10000,2021-06-09
3513,085456,聯發科元富0A購07,0,0,0,0,0,0,0,0,0,10000,0,0,0,10000,0,10000,10000,2021-06-09
3514,085717,元石油中信0A購01,0,0,0,0,0,0,0,0,0,10000,0,0,0,10000,0,10000,10000,2021-06-09
3515,085128,宏碁統一09購02,0,0,0,0,0,0,0,0,0,10000,0,0,0,10000,0,10000,10000,2021-06-09
3516,085163,信邦凱基08購01,0,0,0,0,0,0,0,0,0,10000,0,0,0,10000,0,10000,10000,2021-06-09
3517,085165,欣興凱基0B購01,0,0,0,0,0,0,0,0,0,10000,0,0,0,10000,0,10000,10000,2021-06-09
3518,085268,宏碁統一0A購06,0,0,0,0,0,0,0,0,0,10000,0,0,0,39000,29000,10000,10000,2021-06-09
3519,085356,晶技永豐08購01,0,0,0,0,0,0,0,0,0,10000,0,0,0,10000,0,10000,10000,2021-06-09
3520,083444,日月光凱基09購01,0,0,0,0,0,0,0,0,0,10000,0,0,0,10000,0,10000,10000,2021-06-09
3521,083590,精英國票08購01,0,0,0,0,0,0,0,0,0,10000,0,0,0,10000,0,10000,10000,2021-06-09
3522,084128,全新兆豐07購01,0,0,0,0,0,0,0,0,0,10000,0,0,0,10000,0,10000,10000,2021-06-09
3523,084185,元石油元大0A購01,0,0,0,0,0,0,0,0,0,10000,0,0,0,10000,0,10000,10000,2021-06-09
3524,083877,南電國票08購03,0,0,0,0,0,0,0,0,0,10000,0,0,0,10000,0,10000,10000,2021-06-09
3525,083834,矽格凱基0A購01,0,0,0,0,0,0,0,0,0,10000,0,0,0,10000,0,10000,10000,2021-06-09
3526,083826,台積電凱基0C購06,0,0,0,0,0,0,0,0,0,10000,0,0,0,10000,0,10000,10000,2021-06-09
3527,084023,帆宣統一09購01,0,0,0,0,0,0,0,0,0,10000,0,0,0,10000,0,10000,10000,2021-06-09
3528,083919,同欣電元大07購08,0,0,0,0,0,0,0,0,0,10000,0,0,0,10000,0,10000,10000,2021-06-09
3529,083925,聯發科兆豐07購08,0,0,0,0,0,0,0,0,0,10000,0,0,0,100000,90000,10000,10000,2021-06-09
3530,083964,智原凱基07購01,0,0,0,0,0,0,0,0,0,10000,0,0,0,10000,0,10000,10000,2021-06-09
3531,084575,和碩國票08購03,0,0,0,0,0,0,0,0,0,10000,0,0,0,10000,0,10000,10000,2021-06-09
3532,084253,南電統一09購08,0,0,0,0,0,0,0,0,0,10000,0,0,0,10000,0,10000,10000,2021-06-09
3533,084366,矽格元大07購05,0,0,0,0,0,0,0,0,0,10000,0,0,0,10000,0,10000,10000,2021-06-09
3534,084353,可成元大07購06,0,0,0,0,0,0,0,0,0,10000,0,0,0,10000,0,10000,10000,2021-06-09
3535,084419,力山兆豐08購01,0,0,0,0,0,0,0,0,0,10000,0,0,0,10000,0,10000,10000,2021-06-09
3536,084681,安集國泰0A購02,0,0,0,0,0,0,0,0,0,10000,0,0,0,10000,0,10000,10000,2021-06-09
3537,084723,為升元大08購01,0,0,0,0,0,0,0,0,0,10000,0,0,0,10000,0,10000,10000,2021-06-09
3538,084883,台灣50群益09購03,0,0,0,0,0,0,0,0,0,10000,0,0,0,10000,0,10000,10000,2021-06-09
3539,087176,上銀元富09購02,0,0,0,0,0,0,0,0,0,10000,0,0,0,11000,1000,10000,10000,2021-06-09
3540,087269,T50反1元大0C購02,0,0,0,0,0,0,0,0,0,10000,0,0,0,10000,0,10000,10000,2021-06-09
3541,087255,億光國票0A購01,0,0,0,0,0,0,0,0,0,10000,0,0,0,10000,0,10000,10000,2021-06-09
3542,087233,中石化兆豐0B購01,0,0,0,0,0,0,0,0,0,10000,0,0,0,10000,0,10000,10000,2021-06-09
3543,087306,S&P500中信0A購01,0,0,0,0,0,0,0,0,0,10000,0,0,0,10000,0,10000,10000,2021-06-09
3544,087403,景碩元大09購02,0,0,0,0,0,0,0,0,0,10000,0,0,0,10000,0,10000,10000,2021-06-09
3545,087518,旺宏凱基0B購01,0,0,0,0,0,0,0,0,0,10000,0,0,0,10000,0,10000,10000,2021-06-09
3546,087527,晶相光凱基09購01,0,0,0,0,0,0,0,0,0,10000,0,0,0,10000,0,10000,10000,2021-06-09
3547,086641,玉晶光凱基0B購01,0,0,0,0,0,0,0,0,0,10000,0,0,0,20000,10000,10000,10000,2021-06-09
3548,086502,佳世達麥證0A購01,0,0,0,45000,10000,35000,0,0,0,10000,0,0,0,45000,35000,10000,10000,2021-06-09
3549,086470,欣興兆豐0A購02,0,0,0,0,0,0,0,0,0,10000,0,0,0,10000,0,10000,10000,2021-06-09
3550,086484,聯詠統一0B購01,0,0,0,0,0,0,0,0,0,10000,0,0,0,10000,0,10000,10000,2021-06-09
3551,086432,華邦電第一13購01,0,0,0,0,0,0,0,0,0,10000,0,0,0,10000,0,10000,10000,2021-06-09
3552,086946,欣興元大09購05,0,0,0,0,0,0,0,0,0,10000,0,0,0,10000,0,10000,10000,2021-06-09
3553,086953,超眾元大0A購01,0,0,0,0,0,0,0,0,0,10000,0,0,0,10000,0,10000,10000,2021-06-09
3554,086802,群創統一0B購03,0,0,0,0,0,0,0,0,0,10000,0,0,0,10000,0,10000,10000,2021-06-09
3555,086805,日月光統一0B購02,0,0,0,0,0,0,0,0,0,10000,0,0,0,25000,15000,10000,10000,2021-06-09
3556,086826,佳世達元大09購02,0,0,0,0,0,0,0,0,0,10000,0,0,0,10000,0,10000,10000,2021-06-09
3557,086835,長榮航元大09購03,0,0,0,0,0,0,0,0,0,10000,0,0,0,10000,0,10000,10000,2021-06-09
3558,086896,泰金寶群益09購01,0,0,0,0,0,0,0,0,0,10000,0,0,0,10000,0,10000,10000,2021-06-09
3559,086890,泰山群益09購01,0,0,0,0,0,0,0,0,0,10000,0,0,0,10000,0,10000,10000,2021-06-09
3560,088899,矽創凱基09購04,0,0,0,0,0,0,0,0,0,10000,0,0,0,10000,0,10000,10000,2021-06-09
3561,088816,全漢元大09購01,0,0,0,0,0,0,0,0,0,10000,0,0,0,10000,0,10000,10000,2021-06-09
3562,088779,道瓊反國票09購01,0,0,0,0,0,0,0,0,0,10000,0,0,0,20000,10000,10000,10000,2021-06-09
3563,088773,瑞儀兆豐0A購01,0,0,0,0,0,0,0,0,0,10000,0,0,0,10000,0,10000,10000,2021-06-09
3564,088453,瑞軒統一0A購01,0,0,0,0,0,0,0,0,0,10000,0,0,0,10000,0,10000,10000,2021-06-09
3565,088405,廣宇永豐09購02,0,0,0,0,0,0,0,0,0,10000,0,0,0,10000,0,10000,10000,2021-06-09
3566,088358,新日興統一0B購01,0,0,0,0,0,0,0,0,0,10000,0,0,0,10000,0,10000,10000,2021-06-09
3567,088346,乙盛元大0B購01,0,0,0,0,0,0,0,0,0,10000,0,0,0,10000,0,10000,10000,2021-06-09
3568,088664,華碩元大09購03,0,0,0,0,0,0,0,0,0,10000,0,0,0,145000,135000,10000,10000,2021-06-09
3569,088665,華碩元大11購01,0,0,0,0,0,0,0,0,0,10000,0,0,0,33000,23000,10000,10000,2021-06-09
3570,088579,南帝兆豐0A購01,0,0,0,0,0,0,0,0,0,10000,0,0,0,10000,0,10000,10000,2021-06-09
3571,087676,榮成元大0A購01,0,0,0,0,0,0,0,0,0,10000,0,0,0,10000,0,10000,10000,2021-06-09
3572,087762,GIS富邦09購01,0,0,0,0,0,0,0,0,0,10000,0,0,0,10000,0,10000,10000,2021-06-09
3573,087825,台達電凱基09購03,0,0,0,0,0,0,0,0,0,10000,0,0,0,10000,0,10000,10000,2021-06-09
3574,087893,欣興元大11購02,0,0,0,0,0,0,0,0,0,10000,0,0,0,20000,10000,10000,10000,2021-06-09
3575,088077,華新科統一0C購01,0,0,0,0,0,0,0,0,0,10000,0,0,0,10000,0,10000,10000,2021-06-09
3576,088184,道瓊反群益0C購01,0,0,0,0,0,0,0,0,0,10000,0,0,0,10000,0,10000,10000,2021-06-09
3577,088168,富邦金元大09購05,0,0,0,0,0,0,0,0,0,10000,0,0,0,10000,0,10000,10000,2021-06-09
3578,088216,惠特統一0B購01,0,0,0,0,0,0,0,0,0,10000,0,0,0,10000,0,10000,10000,2021-06-09
3579,089020,智易元大0C購01,0,0,0,0,0,0,0,0,0,10000,0,0,0,78000,68000,10000,10000,2021-06-09
3580,030250,慧洋永豐0A購01,0,0,0,0,0,0,0,0,0,10000,0,0,0,10000,0,10000,10000,2021-06-09
3581,030418,潤泰全元大0B購01,0,0,0,0,0,0,0,0,0,10000,0,0,0,20000,10000,10000,10000,2021-06-09
3582,030290,大立光元富0A購05,0,0,0,0,0,0,0,0,0,10000,0,0,0,10000,0,10000,10000,2021-06-09
3583,030291,威強電元富0A購01,0,0,0,0,0,0,0,0,0,10000,0,0,0,10000,0,10000,10000,2021-06-09
3584,030296,威鋒電元富0A購01,0,0,0,0,0,0,0,0,0,10000,0,0,0,10000,0,10000,10000,2021-06-09
3585,030030,立積統一13購01,0,0,0,0,0,0,0,0,0,10000,0,0,0,10000,0,10000,10000,2021-06-09
3586,030105,奇鋐永豐0A購01,0,0,0,0,0,0,0,0,0,10000,0,0,0,10000,0,10000,10000,2021-06-09
3587,030216,益登凱基0A購01,0,0,0,0,0,0,0,0,0,10000,0,0,0,10000,0,10000,10000,2021-06-09
3588,030193,宏泰凱基0C購01,0,0,0,0,0,0,0,0,0,10000,0,0,0,10000,0,10000,10000,2021-06-09
3589,030162,國光生中信0A購01,0,0,0,0,0,0,0,0,0,10000,0,0,0,10000,0,10000,10000,2021-06-09
3590,03050X,元展47,0,0,0,0,0,0,0,0,0,10000,0,0,0,10000,0,10000,10000,2021-06-09
3591,031341,群創元大0A購10,0,0,0,0,0,0,0,0,0,10000,0,0,0,20000,10000,10000,10000,2021-06-09
3592,031520,矽創元大12購01,0,0,0,0,0,0,0,0,0,10000,0,0,0,11000,1000,10000,10000,2021-06-09
3593,032736,榮成凱基13購01,0,0,0,0,0,0,0,0,0,10000,0,0,0,10000,0,10000,10000,2021-06-09
3594,032752,鴻海日盛13購01,0,0,0,0,0,0,0,0,0,10000,0,0,0,10000,0,10000,10000,2021-06-09
3595,032753,台積電日盛13購02,0,0,0,0,0,0,0,0,0,10000,0,0,0,10000,0,10000,10000,2021-06-09
3596,032712,東鋼群益0C購02,0,0,0,0,0,0,0,0,0,10000,0,0,0,31000,21000,10000,10000,2021-06-09
3597,033160,欣興國泰11購01,0,0,0,0,0,0,0,0,0,10000,0,0,0,15000,5000,10000,10000,2021-06-09
3598,033218,萬海元富0B購02,0,0,0,0,0,0,0,0,0,10000,0,0,0,10000,0,10000,10000,2021-06-09
3599,033222,群創元富11購01,0,0,0,0,0,0,0,0,0,10000,0,0,0,10000,0,10000,10000,2021-06-09
3600,031054,瑞昱元大0A購03,0,0,0,0,0,0,0,0,0,10000,0,0,0,18000,8000,10000,10000,2021-06-09
3601,030742,強茂元大11購01,0,0,0,0,0,0,0,0,0,10000,0,0,0,10000,0,10000,10000,2021-06-09
3602,030624,玉晶光元大11購01,0,0,0,0,0,0,0,0,0,10000,0,0,0,10000,0,10000,10000,2021-06-09
3603,031000,大成鋼麥證0B購02,0,0,0,10000,0,10000,0,0,0,10000,0,0,0,10000,0,10000,10000,2021-06-09
3604,030833,長榮航中信0B購02,0,0,0,0,0,0,0,0,0,10000,0,0,0,20000,10000,10000,10000,2021-06-09
3605,031308,漢唐富邦0C購01,0,0,0,0,0,0,0,0,0,10000,0,0,0,10000,0,10000,10000,2021-06-09
3606,030549,申豐凱基0A購02,0,0,0,0,0,0,0,0,0,10000,0,0,0,10000,0,10000,10000,2021-06-09
3607,032614,彩晶元大0A購11,0,0,0,0,0,0,0,0,0,10000,0,0,0,10000,0,10000,10000,2021-06-09
3608,032626,大亞統一0C購04,0,0,0,0,0,0,0,0,0,10000,0,0,0,10000,0,10000,10000,2021-06-09
3609,031767,華邦電麥證0C購02,0,0,0,10000,0,10000,0,0,0,10000,0,0,0,10000,0,10000,10000,2021-06-09
3610,031694,華夏永豐0A購01,0,0,0,0,0,0,0,0,0,10000,0,0,0,10000,0,10000,10000,2021-06-09
3611,031685,玉晶光國泰0C購01,0,0,0,0,0,0,0,0,0,10000,0,0,0,10000,0,10000,10000,2021-06-09
3612,031811,中橡元大0B購01,0,0,0,0,0,0,0,0,0,10000,0,0,0,10000,0,10000,10000,2021-06-09
3613,036310,台玻統一11購06,0,0,0,0,0,0,0,0,0,10000,0,0,0,10000,0,10000,10000,2021-06-09
3614,036296,裕民元大12購01,0,0,0,0,0,0,0,0,0,10000,0,0,0,10000,0,10000,10000,2021-06-09
3615,036281,威致元大13購01,0,0,0,0,0,0,0,0,0,10000,0,0,0,10000,0,10000,10000,2021-06-09
3616,032076,中石化兆豐0B購02,0,0,0,0,0,0,0,0,0,10000,0,0,0,10000,0,10000,10000,2021-06-09
3617,032016,大立光統一0C購02,0,0,0,0,0,0,0,0,0,10000,0,0,0,25000,15000,10000,10000,2021-06-09
3618,031929,聚陽元富11購01,0,0,0,0,0,0,0,0,0,10000,0,0,0,20000,10000,10000,10000,2021-06-09
3619,031916,裕民永豐0A購01,0,0,0,0,0,0,0,0,0,10000,0,0,0,10000,0,10000,10000,2021-06-09
3620,031997,瑞昱群益0C購01,0,0,0,0,0,0,0,0,0,10000,0,0,0,33000,23000,10000,10000,2021-06-09
3621,032003,聯詠群益0C購01,0,0,0,0,0,0,0,0,0,10000,0,0,0,10000,0,10000,10000,2021-06-09
3622,031989,新光鋼群益0A購01,0,0,0,0,0,0,0,0,0,10000,0,0,0,10000,0,10000,10000,2021-06-09
3623,031969,智原元大0B購01,0,0,0,0,0,0,0,0,0,10000,0,0,0,10000,0,10000,10000,2021-06-09
3624,031939,台塑元大11購01,0,0,0,0,0,0,0,0,0,10000,0,0,0,10000,0,10000,10000,2021-06-09
3625,031945,南紡元大0A購03,0,0,0,0,0,0,0,0,0,10000,0,0,0,10000,0,10000,10000,2021-06-09
3626,032458,潤泰新元大0B購01,0,0,0,0,0,0,0,0,0,10000,0,0,0,10000,0,10000,10000,2021-06-09
3627,033307,南紡元富0B購01,0,0,0,0,0,0,0,0,0,10000,0,0,0,10000,0,10000,10000,2021-06-09
3628,032198,榮運群益0A購01,0,0,0,0,0,0,0,0,0,10000,0,0,0,10000,0,10000,10000,2021-06-09
3629,032216,中鋼統一0C購10,0,0,0,0,0,0,0,0,0,10000,0,0,0,10000,0,10000,10000,2021-06-09
3630,032954,允強元大0C購01,0,0,0,0,0,0,0,0,0,10000,0,0,0,10000,0,10000,10000,2021-06-09
3631,033014,漢唐麥證0A購01,0,0,0,20000,22000,-2000,0,0,0,10000,0,0,0,42000,32000,10000,10000,2021-06-09
3632,033034,大立光群益0B購02,0,0,0,0,0,0,0,0,0,10000,0,0,0,80000,70000,10000,10000,2021-06-09
3633,032884,台郡凱基0A購02,0,0,0,0,0,0,0,0,0,10000,0,0,0,20000,10000,10000,10000,2021-06-09
3634,033248,長榮元大0B購08,0,0,0,0,0,0,0,0,0,10000,0,0,0,10000,0,10000,10000,2021-06-09
3635,033120,中石化元大0A購08,0,0,0,0,0,0,0,0,0,10000,0,0,0,11000,1000,10000,10000,2021-06-09
3636,033112,友達富邦13購01,0,0,0,0,0,0,0,0,0,10000,0,0,0,10000,0,10000,10000,2021-06-09
3637,033295,長榮台新0B購02,0,0,0,0,0,0,0,0,0,10000,0,0,0,10000,0,10000,10000,2021-06-09
3638,033394,健策元大0B購02,0,0,0,0,0,0,0,0,0,10000,0,0,0,10000,0,10000,10000,2021-06-09
3639,033397,華新台新0B購01,0,0,0,0,0,0,0,0,0,10000,0,0,0,10000,0,10000,10000,2021-06-09
3640,033463,界霖群益0C購01,0,0,0,0,0,0,0,0,0,10000,0,0,0,10000,0,10000,10000,2021-06-09
3641,033450,上証2X群益0B購01,0,0,0,0,0,0,0,0,0,10000,0,0,0,10000,0,10000,10000,2021-06-09
3642,033430,新纖元大0B購01,0,0,0,0,0,0,0,0,0,10000,0,0,0,98000,88000,10000,10000,2021-06-09
3643,031860,台泥凱基11購01,0,0,0,0,0,0,0,0,0,10000,0,0,0,20000,10000,10000,10000,2021-06-09
3644,032417,台玻元大0C購01,0,0,0,0,0,0,0,0,0,10000,0,0,0,10000,0,10000,10000,2021-06-09
3645,033590,富邦金凱基15購01,0,0,0,0,0,0,0,0,0,10000,0,0,0,11000,1000,10000,10000,2021-06-09
3646,032365,元大金凱基0A購01,0,0,0,0,0,0,0,0,0,10000,0,0,0,10000,0,10000,10000,2021-06-09
3647,033985,台玻兆豐0C購01,0,0,0,0,0,0,0,0,0,10000,0,0,0,10000,0,10000,10000,2021-06-09
3648,033915,台塑元大0C購01,0,0,0,0,0,0,0,0,0,10000,0,0,0,25000,15000,10000,10000,2021-06-09
3649,035865,聯發科元富13購01,0,0,0,0,0,0,0,0,0,10000,0,0,0,10000,0,10000,10000,2021-06-09
3650,035755,裕民元富13購04,0,0,0,0,0,0,0,0,0,10000,0,0,0,10000,0,10000,10000,2021-06-09
3651,034848,宏泰元大0C購01,0,0,0,0,0,0,0,0,0,10000,0,0,0,10000,0,10000,10000,2021-06-09
3652,035413,華夏元大0B購03,0,0,0,0,0,0,0,0,0,10000,0,0,0,10000,0,10000,10000,2021-06-09
3653,036049,寶成元富0C購01,0,0,0,0,0,0,0,0,0,10000,0,0,0,10000,0,10000,10000,2021-06-09
3654,036042,華邦電元富13購01,0,0,0,0,0,0,0,0,0,10000,0,0,0,10000,0,10000,10000,2021-06-09
3655,04983P,T50正2國票08售04,0,0,0,0,0,0,0,0,0,10000,0,0,0,10000,0,10000,10000,2021-06-09
3656,035321,聯發科元大11購06,0,0,0,0,0,0,0,0,0,10000,0,0,0,10000,0,10000,10000,2021-06-09
3657,035318,京元電元大0B購04,0,0,0,0,0,0,0,0,0,10000,0,0,0,315000,305000,10000,10000,2021-06-09
3658,035044,萬海國票11購01,0,0,0,0,0,0,0,0,0,10000,0,0,0,10000,0,10000,10000,2021-06-09
3659,035073,長榮群益0B購13,0,0,0,0,0,0,0,0,0,10000,0,0,0,15000,5000,10000,10000,2021-06-09
3660,035080,萬海第一15購02,0,0,0,0,0,0,0,0,0,10000,0,0,0,10000,0,10000,10000,2021-06-09
3661,035088,大成鋼凱基11購02,0,0,0,0,0,0,0,0,0,10000,0,0,0,10000,0,10000,10000,2021-06-09
3662,035094,裕民凱基11購01,0,0,0,0,0,0,0,0,0,10000,0,0,0,10000,0,10000,10000,2021-06-09
3663,035118,亞聚永豐0B購02,0,0,0,0,0,0,0,0,0,10000,0,0,0,10000,0,10000,10000,2021-06-09
3664,035196,聯發科元富0C購07,0,0,0,0,0,0,0,0,0,10000,0,0,0,10000,0,10000,10000,2021-06-09
3665,034720,南亞麥證0B購01,0,0,0,10000,0,10000,0,0,0,10000,0,0,0,10000,0,10000,10000,2021-06-09
3666,034069,萬海富邦11購01,0,0,0,0,0,0,0,0,0,10000,0,0,0,10000,0,10000,10000,2021-06-09
3667,034015,中鋼統一15購03,0,0,0,0,0,0,0,0,0,10000,0,0,0,10000,0,10000,10000,2021-06-09
3668,034200,牧德元大0B購01,0,0,0,0,0,0,0,0,0,10000,0,0,0,10000,0,10000,10000,2021-06-09
3669,034246,新光鋼統一12購01,0,0,0,0,0,0,0,0,0,10000,0,0,0,24000,14000,10000,10000,2021-06-09
3670,05858P,聯發科統一07售06,0,0,0,0,0,0,0,0,0,10000,0,0,0,10000,0,10000,10000,2021-06-09
3671,034342,T50反1元富12購07,0,0,0,0,0,0,0,0,0,10000,0,0,0,10000,0,10000,10000,2021-06-09
3672,05899P,臺股指國票0B售07,0,0,0,0,0,0,0,0,0,10000,0,0,0,10000,0,10000,10000,2021-06-09
3673,034926,群創富邦11購02,0,0,0,0,0,0,0,0,0,10000,0,0,0,10000,0,10000,10000,2021-06-09
3674,034929,華新科國泰11購02,0,0,0,0,0,0,0,0,0,10000,0,0,0,22000,12000,10000,10000,2021-06-09
3675,033637,華新麥證0B購02,0,0,0,33000,0,33000,0,0,0,10000,0,0,0,33000,23000,10000,10000,2021-06-09
3676,035574,聯詠元富12購01,0,0,0,0,0,0,0,0,0,10000,0,0,0,68000,58000,10000,10000,2021-06-09
3677,036133,健和興凱基11購01,0,0,0,0,0,0,0,0,0,10000,0,0,0,14000,4000,10000,10000,2021-06-09
3678,033756,旺宏凱基0C購01,0,0,0,0,0,0,0,0,0,10000,0,0,0,10000,0,10000,10000,2021-06-09
3679,06043P,精英元大07售05,0,0,0,0,0,0,0,0,0,10000,0,0,0,10000,0,10000,10000,2021-06-09
3680,06045P,晶技元大07售05,0,0,0,0,0,0,0,0,0,10000,0,0,0,10000,0,10000,10000,2021-06-09
3681,06046P,玉晶光元大07售11,0,0,0,0,0,0,0,0,0,10000,0,0,0,10000,0,10000,10000,2021-06-09
3682,06079P,聯電國票08售05,0,0,0,0,0,0,0,0,0,10000,0,0,0,10000,0,10000,10000,2021-06-09
3683,06288P,玉晶光康和08售02,0,0,0,0,0,0,0,0,0,10000,0,0,0,10000,0,10000,10000,2021-06-09
3684,06225P,強茂元大08售02,0,0,0,0,0,0,0,0,0,10000,0,0,0,10000,0,10000,10000,2021-06-09
3685,06237P,台積電群益08售21,0,0,0,0,0,0,0,0,0,10000,0,0,0,10000,0,10000,10000,2021-06-09
3686,06238P,大毅群益08售04,0,0,0,0,0,0,0,0,0,10000,0,0,0,10000,0,10000,10000,2021-06-09
3687,06244P,可成元大08售03,0,0,0,0,0,0,0,0,0,10000,0,0,0,10000,0,10000,10000,2021-06-09
3688,05930P,台灣50元大07售24,0,0,0,0,0,0,0,0,0,10000,0,0,0,10000,0,10000,10000,2021-06-09
3689,06192P,祥碩凱基08售04,0,0,0,0,0,0,0,0,0,10000,0,0,0,10000,0,10000,10000,2021-06-09
3690,06202P,臺股指群益08售02,0,0,0,0,0,0,0,0,0,10000,0,0,0,10000,0,10000,10000,2021-06-09
3691,06325P,緯穎元大08售05,0,0,0,0,0,0,0,0,0,10000,0,0,0,10000,0,10000,10000,2021-06-09
3692,06944P,群創國票0A售06,0,0,0,0,0,0,0,0,0,10000,0,0,0,20000,10000,10000,10000,2021-06-09
3693,06871P,臺股指凱基0A售14,0,0,0,0,0,0,0,0,0,10000,0,0,0,10000,0,10000,10000,2021-06-09
3694,071143,達方元富09購01,0,0,0,0,0,0,0,0,0,10000,0,0,0,10000,0,10000,10000,2021-06-09
3695,071713,為升元富09購02,0,0,0,0,0,0,0,0,0,10000,0,0,0,10000,0,10000,10000,2021-06-09
3696,07038P,台積電群益0B售07,0,0,0,0,0,0,0,0,0,10000,0,0,0,10000,0,10000,10000,2021-06-09
3697,06474P,大立光國票0A售02,0,0,0,0,0,0,0,0,0,10000,0,0,0,10000,0,10000,10000,2021-06-09
3698,06517P,台積電凱基12售02,0,0,0,0,0,0,0,0,0,10000,0,0,0,10000,0,10000,10000,2021-06-09
3699,066868,聯發科元富07購01,0,0,0,0,0,0,0,0,0,10000,0,0,0,10000,0,10000,10000,2021-06-09
3700,074977,TPK富邦06購01,0,0,0,0,0,0,0,0,0,10000,0,0,0,10000,0,10000,10000,2021-06-09
3701,074787,旺宏統一06購01,0,0,0,0,0,0,0,0,0,10000,0,0,0,10000,0,10000,10000,2021-06-09
3702,074914,矽格元富0A購01,0,0,0,0,0,0,0,0,0,10000,0,0,0,10000,0,10000,10000,2021-06-09
3703,074394,玉晶光國票07購05,0,0,0,0,0,0,0,0,0,10000,0,0,0,10000,0,10000,10000,2021-06-09
3704,075937,創意國票07購02,0,0,0,0,0,0,0,0,0,10000,0,0,0,10000,0,10000,10000,2021-06-09
3705,076014,中纖元大06購01,0,0,0,0,0,0,0,0,0,10000,0,0,0,10000,0,10000,10000,2021-06-09
3706,076315,南帝元大07購01,0,0,0,0,0,0,0,0,0,10000,0,0,0,10000,0,10000,10000,2021-06-09
3707,072575,上銀元富09購01,0,0,0,0,0,0,0,0,0,10000,0,0,0,10000,0,10000,10000,2021-06-09
3708,073090,亞光中信08購01,0,0,0,0,0,0,0,0,0,10000,0,0,0,10000,0,10000,10000,2021-06-09
3709,078517,和大凱基08購01,0,0,0,0,0,0,0,0,0,10000,0,0,0,10000,0,10000,10000,2021-06-09
3710,078208,長華元大07購01,0,0,0,0,0,0,0,0,0,10000,0,0,0,10000,0,10000,10000,2021-06-09
3711,078806,長榮凱基06購05,0,0,0,0,0,0,0,0,0,10000,0,0,0,10000,0,10000,10000,2021-06-09
3712,078766,全新中信08購01,0,0,0,0,0,0,0,0,0,10000,0,0,0,10000,0,10000,10000,2021-06-09
3713,078997,旺宏凱基07購02,0,0,0,0,0,0,0,0,0,10000,0,0,0,10000,0,10000,10000,2021-06-09
3714,078986,台光電麥證06購01,0,0,0,10000,0,10000,0,0,0,10000,0,0,0,10000,0,10000,10000,2021-06-09
3715,078964,大成鋼兆豐06購02,0,0,0,0,0,0,0,0,0,10000,0,0,0,140000,130000,10000,10000,2021-06-09
3716,077447,SGBR2X國票06購02,0,0,0,0,0,0,0,0,0,10000,0,0,0,10000,0,10000,10000,2021-06-09
3717,076806,景碩國票06購04,0,0,0,0,0,0,0,0,0,10000,0,0,0,10000,0,10000,10000,2021-06-09
3718,076999,世芯國票06購01,0,0,0,0,0,0,0,0,0,10000,0,0,0,10000,0,10000,10000,2021-06-09
3719,077640,亞光國票07購01,0,0,0,0,0,0,0,0,0,10000,0,0,0,10000,0,10000,10000,2021-06-09
3720,077474,萬海國票07購02,0,0,0,0,0,0,0,0,0,10000,0,0,0,10000,0,10000,10000,2021-06-09
3721,077310,金像電富邦07購01,0,0,0,0,0,0,0,0,0,10000,0,0,0,11000,1000,10000,10000,2021-06-09
3722,077762,道瓊反群益09購01,0,0,0,0,0,0,0,0,0,10000,0,0,0,10000,0,10000,10000,2021-06-09
3723,077666,上証2X凱基07購01,0,0,0,0,0,0,0,0,0,10000,0,0,0,60000,50000,10000,10000,2021-06-09
3724,077733,台化富邦08購01,0,0,0,0,0,0,0,0,0,10000,0,0,0,10000,0,10000,10000,2021-06-09
3725,078189,華邦電元大08購01,0,0,0,0,0,0,0,0,0,10000,0,0,0,10000,0,10000,10000,2021-06-09
3726,079951,台積電凱基07購10,0,0,0,0,0,0,0,0,0,10000,0,0,0,11000,1000,10000,10000,2021-06-09
3727,079929,微星富邦07購02,0,0,0,0,0,0,0,0,0,10000,0,0,0,20000,10000,10000,10000,2021-06-09
3728,080162,國喬統一08購01,0,0,0,0,0,0,0,0,0,10000,0,0,0,10000,0,10000,10000,2021-06-09
3729,080166,台玻統一07購01,0,0,0,0,0,0,0,0,0,10000,0,0,0,10000,0,10000,10000,2021-06-09
3730,080054,滬深2X元大08購02,0,0,0,0,0,0,0,0,0,10000,0,0,0,10000,0,10000,10000,2021-06-09
3731,080067,上銀元大08購02,0,0,0,0,0,0,0,0,0,10000,0,0,0,10000,0,10000,10000,2021-06-09
3732,080174,上銀統一08購05,0,0,0,0,0,0,0,0,0,10000,0,0,0,10000,0,10000,10000,2021-06-09
3733,079432,長榮航統一08購01,0,0,0,0,0,0,0,0,0,10000,0,0,0,10000,0,10000,10000,2021-06-09
3734,079843,欣興元大06購04,0,0,0,0,0,0,0,0,0,10000,0,0,0,60000,50000,10000,10000,2021-06-09
3735,079882,國巨元富08購15,0,0,0,0,0,0,0,0,0,10000,0,0,0,10000,0,10000,10000,2021-06-09
3736,079718,創意群益07購01,0,0,0,0,0,0,0,0,0,10000,0,0,0,10000,0,10000,10000,2021-06-09
3737,079131,和碩國票07購01,0,0,0,0,0,0,0,0,0,10000,0,0,0,10000,0,10000,10000,2021-06-09
3738,079380,宏碁元大06購02,0,0,0,0,0,0,0,0,0,10000,0,0,0,10000,0,10000,10000,2021-06-09
3739,079382,京元電元大07購01,0,0,0,0,0,0,0,0,0,10000,0,0,0,10000,0,10000,10000,2021-06-09
3740,079394,寶成元大06購03,0,0,0,0,0,0,0,0,0,10000,0,0,0,10000,0,10000,10000,2021-06-09
3741,081438,國巨統一09購03,0,0,0,0,0,0,0,0,0,10000,0,0,0,10000,0,10000,10000,2021-06-09
3742,081278,上銀統一09購01,0,0,0,0,0,0,0,0,0,10000,0,0,0,10000,0,10000,10000,2021-06-09
3743,081249,達新國票08購01,0,0,0,0,0,0,0,0,0,10000,0,0,0,10000,0,10000,10000,2021-06-09
3744,081172,長榮永豐07購03,0,0,0,0,0,0,0,0,0,10000,0,0,0,10000,0,10000,10000,2021-06-09
3745,081056,玉晶光國票0B購01,0,0,0,0,0,0,0,0,0,10000,0,0,0,10000,0,10000,10000,2021-06-09
3746,080571,長榮永豐06購10,0,0,0,0,0,0,0,0,0,10000,0,0,0,10000,0,10000,10000,2021-06-09
3747,080953,健策群益08購01,0,0,0,0,0,0,0,0,0,10000,0,0,0,10000,0,10000,10000,2021-06-09
3748,080978,國產元大07購01,0,0,0,0,0,0,0,0,0,10000,0,0,0,10000,0,10000,10000,2021-06-09
3749,080991,榮成永豐07購01,0,0,0,0,0,0,0,0,0,10000,0,0,0,10000,0,10000,10000,2021-06-09
3750,081012,億豐永豐07購01,0,0,0,0,0,0,0,0,0,10000,0,0,0,10000,0,10000,10000,2021-06-09
3751,080854,和碩元富07購01,0,0,0,0,0,0,0,0,0,10000,0,0,0,10000,0,10000,10000,2021-06-09
3752,080870,GIS統一08購01,0,0,0,0,0,0,0,0,0,10000,0,0,0,10000,0,10000,10000,2021-06-09
3753,080893,南電中信0A購01,0,0,0,0,0,0,0,0,0,10000,0,0,0,10000,0,10000,10000,2021-06-09
3754,080813,精誠凱基09購01,0,0,0,0,0,0,0,0,0,10000,0,0,0,10000,0,10000,10000,2021-06-09
3755,082494,京元電統一09購01,0,0,0,0,0,0,0,0,0,10000,0,0,0,10000,0,10000,10000,2021-06-09
3756,082487,台積電統一09購03,0,0,0,0,0,0,0,0,0,10000,0,0,0,30000,20000,10000,10000,2021-06-09
3757,082616,聯電永豐08購01,0,0,0,0,0,0,0,0,0,10000,0,0,0,23000,13000,10000,10000,2021-06-09
3758,083315,帆宣元大07購02,0,0,0,0,0,0,0,0,0,10000,0,0,0,10000,0,10000,10000,2021-06-09
3759,083177,T50反1國票09購07,0,0,0,0,0,0,0,0,0,10000,0,0,0,10000,0,10000,10000,2021-06-09
3760,082924,道瓊銀統一09購01,0,0,0,0,0,0,0,0,0,10000,0,0,0,10000,0,10000,10000,2021-06-09
3761,082879,帆宣兆豐08購01,0,0,0,0,0,0,0,0,0,10000,0,0,0,10000,0,10000,10000,2021-06-09
3762,082881,南茂兆豐08購01,0,0,0,0,0,0,0,0,0,10000,0,0,0,10000,0,10000,10000,2021-06-09
3763,082087,樺漢元大07購01,0,0,0,0,0,0,0,0,0,10000,0,0,0,10000,0,10000,10000,2021-06-09
3764,082124,亞德客統一09購01,0,0,0,0,0,0,0,0,0,10000,0,0,0,10000,0,10000,10000,2021-06-09
3765,082143,訊芯統一09購01,0,0,0,0,0,0,0,0,0,10000,0,0,0,10000,0,10000,10000,2021-06-09
3766,082194,信邦永豐07購01,0,0,0,0,0,0,0,0,0,10000,0,0,0,20000,10000,10000,10000,2021-06-09
3767,082243,台新金凱基08購01,0,0,0,0,0,0,0,0,0,10000,0,0,0,10000,0,10000,10000,2021-06-09
3768,082244,信邦凱基07購01,0,0,0,0,0,0,0,0,0,10000,0,0,0,10000,0,10000,10000,2021-06-09
3769,082254,美利達凱基07購01,0,0,0,0,0,0,0,0,0,10000,0,0,0,10000,0,10000,10000,2021-06-09
3770,082255,信邦康和07購01,0,0,0,0,0,0,0,0,0,10000,0,0,0,10000,0,10000,10000,2021-06-09
3771,082323,技嘉統一09購01,0,0,0,0,0,0,0,0,0,10000,0,0,0,10000,0,10000,10000,2021-06-09
3772,082326,義隆統一09購02,0,0,0,0,0,0,0,0,0,10000,0,0,0,10000,0,10000,10000,2021-06-09
3773,082411,鴻海麥證07購05,0,0,0,10000,0,10000,0,0,0,10000,0,0,0,10000,0,10000,10000,2021-06-09
3774,081849,義隆永豐07購01,0,0,0,0,0,0,0,0,0,10000,0,0,0,10000,0,10000,10000,2021-06-09
3775,081822,華邦電凱基07購05,0,0,0,0,0,0,0,0,0,10000,0,0,0,10000,0,10000,10000,2021-06-09
3776,081926,祥碩凱基07購03,0,0,0,0,0,0,0,0,0,10000,0,0,0,10000,0,10000,10000,2021-06-09
3777,081969,國巨元大07購13,0,0,0,0,0,0,0,0,0,10000,0,0,0,10000,0,10000,10000,2021-06-09
3778,081938,台達電富邦09購01,0,0,0,0,0,0,0,0,0,10000,0,0,0,10000,0,10000,10000,2021-06-09
3779,081705,鴻海台新07購01,0,0,0,0,0,0,0,0,0,10000,0,0,0,10000,0,10000,10000,2021-06-09
3780,081421,台勝科群益08購02,0,0,0,0,0,0,0,0,0,10000,0,0,0,10000,0,10000,10000,2021-06-09
3781,081564,合勤控永豐07購01,0,0,0,0,0,0,0,0,0,10000,0,0,0,10000,0,10000,10000,2021-06-09
3782,081528,中化永豐07購01,0,0,0,0,0,0,0,0,0,10000,0,0,0,10000,0,10000,10000,2021-06-09
3783,089677,宏碁元大09購06,0,0,0,0,0,0,0,0,0,10000,0,0,0,113000,103000,10000,10000,2021-06-09
3784,089724,泰豐永豐09購01,0,0,0,0,0,0,0,0,0,10000,0,0,0,10000,0,10000,10000,2021-06-09
3785,089720,台聚永豐09購02,0,0,0,0,0,0,0,0,0,10000,0,0,0,10000,0,10000,10000,2021-06-09
3786,089467,義隆國票0B購01,0,0,0,0,0,0,0,0,0,10000,0,0,0,38000,28000,10000,10000,2021-06-09
3787,089489,裕隆元富0C購01,0,0,0,0,0,0,0,0,0,10000,0,0,0,10000,0,10000,10000,2021-06-09
3788,089574,力麗永豐09購01,0,0,0,0,0,0,0,0,0,10000,0,0,0,10000,0,10000,10000,2021-06-09
3789,089315,群創國票0A購03,0,0,0,0,0,0,0,0,0,10000,0,0,0,10000,0,10000,10000,2021-06-09
3790,089342,國巨元大09購05,0,0,0,0,0,0,0,0,0,10000,0,0,0,10000,0,10000,10000,2021-06-09
3791,089218,欣興群益0A購02,0,0,0,0,0,0,0,0,0,10000,0,0,0,10000,0,10000,10000,2021-06-09
3792,089949,彩晶富邦0B購01,0,0,0,0,0,0,0,0,0,10000,0,0,0,10000,0,10000,10000,2021-06-09
3793,089789,矽創凱基09購05,0,0,0,0,0,0,0,0,0,10000,0,0,0,10000,0,10000,10000,2021-06-09
3794,089795,巨大麥證09購01,0,0,0,10000,0,10000,0,0,0,10000,0,0,0,10000,0,10000,10000,2021-06-09
3795,089831,中鋼元大09購01,0,0,0,0,0,0,0,0,0,10000,0,0,0,10000,0,10000,10000,2021-06-09
3796,6698,旭暉應材,17000,7000,10000,0,0,0,0,0,0,0,0,0,0,0,0,0,10000,2021-06-09
3797,088067,晶碩元大09購04,0,0,0,0,0,0,0,0,0,9000,0,0,0,15000,6000,9000,9000,2021-06-09
3798,087802,榮成兆豐09購01,0,0,0,0,0,0,0,0,0,9000,0,0,0,9000,0,9000,9000,2021-06-09
3799,088844,華碩兆豐09購02,0,0,0,0,0,0,0,0,0,9000,0,0,0,9000,0,9000,9000,2021-06-09
3800,086876,元石油國泰0B購01,0,0,0,0,0,0,0,0,0,9000,0,0,0,10000,1000,9000,9000,2021-06-09
3801,086764,榮成凱基09購01,0,0,0,0,0,0,0,0,0,9000,0,0,0,10000,1000,9000,9000,2021-06-09
3802,087033,亞聚凱基09購01,0,0,0,0,0,0,0,0,0,9000,0,0,0,10000,1000,9000,9000,2021-06-09
3803,087330,玉晶光永豐09購01,0,0,0,0,0,0,0,0,0,9000,0,0,0,16000,7000,9000,9000,2021-06-09
3804,084949,華邦電凱基08購04,0,0,0,0,0,0,0,0,0,9000,0,0,0,14000,5000,9000,9000,2021-06-09
3805,084725,鴻海元大09購09,0,0,0,0,0,0,0,0,0,9000,0,0,0,9000,0,9000,9000,2021-06-09
3806,083936,台郡中信07購01,0,0,0,0,0,0,0,0,0,9000,0,0,0,10000,1000,9000,9000,2021-06-09
3807,084210,義隆元大07購09,0,0,0,0,0,0,0,0,0,9000,0,0,0,9000,0,9000,9000,2021-06-09
3808,085460,創意元富0B購01,0,0,0,0,0,0,0,0,0,9000,0,0,0,222000,213000,9000,9000,2021-06-09
3809,032389,長榮統一0C購09,0,0,0,0,0,0,0,0,0,9000,0,0,0,19000,10000,9000,9000,2021-06-09
3810,032266,慧洋元大0B購01,0,0,0,0,0,0,0,0,0,9000,0,0,0,9000,0,9000,9000,2021-06-09
3811,032478,台積電第一14購04,0,0,0,0,0,0,0,0,0,9000,0,0,0,10000,1000,9000,9000,2021-06-09
3812,032514,台航永豐0A購05,0,0,0,0,0,0,0,0,0,9000,0,0,0,9000,0,9000,9000,2021-06-09
3813,036214,大成鋼國泰12購02,0,0,0,0,0,0,0,0,0,9000,0,0,0,9000,0,9000,9000,2021-06-09
3814,031680,晶碩元大0C購01,0,0,0,0,0,0,0,0,0,9000,0,0,0,9000,0,9000,9000,2021-06-09
3815,031320,正隆元大0B購01,0,0,0,0,0,0,0,0,0,9000,0,0,0,196000,187000,9000,9000,2021-06-09
3816,031631,長榮航統一0C購02,0,0,0,0,0,0,0,0,0,9000,0,0,0,18000,9000,9000,9000,2021-06-09
3817,032686,大亞永豐0A購03,0,0,0,0,0,0,0,0,0,9000,0,0,0,10000,1000,9000,9000,2021-06-09
3818,031496,台揚元大0A購01,0,0,0,0,0,0,0,0,0,9000,0,0,0,9000,0,9000,9000,2021-06-09
3819,030458,祥碩富邦0A購01,0,0,0,0,0,0,0,0,0,9000,0,0,0,9000,0,9000,9000,2021-06-09
3820,030123,台揚凱基12購01,0,0,0,0,0,0,0,0,0,9000,0,0,0,9000,0,9000,9000,2021-06-09
3821,06362P,臺股指麥證08售03,0,0,0,20000,11000,9000,0,0,0,9000,0,0,0,20000,11000,9000,9000,2021-06-09
3822,06073P,上銀群益08售01,0,0,0,0,0,0,0,0,0,9000,0,0,0,9000,0,9000,9000,2021-06-09
3823,034413,大亞統一11購01,0,0,0,0,0,0,0,0,0,9000,0,0,0,29000,20000,9000,9000,2021-06-09
3824,034888,台表科群益0B購01,0,0,0,0,0,0,0,0,0,9000,0,0,0,92000,83000,9000,9000,2021-06-09
3825,034582,美律凱基0B購01,0,0,0,0,0,0,0,0,0,9000,0,0,0,9000,0,9000,9000,2021-06-09
3826,034368,南紡元大11購01,0,0,0,0,0,0,0,0,0,9000,0,0,0,160000,151000,9000,9000,2021-06-09
3827,035208,長榮麥證0B購04,0,0,0,825000,816000,9000,0,0,0,9000,0,0,0,825000,816000,9000,9000,2021-06-09
3828,035371,南亞凱基0B購02,0,0,0,0,0,0,0,0,0,9000,0,0,0,9000,0,9000,9000,2021-06-09
3829,034884,圓剛群益0B購01,0,0,0,0,0,0,0,0,0,9000,0,0,0,76000,67000,9000,9000,2021-06-09
3830,083040,強茂中信07購01,0,0,0,0,0,0,0,0,0,9000,0,0,0,9000,0,9000,9000,2021-06-09
3831,082560,台積電統一0B購01,0,0,0,0,0,0,0,0,0,9000,0,0,0,9000,0,9000,9000,2021-06-09
3832,081290,滬深2X元大0A購01,0,0,0,0,0,0,0,0,0,9000,0,0,0,10000,1000,9000,9000,2021-06-09
3833,081300,聯電元大07購05,0,0,0,0,0,0,0,0,0,9000,0,0,0,9000,0,9000,9000,2021-06-09
3834,081385,長榮麥證07購01,0,0,0,9000,0,9000,0,0,0,9000,0,0,0,9000,0,9000,9000,2021-06-09
3835,079402,世紀鋼國票08購03,0,0,0,0,0,0,0,0,0,9000,0,0,0,9000,0,9000,9000,2021-06-09
3836,080316,T50反1凱基0C購03,0,0,0,0,0,0,0,0,0,9000,0,0,0,20000,11000,9000,9000,2021-06-09
3837,080540,金像電統一08購01,0,0,0,0,0,0,0,0,0,9000,0,0,0,9000,0,9000,9000,2021-06-09
3838,078117,強茂元富09購01,0,0,0,0,0,0,0,0,0,9000,0,0,0,9000,0,9000,9000,2021-06-09
3839,077485,世紀鋼國票07購03,0,0,0,0,0,0,0,0,0,9000,0,0,0,9000,0,9000,9000,2021-06-09
3840,076653,致伸統一06購01,0,0,0,0,0,0,0,0,0,9000,0,0,0,123000,114000,9000,9000,2021-06-09
3841,078388,大成鋼富邦08購01,0,0,0,0,0,0,0,0,0,9000,0,0,0,9000,0,9000,9000,2021-06-09
3842,073564,台積電元大07購01,0,0,0,0,0,0,0,0,0,9000,0,0,0,9000,0,9000,9000,2021-06-09
3843,06738P,南亞科群益0A售01,0,0,0,0,0,0,0,0,0,9000,0,0,0,9000,0,9000,9000,2021-06-09
3844,06782P,友達台新0A售02,0,0,0,0,0,0,0,0,0,9000,0,0,0,9000,0,9000,9000,2021-06-09
3845,06505P,國巨元富0C售06,0,0,0,0,0,0,0,0,0,9000,0,0,0,9000,0,9000,9000,2021-06-09
3846,06435P,上証2X群益09售03,0,0,0,0,0,0,0,0,0,9000,0,0,0,13000,4000,9000,9000,2021-06-09
3847,07153P,長榮元大0B售14,0,0,0,0,0,0,0,0,0,9000,0,0,0,54000,45000,9000,9000,2021-06-09
3848,07131P,臺股指中信0B售13,0,0,0,0,0,0,0,0,0,9000,0,0,0,11000,2000,9000,9000,2021-06-09
3849,06854P,滬深2X元大12售01,0,0,0,0,0,0,0,0,0,9000,0,0,0,9000,0,9000,9000,2021-06-09
3850,069940,欣興元富08購05,0,0,0,0,0,0,0,0,0,9000,0,0,0,17000,8000,9000,9000,2021-06-09
3851,083362,玉晶光永豐07購02,0,0,0,0,0,0,0,0,0,9000,0,0,0,16000,7000,9000,9000,2021-06-09
3852,6552,易華電,14000,5000,9000,0,0,0,0,0,0,0,0,0,0,0,0,0,9000,2021-06-09
3853,6558,興能高,31000,22000,9000,0,0,0,0,0,0,0,0,0,0,0,0,0,9000,2021-06-09
3854,089835,台橡元大0B購01,0,0,0,0,0,0,0,0,0,9000,0,0,0,34000,25000,9000,9000,2021-06-09
3855,1589,永冠-KY,59000,54000,5000,0,0,0,0,0,0,4000,0,0,0,9000,5000,4000,9000,2021-06-09
3856,089139,宏達電元大09購01,0,0,0,0,0,0,0,0,0,9000,0,0,0,9000,0,9000,9000,2021-06-09
3857,089157,緯創元富09購01,0,0,0,0,0,0,0,0,0,9000,0,0,0,9000,0,9000,9000,2021-06-09
3858,089487,裕隆元富09購02,0,0,0,0,0,0,0,0,0,9000,0,0,0,9000,0,9000,9000,2021-06-09
3859,3518,柏騰,34000,25000,9000,0,0,0,0,0,0,0,0,0,0,0,0,0,9000,2021-06-09
3860,3416,融程電,14000,5000,9000,0,0,0,0,0,0,0,0,0,0,0,0,0,9000,2021-06-09
3861,00771,元大US高息特別股,52000,1000,51000,0,0,0,0,0,0,-42846,0,0,0,2154,45000,-42846,8154,2021-06-09
3862,085247,日月光中信08購02,0,0,0,0,0,0,0,0,0,8000,0,0,0,8000,0,8000,8000,2021-06-09
3863,084051,欣興國票08購02,0,0,0,0,0,0,0,0,0,8000,0,0,0,87000,79000,8000,8000,2021-06-09
3864,084468,台達電凱基08購03,0,0,0,0,0,0,0,0,0,8000,0,0,0,8000,0,8000,8000,2021-06-09
3865,086834,長榮航元大09購02,0,0,0,0,0,0,0,0,0,8000,0,0,0,8000,0,8000,8000,2021-06-09
3866,088775,瑞軒元富0C購01,0,0,0,0,0,0,0,0,0,8000,0,0,0,8000,0,8000,8000,2021-06-09
3867,087743,元石油國票0B購01,0,0,0,0,0,0,0,0,0,8000,0,0,0,28000,20000,8000,8000,2021-06-09
3868,00851,台新全球AI,0,0,0,0,0,0,0,0,0,8000,0,0,0,29000,21000,8000,8000,2021-06-09
3869,031442,佳世達麥證0C購01,0,0,0,20000,12000,8000,0,0,0,8000,0,0,0,20000,12000,8000,8000,2021-06-09
3870,032693,長榮永豐0A購12,0,0,0,0,0,0,0,0,0,8000,0,0,0,8000,0,8000,8000,2021-06-09
3871,031284,華邦電日盛0A購03,0,0,0,0,0,0,0,0,0,8000,0,0,0,10000,2000,8000,8000,2021-06-09
3872,030912,上緯控凱基0A購02,0,0,0,0,0,0,0,0,0,8000,0,0,0,8000,0,8000,8000,2021-06-09
3873,030859,金寶永豐0A購01,0,0,0,0,0,0,0,0,0,8000,0,0,0,8000,0,8000,8000,2021-06-09
3874,031808,中鋼元大0A購06,0,0,0,0,0,0,0,0,0,8000,0,0,0,8000,0,8000,8000,2021-06-09
3875,036239,亞聚凱基0C購01,0,0,0,0,0,0,0,0,0,8000,0,0,0,10000,2000,8000,8000,2021-06-09
3876,031948,和桐元大0B購01,0,0,0,0,0,0,0,0,0,8000,0,0,0,351000,343000,8000,8000,2021-06-09
3877,031949,永豐餘元大0B購01,0,0,0,0,0,0,0,0,0,8000,0,0,0,8000,0,8000,8000,2021-06-09
3878,031937,元石油元大14購01,0,0,0,0,0,0,0,0,0,8000,0,0,0,40000,32000,8000,8000,2021-06-09
3879,031918,台航永豐0A購02,0,0,0,0,0,0,0,0,0,8000,0,0,0,8000,0,8000,8000,2021-06-09
3880,033136,開發金元大0B購02,0,0,0,0,0,0,0,0,0,8000,0,0,0,344000,336000,8000,8000,2021-06-09
3881,032896,嘉晶統一0B購01,0,0,0,0,0,0,0,0,0,8000,0,0,0,25000,17000,8000,8000,2021-06-09
3882,032824,長榮康和0A購07,0,0,0,0,0,0,0,0,0,8000,0,0,0,8000,0,8000,8000,2021-06-09
3883,032832,聯發科富邦14購02,0,0,0,0,0,0,0,0,0,8000,0,0,0,8000,0,8000,8000,2021-06-09
3884,032974,明泰元大0A購01,0,0,0,0,0,0,0,0,0,8000,0,0,0,12000,4000,8000,8000,2021-06-09
3885,033470,偉詮電凱基0B購01,0,0,0,0,0,0,0,0,0,8000,0,0,0,230000,222000,8000,8000,2021-06-09
3886,033408,南亞科第一15購01,0,0,0,0,0,0,0,0,0,8000,0,0,0,10000,2000,8000,8000,2021-06-09
3887,033298,華新中信0B購02,0,0,0,0,0,0,0,0,0,8000,0,0,0,8000,0,8000,8000,2021-06-09
3888,035502,聯電凱基0B購05,0,0,0,0,0,0,0,0,0,8000,0,0,0,9000,1000,8000,8000,2021-06-09
3889,034141,聯電凱基0C購04,0,0,0,0,0,0,0,0,0,8000,0,0,0,9000,1000,8000,8000,2021-06-09
3890,034070,群創富邦11購01,0,0,0,0,0,0,0,0,0,8000,0,0,0,8000,0,8000,8000,2021-06-09
3891,034999,聯電元大0C購08,0,8000,-8000,0,0,0,0,0,0,16000,0,0,0,77000,61000,16000,8000,2021-06-09
3892,06018P,T50正2國票09售03,0,0,0,0,0,0,0,0,0,8000,0,0,0,13000,5000,8000,8000,2021-06-09
3893,06277P,台積電日盛08售03,0,0,0,0,0,0,0,0,0,8000,0,0,0,8000,0,8000,8000,2021-06-09
3894,06291P,可成元富08售06,0,0,0,0,0,0,0,0,0,8000,0,0,0,8000,0,8000,8000,2021-06-09
3895,033640,台聚統一13購01,0,0,0,0,0,0,0,0,0,8000,0,0,0,8000,0,8000,8000,2021-06-09
3896,06351P,聯詠凱基08售07,0,0,0,0,0,0,0,0,0,8000,0,0,0,10000,2000,8000,8000,2021-06-09
3897,07179P,臺股指中信13售02,0,0,0,0,0,0,0,0,0,8000,0,0,0,8000,0,8000,8000,2021-06-09
3898,06788P,聯詠凱基0A售04,0,0,0,0,0,0,0,0,0,8000,0,0,0,8000,0,8000,8000,2021-06-09
3899,073888,玉晶光中信06購01,0,0,0,0,0,0,0,0,0,8000,0,0,0,8000,0,8000,8000,2021-06-09
3900,076209,臺股指國票09購04,0,0,0,0,0,0,0,0,0,8000,0,0,0,9000,1000,8000,8000,2021-06-09
3901,074174,為升元富0A購01,0,0,0,0,0,0,0,0,0,8000,0,0,0,18000,10000,8000,8000,2021-06-09
3902,075532,台積電國票09購02,0,0,0,0,0,0,0,0,0,8000,0,0,0,10000,2000,8000,8000,2021-06-09
3903,078832,立積國票07購01,0,0,0,0,0,0,0,0,0,8000,0,0,0,8000,0,8000,8000,2021-06-09
3904,079660,上銀元大08購01,0,0,0,0,0,0,0,0,0,8000,0,0,0,18000,10000,8000,8000,2021-06-09
3905,081173,東森永豐07購01,0,0,0,0,0,0,0,0,0,8000,0,0,0,11000,3000,8000,8000,2021-06-09
3906,080655,潤泰全元大09購02,0,0,0,0,0,0,0,0,0,8000,0,0,0,8000,0,8000,8000,2021-06-09
3907,081710,鴻海統一09購01,0,0,0,0,0,0,0,0,0,8000,0,0,0,18000,10000,8000,8000,2021-06-09
3908,081657,廣宇永豐07購01,0,0,0,0,0,0,0,0,0,8000,0,0,0,18000,10000,8000,8000,2021-06-09
3909,082273,台積電元大07購12,0,0,0,0,0,0,0,0,0,8000,0,0,0,8000,0,8000,8000,2021-06-09
3910,4164,承業醫,26000,18000,8000,0,0,0,0,0,0,0,0,0,0,0,0,0,8000,2021-06-09
3911,3043,科風,8000,0,8000,0,0,0,0,0,0,0,0,0,0,0,0,0,8000,2021-06-09
3912,2852,第一保,44000,36000,8000,0,0,0,0,0,0,0,0,0,0,0,0,0,8000,2021-06-09
3913,089707,申豐元富0B購01,0,0,0,0,0,0,0,0,0,8000,0,0,0,8000,0,8000,8000,2021-06-09
3914,089174,奇鋐國泰0B購01,0,0,0,0,0,0,0,0,0,8000,0,0,0,8000,0,8000,8000,2021-06-09
3915,089125,A50正2元大0A購02,0,0,0,0,0,0,0,0,0,8000,0,0,0,8000,0,8000,8000,2021-06-09
3916,089322,東鋼富邦0A購01,0,0,0,0,0,0,0,0,0,8000,0,0,0,12000,4000,8000,8000,2021-06-09
3917,088230,世紀鋼元富11購01,0,0,0,0,0,0,0,0,0,7000,0,0,0,7000,0,7000,7000,2021-06-09
3918,088589,瑞軒統一09購02,0,0,0,0,0,0,0,0,0,7000,0,0,0,10000,3000,7000,7000,2021-06-09
3919,086608,瀚宇博永豐09購01,0,0,0,0,0,0,0,0,0,7000,0,0,0,7000,0,7000,7000,2021-06-09
3920,084619,聯電凱基08購10,0,0,0,0,0,0,0,0,0,7000,0,0,0,8000,1000,7000,7000,2021-06-09
3921,084736,宏碁元大09購01,0,0,0,0,0,0,0,0,0,7000,0,0,0,15000,8000,7000,7000,2021-06-09
3922,083958,興勤凱基08購02,0,0,0,0,0,0,0,0,0,7000,0,0,0,7000,0,7000,7000,2021-06-09
3923,085445,T50反1元富12購03,0,0,0,0,0,0,0,0,0,7000,0,0,0,19000,12000,7000,7000,2021-06-09
3924,086014,日月光元大0C購01,0,0,0,0,0,0,0,0,0,7000,0,0,0,12000,5000,7000,7000,2021-06-09
3925,032372,志超凱基0A購01,0,0,0,0,0,0,0,0,0,7000,0,0,0,52000,45000,7000,7000,2021-06-09
3926,032005,新唐群益0B購03,0,0,0,0,0,0,0,0,0,7000,0,0,0,7000,0,7000,7000,2021-06-09
3927,032196,長榮群益11購04,0,0,0,0,0,0,0,0,0,7000,0,0,0,7000,0,7000,7000,2021-06-09
3928,031663,京元電元大0A購02,0,0,0,0,0,0,0,0,0,7000,0,0,0,7000,0,7000,7000,2021-06-09
3929,031699,華新永豐0A購01,0,0,0,0,0,0,0,0,0,7000,0,0,0,7000,0,7000,7000,2021-06-09
3930,030903,廣宇凱基0A購02,0,0,0,0,0,0,0,0,0,7000,0,0,0,7000,0,7000,7000,2021-06-09
3931,031581,志聖凱基0B購01,0,0,0,0,0,0,0,0,0,7000,0,0,0,10000,3000,7000,7000,2021-06-09
3932,032706,矽創兆豐0B購01,0,0,0,0,0,0,0,0,0,7000,0,0,0,7000,0,7000,7000,2021-06-09
3933,032762,亞聚元大0A購04,0,0,0,0,0,0,0,0,0,7000,0,0,0,7000,0,7000,7000,2021-06-09
3934,032545,慧洋凱基0C購02,0,0,0,0,0,0,0,0,0,7000,0,0,0,23000,16000,7000,7000,2021-06-09
3935,031073,和碩元大0A購01,0,0,0,0,0,0,0,0,0,7000,0,0,0,7000,0,7000,7000,2021-06-09
3936,031448,華紙元富0A購01,0,0,0,0,0,0,0,0,0,7000,0,0,0,23000,16000,7000,7000,2021-06-09
3937,031471,百和群益0A購01,0,0,0,0,0,0,0,0,0,7000,0,0,0,10000,3000,7000,7000,2021-06-09
3938,031527,南亞富邦0C購01,0,0,0,0,0,0,0,0,0,7000,0,0,0,232000,225000,7000,7000,2021-06-09
3939,030318,台積電麥證0B購04,0,0,0,149000,142000,7000,0,0,0,7000,0,0,0,149000,142000,7000,7000,2021-06-09
3940,030329,恆大群益0B購01,0,0,0,0,0,0,0,0,0,7000,0,0,0,7000,0,7000,7000,2021-06-09
3941,030535,華邦電凱基0A購05,0,0,0,0,0,0,0,0,0,7000,0,0,0,57000,50000,7000,7000,2021-06-09
3942,00703,台新MSCI中國,0,0,0,0,0,0,0,0,0,7000,0,0,0,60000,53000,7000,7000,2021-06-09
3943,030449,臺股指元大11購06,0,0,0,0,0,0,0,0,0,7000,0,0,0,60000,53000,7000,7000,2021-06-09
3944,06172P,貿聯元大08售02,0,0,0,0,0,0,0,0,0,7000,0,0,0,7000,0,7000,7000,2021-06-09
3945,034045,裕民元富12購02,0,0,0,0,0,0,0,0,0,7000,0,0,0,132000,125000,7000,7000,2021-06-09
3946,034188,新光鋼元大0B購04,0,0,0,0,0,0,0,0,0,7000,0,0,0,7000,0,7000,7000,2021-06-09
3947,034233,大立光麥證11購01,0,0,0,7000,0,7000,0,0,0,7000,0,0,0,7000,0,7000,7000,2021-06-09
3948,035658,友達國泰12購02,0,0,0,0,0,0,0,0,0,7000,0,0,0,30000,23000,7000,7000,2021-06-09
3949,035452,微星國票0C購02,0,0,0,0,0,0,0,0,0,7000,0,0,0,16000,9000,7000,7000,2021-06-09
3950,034311,玉晶光永豐0B購04,0,0,0,0,0,0,0,0,0,7000,0,0,0,15000,8000,7000,7000,2021-06-09
3951,035945,新唐凱基11購02,0,0,0,0,0,0,0,0,0,7000,0,0,0,15000,8000,7000,7000,2021-06-09
3952,036115,台玻群益12購01,0,0,0,0,0,0,0,0,0,7000,0,0,0,7000,0,7000,7000,2021-06-09
3953,035107,開發金元大0B購04,0,0,0,0,0,0,0,0,0,7000,0,0,0,7000,0,7000,7000,2021-06-09
3954,035057,國巨國泰11購04,0,0,0,0,0,0,0,0,0,7000,0,0,0,268000,261000,7000,7000,2021-06-09
3955,036417,長榮航第一16購01,0,0,0,0,0,0,0,0,0,7000,0,0,0,131000,124000,7000,7000,2021-06-09
3956,082524,台積電群益08購07,0,0,0,0,0,0,0,0,0,7000,0,0,0,8000,1000,7000,7000,2021-06-09
3957,082846,晶技國票08購01,0,0,0,0,0,0,0,0,0,7000,0,0,0,10000,3000,7000,7000,2021-06-09
3958,083005,鴻海凱基0B購03,0,0,0,0,0,0,0,0,0,7000,0,0,0,15000,8000,7000,7000,2021-06-09
3959,080909,順德凱基0A購01,0,0,0,0,0,0,0,0,0,7000,0,0,0,7000,0,7000,7000,2021-06-09
3960,081477,新興康和07購01,0,0,0,0,0,0,0,0,0,7000,0,0,0,7000,0,7000,7000,2021-06-09
3961,079726,世紀鋼群益06購02,0,0,0,0,0,0,0,0,0,7000,0,0,0,7000,0,7000,7000,2021-06-09
3962,079386,欣興元大08購01,0,0,0,0,0,0,0,0,0,7000,0,0,0,7000,0,7000,7000,2021-06-09
3963,076970,世芯群益07購01,0,0,0,0,0,0,0,0,0,7000,0,0,0,7000,0,7000,7000,2021-06-09
3964,077060,奇力新統一08購01,0,0,0,0,0,0,0,0,0,7000,0,0,0,7000,0,7000,7000,2021-06-09
3965,073507,聯陽元富0A購01,0,0,0,0,0,0,0,0,0,7000,0,0,0,7000,0,7000,7000,2021-06-09
3966,06566P,台灣50中信11售01,0,0,0,0,0,0,0,0,0,7000,0,0,0,7000,0,7000,7000,2021-06-09
3967,06574P,台灣50元大0C售05,0,0,0,0,0,0,0,0,0,7000,0,0,0,12000,5000,7000,7000,2021-06-09
3968,07171P,聯詠群益0C售03,0,0,0,0,0,0,0,0,0,7000,0,0,0,7000,0,7000,7000,2021-06-09
3969,06842P,景碩元大0A售04,0,0,0,0,0,0,0,0,0,7000,0,0,0,40000,33000,7000,7000,2021-06-09
3970,083387,台積電富邦0A購02,0,0,0,0,0,0,0,0,0,7000,0,0,0,9000,2000,7000,7000,2021-06-09
3971,089160,立積元富09購05,0,0,0,0,0,0,0,0,0,7000,0,0,0,20000,13000,7000,7000,2021-06-09
3972,1524,耿鼎,67000,60000,7000,0,0,0,0,0,0,0,0,0,0,0,0,0,7000,2021-06-09
3973,089959,南帝元大0A購02,0,0,0,0,0,0,0,0,0,7000,0,0,0,12000,5000,7000,7000,2021-06-09
3974,089998,長榮中信11購01,0,0,0,0,0,0,0,0,0,7000,0,0,0,7000,0,7000,7000,2021-06-09
3975,089991,瑞儀元大0A購01,0,0,0,0,0,0,0,0,0,7000,0,0,0,18000,11000,7000,7000,2021-06-09
3976,4764,雙鍵,7000,0,7000,0,0,0,0,0,0,0,0,0,0,0,0,0,7000,2021-06-09
3977,1786,科妍,12000,5000,7000,0,0,0,0,0,0,0,0,0,0,0,0,0,7000,2021-06-09
3978,9905,大華,32000,25000,7000,0,0,0,0,0,0,0,0,0,0,0,0,0,7000,2021-06-09
3979,00739,元大MSCI A股,30000,6000,24000,0,0,0,0,0,0,-17664,0,0,0,146336,164000,-17664,6336,2021-06-09
3980,086406,聯陽統一0B購01,0,0,0,0,0,0,0,0,0,6000,0,0,0,15000,9000,6000,6000,2021-06-09
3981,085692,宏碁國泰0A購03,0,0,0,0,0,0,0,0,0,6000,0,0,0,8000,2000,6000,6000,2021-06-09
3982,084209,全新元大07購05,0,0,0,0,0,0,0,0,0,6000,0,0,0,26000,20000,6000,6000,2021-06-09
3983,085032,世紀鋼統一0A購01,0,0,0,0,0,0,0,0,0,6000,0,0,0,6000,0,6000,6000,2021-06-09
3984,084469,鴻海凱基08購11,0,0,0,0,0,0,0,0,0,6000,0,0,0,6000,0,6000,6000,2021-06-09
3985,086522,長榮航凱基11購01,0,0,0,0,0,0,0,0,0,6000,0,0,0,6000,0,6000,6000,2021-06-09
3986,086824,華邦電元大09購03,0,0,0,0,0,0,0,0,0,6000,0,0,0,6000,0,6000,6000,2021-06-09
3987,087022,美德醫永豐09購01,0,0,0,0,0,0,0,0,0,6000,0,0,0,6000,0,6000,6000,2021-06-09
3988,086934,友達元大0B購02,0,0,0,0,0,0,0,0,0,6000,0,0,0,12000,6000,6000,6000,2021-06-09
3989,087283,為升元大09購03,0,0,0,0,0,0,0,0,0,6000,0,0,0,6000,0,6000,6000,2021-06-09
3990,087363,華碩兆豐09購01,0,0,0,0,0,0,0,0,0,6000,0,0,0,6000,0,6000,6000,2021-06-09
3991,088374,鴻海國票13購03,0,0,0,0,0,0,0,0,0,6000,0,0,0,6000,0,6000,6000,2021-06-09
3992,088412,台船群益0A購01,0,0,0,0,0,0,0,0,0,6000,0,0,0,6000,0,6000,6000,2021-06-09
3993,088843,聯電兆豐0A購03,0,0,0,0,0,0,0,0,0,6000,0,0,0,6000,0,6000,6000,2021-06-09
3994,088748,矽創永豐09購03,0,0,0,0,0,0,0,0,0,6000,0,0,0,16000,10000,6000,6000,2021-06-09
3995,088745,晶相光永豐09購02,0,0,0,0,0,0,0,0,0,6000,0,0,0,6000,0,6000,6000,2021-06-09
3996,088946,矽創統一0B購08,0,0,0,0,0,0,0,0,0,6000,0,0,0,6000,0,6000,6000,2021-06-09
3997,088321,聚陽元大09購03,0,0,0,0,0,0,0,0,0,6000,0,0,0,6000,0,6000,6000,2021-06-09
3998,087796,玉晶光日盛09購01,0,0,0,0,0,0,0,0,0,6000,0,0,0,6000,0,6000,6000,2021-06-09
3999,00711B,FH彭博新興債,5000,0,5000,0,0,0,0,0,0,1000,0,0,0,101000,100000,1000,6000,2021-06-09
4000,00865B,國泰US短期公債,1000,0,1000,0,0,0,0,0,0,5000,0,0,0,6000,1000,5000,6000,2021-06-09
4001,030097,聯發科永豐0B購01,0,0,0,0,0,0,0,0,0,6000,0,0,0,6000,0,6000,6000,2021-06-09
4002,030108,日電貿永豐0A購01,0,0,0,0,0,0,0,0,0,6000,0,0,0,35000,29000,6000,6000,2021-06-09
4003,030102,東森永豐0A購01,0,0,0,0,0,0,0,0,0,6000,0,0,0,22000,16000,6000,6000,2021-06-09
4004,031224,瀚宇博凱基0A購01,0,0,0,0,0,0,0,0,0,6000,0,0,0,6000,0,6000,6000,2021-06-09
4005,031412,華紙凱基0B購01,0,0,0,0,0,0,0,0,0,6000,0,0,0,6000,0,6000,6000,2021-06-09
4006,031381,榮成統一0A購02,0,0,0,0,0,0,0,0,0,6000,0,0,0,6000,0,6000,6000,2021-06-09
4007,030715,惠特群益0B購02,0,0,0,0,0,0,0,0,0,6000,0,0,0,6000,0,6000,6000,2021-06-09
4008,032656,台塑麥證0B購01,0,0,0,6000,0,6000,0,0,0,6000,0,0,0,6000,0,6000,6000,2021-06-09
4009,030853,南茂兆豐0B購01,0,0,0,0,0,0,0,0,0,6000,0,0,0,61000,55000,6000,6000,2021-06-09
4010,031711,長榮永豐0A購07,0,0,0,0,0,0,0,0,0,6000,0,0,0,11000,5000,6000,6000,2021-06-09
4011,032565,萬海群益0A購08,0,0,0,0,0,0,0,0,0,6000,0,0,0,6000,0,6000,6000,2021-06-09
4012,032115,上証2X凱基0C購03,0,0,0,0,0,0,0,0,0,6000,0,0,0,10000,4000,6000,6000,2021-06-09
4013,032150,萬海凱基0A購04,0,0,0,0,0,0,0,0,0,6000,0,0,0,6000,0,6000,6000,2021-06-09
4014,032187,台橡群益0A購01,0,0,0,0,0,0,0,0,0,6000,0,0,0,26000,20000,6000,6000,2021-06-09
4015,031998,長榮群益0C購04,0,0,0,0,0,0,0,0,0,6000,0,0,0,6000,0,6000,6000,2021-06-09
4016,032038,華榮國票0B購01,0,0,0,0,0,0,0,0,0,6000,0,0,0,6000,0,6000,6000,2021-06-09
4017,031866,台玻凱基14購01,0,0,0,0,0,0,0,0,0,6000,0,0,0,6000,0,6000,6000,2021-06-09
4018,032852,滬深2X群益0A購04,0,0,0,0,0,0,0,0,0,6000,0,0,0,32000,26000,6000,6000,2021-06-09
4019,036453,京元電康和0C購01,0,0,0,0,0,0,0,0,0,6000,0,0,0,6000,0,6000,6000,2021-06-09
4020,04458P,滬深2X元富0A售01,0,0,0,0,0,0,0,0,0,6000,0,0,0,6000,0,6000,6000,2021-06-09
4021,035018,臺指反凱基11購01,0,0,0,0,0,0,0,0,0,6000,0,0,0,6000,0,6000,6000,2021-06-09
4022,035428,聯發科元大11購07,0,0,0,0,0,0,0,0,0,6000,0,0,0,16000,10000,6000,6000,2021-06-09
4023,035229,南電兆豐0B購01,0,0,0,0,0,0,0,0,0,6000,0,0,0,6000,0,6000,6000,2021-06-09
4024,035239,中鋼群益0B購17,0,0,0,0,0,0,0,0,0,6000,0,0,0,15000,9000,6000,6000,2021-06-09
4025,036121,嘉晶群益0C購01,0,0,0,0,0,0,0,0,0,6000,0,0,0,46000,40000,6000,6000,2021-06-09
4026,035932,燁輝凱基0C購02,0,0,0,0,0,0,0,0,0,6000,0,0,0,6000,0,6000,6000,2021-06-09
4027,035806,聯電凱基13購03,0,0,0,0,0,0,0,0,0,6000,0,0,0,7000,1000,6000,6000,2021-06-09
4028,034864,晶相光元大0C購01,0,0,0,0,0,0,0,0,0,6000,0,0,0,6000,0,6000,6000,2021-06-09
4029,035485,萬海群益13購03,0,0,0,0,0,0,0,0,0,6000,0,0,0,26000,20000,6000,6000,2021-06-09
4030,035704,中鋼元大0C購05,0,0,0,0,0,0,0,0,0,6000,0,0,0,6000,0,6000,6000,2021-06-09
4031,034145,友訊凱基0B購01,0,0,0,0,0,0,0,0,0,6000,0,0,0,6000,0,6000,6000,2021-06-09
4032,06100P,台灣50凱基07售19,0,0,0,0,0,0,0,0,0,6000,0,0,0,6000,0,6000,6000,2021-06-09
4033,05950P,上銀群益07售02,0,0,0,0,0,0,0,0,0,6000,0,0,0,6000,0,6000,6000,2021-06-09
4034,034984,大成鋼群益0C購06,0,0,0,0,0,0,0,0,0,6000,0,0,0,6000,0,6000,6000,2021-06-09
4035,033668,南紡台新0B購01,0,0,0,0,0,0,0,0,0,6000,0,0,0,6000,0,6000,6000,2021-06-09
4036,034892,國喬凱基0B購03,0,0,0,0,0,0,0,0,0,6000,0,0,0,21000,15000,6000,6000,2021-06-09
4037,06369P,旺宏元大08售03,0,0,0,0,0,0,0,0,0,6000,0,0,0,66000,60000,6000,6000,2021-06-09
4038,06878P,立積元大0A售07,0,0,0,0,0,0,0,0,0,6000,0,0,0,19000,13000,6000,6000,2021-06-09
4039,07065P,國泰金元富0B售05,0,0,0,0,0,0,0,0,0,6000,0,0,0,33000,27000,6000,6000,2021-06-09
4040,06585P,祥碩凱基09售05,0,0,0,0,0,0,0,0,0,6000,0,0,0,44000,38000,6000,6000,2021-06-09
4041,06404P,南亞科元富08售04,0,0,0,0,0,0,0,0,0,6000,0,0,0,9000,3000,6000,6000,2021-06-09
4042,06751P,景碩中信0A售01,0,0,0,0,0,0,0,0,0,6000,0,0,0,36000,30000,6000,6000,2021-06-09
4043,06745P,台灣50元大0A售15,0,0,0,0,0,0,0,0,0,6000,0,0,0,156000,150000,6000,6000,2021-06-09
4044,076045,上銀國票08購01,0,0,0,0,0,0,0,0,0,6000,0,0,0,6000,0,6000,6000,2021-06-09
4045,079020,聯電元大06購20,0,0,0,0,0,0,0,0,0,6000,0,0,0,17000,11000,6000,6000,2021-06-09
4046,078116,強茂元富07購03,0,0,0,0,0,0,0,0,0,6000,0,0,0,6000,0,6000,6000,2021-06-09
4047,079748,正隆元富06購01,0,0,0,0,0,0,0,0,0,6000,0,0,0,6000,0,6000,6000,2021-06-09
4048,079742,合勤控統一07購01,0,0,0,0,0,0,0,0,0,6000,0,0,0,6000,0,6000,6000,2021-06-09
4049,080939,智邦群益08購01,0,0,0,0,0,0,0,0,0,6000,0,0,0,6000,0,6000,6000,2021-06-09
4050,082874,京元電兆豐08購01,0,0,0,0,0,0,0,0,0,6000,0,0,0,6000,0,6000,6000,2021-06-09
4051,082767,台勝科統一09購02,0,0,0,0,0,0,0,0,0,6000,0,0,0,6000,0,6000,6000,2021-06-09
4052,082154,鴻海國泰09購01,0,0,0,0,0,0,0,0,0,6000,0,0,0,6000,0,6000,6000,2021-06-09
4053,082052,大立光凱基08購04,0,0,0,0,0,0,0,0,0,6000,0,0,0,14000,8000,6000,6000,2021-06-09
4054,2414,精技,21000,15000,6000,0,0,0,0,0,0,0,0,0,0,0,0,0,6000,2021-06-09
4055,4916,事欣科,14000,8000,6000,0,0,0,0,0,0,0,0,0,0,0,0,0,6000,2021-06-09
4056,3494,誠研,10000,4000,6000,0,0,0,0,0,0,0,0,0,0,0,0,0,6000,2021-06-09
4057,089864,永豐餘中信0C購01,0,0,0,0,0,0,0,0,0,6000,0,0,0,6000,0,6000,6000,2021-06-09
4058,089702,南帝元富09購03,0,0,0,0,0,0,0,0,0,6000,0,0,0,9000,3000,6000,6000,2021-06-09
4059,089530,祥碩元大09購06,0,0,0,0,0,0,0,0,0,6000,0,0,0,6000,0,6000,6000,2021-06-09
4060,087690,華新科元大0C購03,0,0,0,0,0,0,0,0,0,5000,0,0,0,5000,0,5000,5000,2021-06-09
4061,087914,富邦金群益0B購03,0,0,0,0,0,0,0,0,0,5000,0,0,0,5000,0,5000,5000,2021-06-09
4062,088204,和碩台新09購01,0,0,0,0,0,0,0,0,0,5000,0,0,0,5000,0,5000,5000,2021-06-09
4063,088172,開發金元大11購01,0,0,0,0,0,0,0,0,0,5000,0,0,0,5000,0,5000,5000,2021-06-09
4064,088178,鼎炫元大0A購01,0,0,0,0,0,0,0,0,0,5000,0,0,0,5000,0,5000,5000,2021-06-09
4065,088986,立積元富09購03,0,0,0,0,0,0,0,0,0,5000,0,0,0,5000,0,5000,5000,2021-06-09
4066,088945,矽創統一0B購07,0,0,0,0,0,0,0,0,0,5000,0,0,0,5000,0,5000,5000,2021-06-09
4067,088898,惠特凱基0B購01,0,0,0,0,0,0,0,0,0,5000,0,0,0,5000,0,5000,5000,2021-06-09
4068,088711,茂林中信09購01,0,0,0,0,0,0,0,0,0,5000,0,0,0,15000,10000,5000,5000,2021-06-09
4069,088389,聯陽富邦0B購01,0,0,0,0,0,0,0,0,0,5000,0,0,0,5000,0,5000,5000,2021-06-09
4070,088360,矽創統一0B購05,0,0,0,0,0,0,0,0,0,5000,0,0,0,25000,20000,5000,5000,2021-06-09
4071,088529,緯穎國泰0B購01,0,0,0,0,0,0,0,0,0,5000,0,0,0,5000,0,5000,5000,2021-06-09
4072,088655,新光鋼元大09購02,0,0,0,0,0,0,0,0,0,5000,0,0,0,5000,0,5000,5000,2021-06-09
4073,087500,國巨兆豐0A購01,0,0,0,0,0,0,0,0,0,5000,0,0,0,5000,0,5000,5000,2021-06-09
4074,087449,晶碩群益0A購01,0,0,0,0,0,0,0,0,0,5000,0,0,0,5000,0,5000,5000,2021-06-09
4075,087419,晶豪科統一0C購01,0,0,0,0,0,0,0,0,0,5000,0,0,0,5000,0,5000,5000,2021-06-09
4076,087625,滬深2X凱基09購05,0,0,0,0,0,0,0,0,0,5000,0,0,0,5000,0,5000,5000,2021-06-09
4077,087617,聯發科國泰13購01,0,0,0,0,0,0,0,0,0,5000,0,0,0,6000,1000,5000,5000,2021-06-09
4078,087072,台船統一0B購01,0,0,0,0,0,0,0,0,0,5000,0,0,0,5000,0,5000,5000,2021-06-09
4079,087100,鴻海元大11購02,0,0,0,0,0,0,0,0,0,5000,0,0,0,5000,0,5000,5000,2021-06-09
4080,087013,亞聚永豐09購01,0,0,0,0,0,0,0,0,0,5000,0,0,0,5000,0,5000,5000,2021-06-09
4081,087055,聯茂凱基09購01,0,0,0,0,0,0,0,0,0,5000,0,0,0,45000,40000,5000,5000,2021-06-09
4082,087036,大成鋼凱基13購02,0,0,0,0,0,0,0,0,0,5000,0,0,0,5000,0,5000,5000,2021-06-09
4083,087032,華夏凱基09購02,0,0,0,0,0,0,0,0,0,5000,0,0,0,5000,0,5000,5000,2021-06-09
4084,086775,台表科凱基0A購01,0,0,0,0,0,0,0,0,0,5000,0,0,0,5000,0,5000,5000,2021-06-09
4085,086833,可成元大09購02,0,0,0,0,0,0,0,0,0,5000,0,0,0,10000,5000,5000,5000,2021-06-09
4086,086508,奇鋐麥證09購01,0,0,0,20000,15000,5000,0,0,0,5000,0,0,0,20000,15000,5000,5000,2021-06-09
4087,084394,健策元富07購02,0,0,0,0,0,0,0,0,0,5000,0,0,0,5000,0,5000,5000,2021-06-09
4088,084698,宏碁統一0A購03,0,0,0,0,0,0,0,0,0,5000,0,0,0,5000,0,5000,5000,2021-06-09
4089,084823,仁寶統一0A購01,0,0,0,0,0,0,0,0,0,5000,0,0,0,5000,0,5000,5000,2021-06-09
4090,084182,世紀鋼凱基08購06,0,0,0,0,0,0,0,0,0,5000,0,0,0,5000,0,5000,5000,2021-06-09
4091,084038,義隆元富07購03,0,0,0,0,0,0,0,0,0,5000,0,0,0,5000,0,5000,5000,2021-06-09
4092,084024,台郡統一09購02,0,0,0,0,0,0,0,0,0,5000,0,0,0,5000,0,5000,5000,2021-06-09
4093,083855,聯茂群益08購02,0,0,0,0,0,0,0,0,0,5000,0,0,0,5000,0,5000,5000,2021-06-09
4094,083735,裕隆國票08購02,0,0,0,0,0,0,0,0,0,5000,0,0,0,5000,0,5000,5000,2021-06-09
4095,083731,SGBR2X國票08購02,0,0,0,0,0,0,0,0,0,5000,0,0,0,5000,0,5000,5000,2021-06-09
4096,085640,乙盛凱基08購03,0,0,0,0,0,0,0,0,0,5000,0,0,0,57000,52000,5000,5000,2021-06-09
4097,085642,聚鼎凱基08購01,0,0,0,0,0,0,0,0,0,5000,0,0,0,50000,45000,5000,5000,2021-06-09
4098,085394,元石油元大08購01,0,0,0,0,0,0,0,0,0,5000,0,0,0,5000,0,5000,5000,2021-06-09
4099,085485,台橡凱基08購01,0,0,0,0,0,0,0,0,0,5000,0,0,0,10000,5000,5000,5000,2021-06-09
4100,085211,臺股指群益08購04,0,0,0,0,0,0,0,0,0,5000,0,0,0,5000,0,5000,5000,2021-06-09
4101,085092,台積電凱基08購24,0,0,0,0,0,0,0,0,0,5000,0,0,0,15000,10000,5000,5000,2021-06-09
4102,085108,聯電元大08購08,0,0,0,0,0,0,0,0,0,5000,0,0,0,6000,1000,5000,5000,2021-06-09
4103,086315,大立光凱基09購06,0,0,0,0,0,0,0,0,0,5000,0,0,0,15000,10000,5000,5000,2021-06-09
4104,086224,晶豪科統一0A購03,0,0,0,0,0,0,0,0,0,5000,0,0,0,5000,0,5000,5000,2021-06-09
4105,086167,聯詠元大0C購01,0,0,0,0,0,0,0,0,0,5000,0,0,0,5000,0,5000,5000,2021-06-09
4106,086049,聯陽元富0B購01,0,0,0,0,0,0,0,0,0,5000,0,0,0,5000,0,5000,5000,2021-06-09
4107,086059,華邦電統一0A購05,0,0,0,0,0,0,0,0,0,5000,0,0,0,5000,0,5000,5000,2021-06-09
4108,085843,力山統一0A購01,0,0,0,0,0,0,0,0,0,5000,0,0,0,5000,0,5000,5000,2021-06-09
4109,085868,台郡統一0A購01,0,0,0,0,0,0,0,0,0,5000,0,0,0,5000,0,5000,5000,2021-06-09
4110,032822,惠特國票0B購01,0,0,0,0,0,0,0,0,0,5000,0,0,0,5000,0,5000,5000,2021-06-09
4111,032887,大亞統一13購01,0,0,0,0,0,0,0,0,0,5000,0,0,0,10000,5000,5000,5000,2021-06-09
4112,033069,宏達電凱基0A購02,0,0,0,0,0,0,0,0,0,5000,0,0,0,45000,40000,5000,5000,2021-06-09
4113,032271,亞泥富邦0B購01,0,0,0,0,0,0,0,0,0,5000,0,0,0,5000,0,5000,5000,2021-06-09
4114,032310,長榮永豐0A購10,0,0,0,0,0,0,0,0,0,5000,0,0,0,5000,0,5000,5000,2021-06-09
4115,032315,嘉晶永豐0A購02,0,0,0,0,0,0,0,0,0,5000,0,0,0,5000,0,5000,5000,2021-06-09
4116,031835,中石化兆豐0C購01,0,0,0,0,0,0,0,0,0,5000,0,0,0,15000,10000,5000,5000,2021-06-09
4117,032440,長榮元大0A購23,0,0,0,0,0,0,0,0,0,5000,0,0,0,5000,0,5000,5000,2021-06-09
4118,032432,微星元大0C購01,0,0,0,0,0,0,0,0,0,5000,0,0,0,15000,10000,5000,5000,2021-06-09
4119,033546,台積電元富12購07,0,0,0,0,0,0,0,0,0,5000,0,0,0,5000,0,5000,5000,2021-06-09
4120,033460,玉晶光群益11購02,0,0,0,0,0,0,0,0,0,5000,0,0,0,17000,12000,5000,5000,2021-06-09
4121,033483,華新統一11購01,0,0,0,0,0,0,0,0,0,5000,0,0,0,5000,0,5000,5000,2021-06-09
4122,032019,祥碩統一0C購02,0,0,0,0,0,0,0,0,0,5000,0,0,0,5000,0,5000,5000,2021-06-09
4123,031884,長榮凱基13購03,0,0,0,0,0,0,0,0,0,5000,0,0,0,5000,0,5000,5000,2021-06-09
4124,032194,益航群益0A購01,0,0,0,0,0,0,0,0,0,5000,0,0,0,18000,13000,5000,5000,2021-06-09
4125,032143,長榮凱基0A購16,0,0,0,0,0,0,0,0,0,5000,0,0,0,5000,0,5000,5000,2021-06-09
4126,032516,慧洋永豐0A購06,0,0,0,0,0,0,0,0,0,5000,0,0,0,5000,0,5000,5000,2021-06-09
4127,033334,華新永豐0B購01,0,0,0,0,0,0,0,0,0,5000,0,0,0,9000,4000,5000,5000,2021-06-09
4128,033321,台玻凱基0C購02,0,0,0,0,0,0,0,0,0,5000,0,0,0,10000,5000,5000,5000,2021-06-09
4129,031806,中鋼元大0A購04,0,0,0,0,0,0,0,0,0,5000,0,0,0,5000,0,5000,5000,2021-06-09
4130,031807,中鋼元大0A購05,0,0,0,0,0,0,0,0,0,5000,0,0,0,5000,0,5000,5000,2021-06-09
4131,036245,順德凱基0C購01,0,0,0,0,0,0,0,0,0,5000,0,0,0,15000,10000,5000,5000,2021-06-09
4132,05442P,聯電群益08售02,0,0,0,0,0,0,0,0,0,5000,0,0,0,5000,0,5000,5000,2021-06-09
4133,031584,長榮凱基14購03,0,0,0,0,0,0,0,0,0,5000,0,0,0,5000,0,5000,5000,2021-06-09
4134,031286,群創日盛0A購04,0,0,0,0,0,0,0,0,0,5000,0,0,0,5000,0,5000,5000,2021-06-09
4135,033187,元金2X凱基11購01,0,0,0,0,0,0,0,0,0,5000,0,0,0,5000,0,5000,5000,2021-06-09
4136,032765,南紡元大0B購02,0,0,0,0,0,0,0,0,0,5000,0,0,0,5000,0,5000,5000,2021-06-09
4137,032766,華新元大0C購01,0,0,0,0,0,0,0,0,0,5000,0,0,0,5000,0,5000,5000,2021-06-09
4138,032735,台玻凱基0A購02,0,0,0,0,0,0,0,0,0,5000,0,0,0,5000,0,5000,5000,2021-06-09
4139,032704,彩晶兆豐0A購06,0,0,0,0,0,0,0,0,0,5000,0,0,0,5000,0,5000,5000,2021-06-09
4140,032676,東鋼中信0A購02,0,0,0,0,0,0,0,0,0,5000,0,0,0,5000,0,5000,5000,2021-06-09
4141,031091,華新群益0A購02,0,0,0,0,0,0,0,0,0,5000,0,0,0,5000,0,5000,5000,2021-06-09
4142,031380,永豐餘統一0B購01,0,0,0,0,0,0,0,0,0,5000,0,0,0,5000,0,5000,5000,2021-06-09
4143,031424,旺宏凱基0B購03,0,0,0,0,0,0,0,0,0,5000,0,0,0,5000,0,5000,5000,2021-06-09
4144,031214,全新凱基0A購02,0,0,0,0,0,0,0,0,0,5000,0,0,0,30000,25000,5000,5000,2021-06-09
4145,031258,群創群益14購02,0,0,0,0,0,0,0,0,0,5000,0,0,0,5000,0,5000,5000,2021-06-09
4146,031628,長榮統一0C購07,0,0,0,0,0,0,0,0,0,5000,0,0,0,5000,0,5000,5000,2021-06-09
4147,030421,聯詠元大0A購04,0,0,0,0,0,0,0,0,0,5000,0,0,0,5000,0,5000,5000,2021-06-09
4148,006203,元大MSCI台灣,1000,0,1000,0,0,0,0,0,0,4000,0,0,0,7000,3000,4000,5000,2021-06-09
4149,00763U,期街口道瓊銅,0,2000,-2000,0,0,0,0,0,0,7000,0,0,0,52000,45000,7000,5000,2021-06-09
4150,06356P,聯電國泰0A售02,0,0,0,0,0,0,0,0,0,5000,0,0,0,5000,0,5000,5000,2021-06-09
4151,034919,友達麥證0B購05,0,0,0,189000,184000,5000,0,0,0,5000,0,0,0,189000,184000,5000,5000,2021-06-09
4152,034944,健策群益0B購03,0,0,0,0,0,0,0,0,0,5000,0,0,0,41000,36000,5000,5000,2021-06-09
4153,033684,萬海元大0C購05,0,0,0,0,0,0,0,0,0,5000,0,0,0,5000,0,5000,5000,2021-06-09
4154,034429,香港2X凱基14購01,0,0,0,0,0,0,0,0,0,5000,0,0,0,5000,0,5000,5000,2021-06-09
4155,05949P,台灣50群益08售06,0,0,0,0,0,0,0,0,0,5000,0,0,0,5000,0,5000,5000,2021-06-09
4156,05964P,大立光凱基08售06,0,0,0,0,0,0,0,0,0,5000,0,0,0,5000,0,5000,5000,2021-06-09
4157,06204P,廣宇國票09售01,0,0,0,0,0,0,0,0,0,5000,0,0,0,15000,10000,5000,5000,2021-06-09
4158,06235P,臺股指中信0C售04,0,0,0,0,0,0,0,0,0,5000,0,0,0,10000,5000,5000,5000,2021-06-09
4159,06101P,台灣50凱基07售20,0,0,0,0,0,0,0,0,0,5000,0,0,0,5000,0,5000,5000,2021-06-09
4160,06076P,上緯控群益09售02,0,0,0,0,0,0,0,0,0,5000,0,0,0,5000,0,5000,5000,2021-06-09
4161,034159,廣宇永豐0B購01,0,0,0,0,0,0,0,0,0,5000,0,0,0,5000,0,5000,5000,2021-06-09
4162,034051,京元電麥證0B購01,0,0,0,5000,0,5000,0,0,0,5000,0,0,0,5000,0,5000,5000,2021-06-09
4163,034097,臻鼎元大0C購01,0,0,0,0,0,0,0,0,0,5000,0,0,0,87000,82000,5000,5000,2021-06-09
4164,034474,華新元大0B購07,0,0,0,0,0,0,0,0,0,5000,0,0,0,19000,14000,5000,5000,2021-06-09
4165,034466,亞聚元大0B購02,0,0,0,0,0,0,0,0,0,5000,0,0,0,15000,10000,5000,5000,2021-06-09
4166,034552,聯電台新0B購01,0,0,0,0,0,0,0,0,0,5000,0,0,0,10000,5000,5000,5000,2021-06-09
4167,035721,玉晶光元大0B購06,0,0,0,0,0,0,0,0,0,5000,0,0,0,5000,0,5000,5000,2021-06-09
4168,035477,T50反1群益11購01,0,0,0,0,0,0,0,0,0,5000,0,0,0,5000,0,5000,5000,2021-06-09
4169,05823P,台積電群益07售10,0,0,0,0,0,0,0,0,0,5000,0,0,0,5000,0,5000,5000,2021-06-09
4170,035826,中鋼元大0B購16,0,0,0,0,0,0,0,0,0,5000,0,0,0,5000,0,5000,5000,2021-06-09
4171,035955,中鋼元大0C購06,0,0,0,0,0,0,0,0,0,5000,0,0,0,7000,2000,5000,5000,2021-06-09
4172,035931,永光凱基0C購01,0,0,0,0,0,0,0,0,0,5000,0,0,0,5000,0,5000,5000,2021-06-09
4173,035901,中鋼群益11購03,0,0,0,0,0,0,0,0,0,5000,0,0,0,5000,0,5000,5000,2021-06-09
4174,036122,群創群益11購07,0,0,0,0,0,0,0,0,0,5000,0,0,0,41000,36000,5000,5000,2021-06-09
4175,033948,聯電國票11購01,0,0,0,0,0,0,0,0,0,5000,0,0,0,11000,6000,5000,5000,2021-06-09
4176,033957,緯穎國票0C購02,0,0,0,0,0,0,0,0,0,5000,0,0,0,6000,1000,5000,5000,2021-06-09
4177,035238,東聯群益0B購02,0,0,0,0,0,0,0,0,0,5000,0,0,0,75000,70000,5000,5000,2021-06-09
4178,035054,祥碩富邦0C購01,0,0,0,0,0,0,0,0,0,5000,0,0,0,50000,45000,5000,5000,2021-06-09
4179,03507B,臺股指元大0B熊16,0,0,0,0,0,0,0,0,0,5000,0,0,0,6000,1000,5000,5000,2021-06-09
4180,05330P,臺指2X國票08售02,0,0,0,0,0,0,0,0,0,5000,0,0,0,5000,0,5000,5000,2021-06-09
4181,082237,國巨凱基09購04,0,0,0,0,0,0,0,0,0,5000,0,0,0,5000,0,5000,5000,2021-06-09
4182,082278,智邦元大07購07,0,0,0,0,0,0,0,0,0,5000,0,0,0,5000,0,5000,5000,2021-06-09
4183,082320,台積電統一07購08,0,0,0,0,0,0,0,0,0,5000,0,0,0,5000,0,5000,5000,2021-06-09
4184,082424,TPK永豐07購01,0,0,0,0,0,0,0,0,0,5000,0,0,0,5000,0,5000,5000,2021-06-09
4185,082374,義隆日盛08購01,0,0,0,0,0,0,0,0,0,5000,0,0,0,5000,0,5000,5000,2021-06-09
4186,082385,貿聯兆豐07購01,0,0,0,0,0,0,0,0,0,5000,0,0,0,5000,0,5000,5000,2021-06-09
4187,082391,為升凱基08購01,0,0,0,0,0,0,0,0,0,5000,0,0,0,5000,0,5000,5000,2021-06-09
4188,081647,鴻海兆豐09購03,0,0,0,0,0,0,0,0,0,5000,0,0,0,5000,0,5000,5000,2021-06-09
4189,081669,鴻海富邦07購03,0,0,0,0,0,0,0,0,0,5000,0,0,0,5000,0,5000,5000,2021-06-09
4190,081671,長榮富邦08購02,0,0,0,0,0,0,0,0,0,5000,0,0,0,5000,0,5000,5000,2021-06-09
4191,081621,榮運元大07購01,0,0,0,0,0,0,0,0,0,5000,0,0,0,5000,0,5000,5000,2021-06-09
4192,081824,億光凱基09購01,0,0,0,0,0,0,0,0,0,5000,0,0,0,5000,0,5000,5000,2021-06-09
4193,082688,SGBR2X凱基08購01,0,0,0,0,0,0,0,0,0,5000,0,0,0,5000,0,5000,5000,2021-06-09
4194,082729,國巨群益08購08,0,0,0,0,0,0,0,0,0,5000,0,0,0,5000,0,5000,5000,2021-06-09
4195,083268,貿聯凱基08購02,0,0,0,0,0,0,0,0,0,5000,0,0,0,5000,0,5000,5000,2021-06-09
4196,083264,健和興凱基09購01,0,0,0,0,0,0,0,0,0,5000,0,0,0,113000,108000,5000,5000,2021-06-09
4197,081412,億光群益08購02,0,0,0,0,0,0,0,0,0,5000,0,0,0,5000,0,5000,5000,2021-06-09
4198,081374,長榮中信09購01,0,0,0,0,0,0,0,0,0,5000,0,0,0,5000,0,5000,5000,2021-06-09
4199,079618,泰山永豐06購01,0,0,0,0,0,0,0,0,0,5000,0,0,0,5000,0,5000,5000,2021-06-09
4200,079411,長榮富邦06購02,0,0,0,0,0,0,0,0,0,5000,0,0,0,105000,100000,5000,5000,2021-06-09
4201,079270,中石化國票08購01,0,0,0,0,0,0,0,0,0,5000,0,0,0,5000,0,5000,5000,2021-06-09
4202,079145,金像電元大07購02,0,0,0,0,0,0,0,0,0,5000,0,0,0,5000,0,5000,5000,2021-06-09
4203,079147,京元電元大06購02,0,0,0,0,0,0,0,0,0,5000,0,0,0,5000,0,5000,5000,2021-06-09
4204,080310,國巨兆豐07購02,0,0,0,0,0,0,0,0,0,5000,0,0,0,5000,0,5000,5000,2021-06-09
4205,080094,世紀鋼元大06購05,0,0,0,0,0,0,0,0,0,5000,0,0,0,37000,32000,5000,5000,2021-06-09
4206,080013,宏達電國票08購02,0,0,0,0,0,0,0,0,0,5000,0,0,0,5000,0,5000,5000,2021-06-09
4207,078389,聯電富邦07購01,0,0,0,0,0,0,0,0,0,5000,0,0,0,5000,0,5000,5000,2021-06-09
4208,078359,旺宏元大07購01,0,0,0,0,0,0,0,0,0,5000,0,0,0,5000,0,5000,5000,2021-06-09
4209,078480,亞德客國票07購01,0,0,0,0,0,0,0,0,0,5000,0,0,0,5000,0,5000,5000,2021-06-09
4210,078979,華新科日盛06購01,0,0,0,0,0,0,0,0,0,5000,0,0,0,5000,0,5000,5000,2021-06-09
4211,078771,聯電群益08購01,0,0,0,0,0,0,0,0,0,5000,0,0,0,5000,0,5000,5000,2021-06-09
4212,077144,矽格凱基06購01,0,0,0,0,0,0,0,0,0,5000,0,0,0,5000,0,5000,5000,2021-06-09
4213,077455,聯電國票06購06,0,0,0,0,0,0,0,0,0,5000,0,0,0,10000,5000,5000,5000,2021-06-09
4214,076993,華立國票06購02,0,0,0,0,0,0,0,0,0,5000,0,0,0,5000,0,5000,5000,2021-06-09
4215,078114,漢唐元富0C購01,0,0,0,0,0,0,0,0,0,5000,0,0,0,5000,0,5000,5000,2021-06-09
4216,076410,和碩統一06購01,0,0,0,0,0,0,0,0,0,5000,0,0,0,5000,0,5000,5000,2021-06-09
4217,076520,中興電元大07購01,0,0,0,0,0,0,0,0,0,5000,0,0,0,5000,0,5000,5000,2021-06-09
4218,075940,申豐國票07購01,0,0,0,0,0,0,0,0,0,5000,0,0,0,8000,3000,5000,5000,2021-06-09
4219,075822,創意國票07購01,0,0,0,0,0,0,0,0,0,5000,0,0,0,5000,0,5000,5000,2021-06-09
4220,075644,京鼎元富08購01,0,0,0,0,0,0,0,0,0,5000,0,0,0,5000,0,5000,5000,2021-06-09
4221,074081,玉晶光元富08購04,0,0,0,0,0,0,0,0,0,5000,0,0,0,5000,0,5000,5000,2021-06-09
4222,073995,京元電元富0A購01,0,0,0,0,0,0,0,0,0,5000,0,0,0,10000,5000,5000,5000,2021-06-09
4223,073526,智易國泰06購01,0,0,0,0,0,0,0,0,0,5000,0,0,0,5000,0,5000,5000,2021-06-09
4224,068227,聯發科元富07購07,0,0,0,0,0,0,0,0,0,5000,0,0,0,5000,0,5000,5000,2021-06-09
4225,06825P,立積元富0A售06,0,0,0,0,0,0,0,0,0,5000,0,0,0,5000,0,5000,5000,2021-06-09
4226,06690P,鴻海凱基09售15,0,0,0,0,0,0,0,0,0,5000,0,0,0,5000,0,5000,5000,2021-06-09
4227,06662P,立積元富09售06,0,0,0,0,0,0,0,0,0,5000,0,0,0,5000,0,5000,5000,2021-06-09
4228,06626P,臺股指中信11售04,0,0,0,0,0,0,0,0,0,5000,0,0,0,5000,0,5000,5000,2021-06-09
4229,06591P,臺股指凱基0C售13,0,0,0,0,0,0,0,0,0,5000,0,0,0,15000,10000,5000,5000,2021-06-09
4230,07169P,台積電台新0B售04,0,0,0,0,0,0,0,0,0,5000,0,0,0,5000,0,5000,5000,2021-06-09
4231,07174P,欣興凱基0B售04,0,0,0,0,0,0,0,0,0,5000,0,0,0,10000,5000,5000,5000,2021-06-09
4232,07122P,臺股指元大0C售21,0,0,0,0,0,0,0,0,0,5000,0,0,0,5000,0,5000,5000,2021-06-09
4233,071042,貿聯元富09購01,0,0,0,0,0,0,0,0,0,5000,0,0,0,5000,0,5000,5000,2021-06-09
4234,06914P,立積凱基0A售06,0,0,0,0,0,0,0,0,0,5000,0,0,0,5000,0,5000,5000,2021-06-09
4235,069629,台達電元富08購02,0,0,0,0,0,0,0,0,0,5000,0,0,0,5000,0,5000,5000,2021-06-09
4236,06973P,彩晶統一0B售05,0,0,0,0,0,0,0,0,0,5000,0,0,0,5000,0,5000,5000,2021-06-09
4237,083384,矽創國泰09購01,0,0,0,0,0,0,0,0,0,5000,0,0,0,5000,0,5000,5000,2021-06-09
4238,083407,金寶永豐07購01,0,0,0,0,0,0,0,0,0,5000,0,0,0,5000,0,5000,5000,2021-06-09
4239,089593,南帝群益0B購03,0,0,0,0,0,0,0,0,0,5000,0,0,0,5000,0,5000,5000,2021-06-09
4240,089450,台積電統一0C購07,0,0,0,0,0,0,0,0,0,5000,0,0,0,5000,0,5000,5000,2021-06-09
4241,089633,友達凱基13購02,0,0,0,0,0,0,0,0,0,5000,0,0,0,5000,0,5000,5000,2021-06-09
4242,089205,台灣50群益09購09,0,0,0,0,0,0,0,0,0,5000,0,0,0,5000,0,5000,5000,2021-06-09
4243,089251,英業達統一0B購04,0,0,0,0,0,0,0,0,0,5000,0,0,0,5000,0,5000,5000,2021-06-09
4244,089442,元大金群益09購01,0,0,0,0,0,0,0,0,0,5000,0,0,0,5000,0,5000,5000,2021-06-09
4245,089429,滬深2X群益09購11,0,0,0,0,0,0,0,0,0,5000,0,0,0,5000,0,5000,5000,2021-06-09
4246,089859,南電元大0B購03,0,0,0,0,0,0,0,0,0,5000,0,0,0,24000,19000,5000,5000,2021-06-09
4247,089821,申豐群益0B購01,0,0,0,0,0,0,0,0,0,5000,0,0,0,5000,0,5000,5000,2021-06-09
4248,089879,凌陽康和0A購01,0,0,0,0,0,0,0,0,0,5000,0,0,0,5000,0,5000,5000,2021-06-09
4249,089993,寶成元大0A購01,0,0,0,0,0,0,0,0,0,5000,0,0,0,5000,0,5000,5000,2021-06-09
4250,3308,聯德,15000,10000,5000,0,0,0,0,0,0,0,0,0,0,0,0,0,5000,2021-06-09
4251,2838A,聯邦銀甲特,0,4000,-4000,0,0,0,0,0,0,9000,9000,0,9000,0,0,0,5000,2021-06-09
4252,1720,生達,50000,45000,5000,0,0,0,0,0,0,0,0,0,0,0,0,0,5000,2021-06-09
4253,2002A,中鋼特,0,0,0,0,0,0,0,0,0,5000,5000,0,5000,0,0,0,5000,2021-06-09
4254,911868,同方友友-DR,13000,8000,5000,0,0,0,0,0,0,0,0,0,0,0,0,0,5000,2021-06-09
4255,6281,全國電,13000,8000,5000,0,0,0,0,0,0,0,0,0,0,0,0,0,5000,2021-06-09
4256,085780,聯電元大0C購03,0,0,0,0,0,0,0,0,0,4000,0,0,0,4000,0,4000,4000,2021-06-09
4257,085243,旺宏康和08購01,0,0,0,0,0,0,0,0,0,4000,0,0,0,4000,0,4000,4000,2021-06-09
4258,085459,聯詠元富09購04,0,0,0,0,0,0,0,0,0,4000,0,0,0,4000,0,4000,4000,2021-06-09
4259,085609,華邦電元大0C購01,0,0,0,0,0,0,0,0,0,4000,0,0,0,5000,1000,4000,4000,2021-06-09
4260,083554,臺股指元大07購20,0,0,0,0,0,0,0,0,0,4000,0,0,0,19000,15000,4000,4000,2021-06-09
4261,083540,貿聯元大07購07,0,0,0,0,0,0,0,0,0,4000,0,0,0,4000,0,4000,4000,2021-06-09
4262,083422,日月光永豐07購01,0,0,0,0,0,0,0,0,0,4000,0,0,0,4000,0,4000,4000,2021-06-09
4263,085054,友達國票08購09,0,0,0,0,0,0,0,0,0,4000,0,0,0,4000,0,4000,4000,2021-06-09
4264,084922,鴻海元大08購12,0,0,0,0,0,0,0,0,0,4000,0,0,0,4000,0,4000,4000,2021-06-09
4265,086822,統一元大09購01,0,0,0,0,0,0,0,0,0,4000,0,0,0,34000,30000,4000,4000,2021-06-09
4266,087004,和碩國泰0B購01,0,0,0,0,0,0,0,0,0,4000,0,0,0,10000,6000,4000,4000,2021-06-09
4267,087182,鴻海群益0C購02,0,0,0,0,0,0,0,0,0,4000,0,0,0,599000,595000,4000,4000,2021-06-09
4268,088554,滬深2X凱基0B購04,0,0,0,0,0,0,0,0,0,4000,0,0,0,24000,20000,4000,4000,2021-06-09
4269,088894,立積凱基09購01,0,0,0,0,0,0,0,0,0,4000,0,0,0,28000,24000,4000,4000,2021-06-09
4270,088137,信錦永豐09購01,0,0,0,0,0,0,0,0,0,4000,0,0,0,4000,0,4000,4000,2021-06-09
4271,087760,台光電富邦0B購01,0,0,0,0,0,0,0,0,0,4000,0,0,0,4000,0,4000,4000,2021-06-09
4272,089045,義隆群益0A購01,0,0,0,0,0,0,0,0,0,4000,0,0,0,22000,18000,4000,4000,2021-06-09
4273,00665L,富邦恒生國企正2,5000,2000,3000,0,0,0,0,0,0,1000,0,0,0,1000,0,1000,4000,2021-06-09
4274,030044,英業達元大0A購02,0,0,0,0,0,0,0,0,0,4000,0,0,0,4000,0,4000,4000,2021-06-09
4275,031508,友達元大0A購09,0,0,0,0,0,0,0,0,0,4000,0,0,0,4000,0,4000,4000,2021-06-09
4276,031206,中鋼凱基0B購01,0,0,0,0,0,0,0,0,0,4000,0,0,0,4000,0,4000,4000,2021-06-09
4277,031430,長榮凱基0A購14,0,0,0,0,0,0,0,0,0,4000,0,0,0,4000,0,4000,4000,2021-06-09
4278,031384,燁輝統一0B購01,0,0,0,0,0,0,0,0,0,4000,0,0,0,4000,0,4000,4000,2021-06-09
4279,031396,世紀鋼日盛0A購01,0,0,0,0,0,0,0,0,0,4000,0,0,0,4000,0,4000,4000,2021-06-09
4280,031362,彩晶中信0A購02,0,0,0,0,0,0,0,0,0,4000,0,0,0,4000,0,4000,4000,2021-06-09
4281,031350,華東元大0A購01,0,0,0,0,0,0,0,0,0,4000,0,0,0,4000,0,4000,4000,2021-06-09
4282,030134,長榮凱基14購01,0,0,0,0,0,0,0,0,0,4000,0,0,0,4000,0,4000,4000,2021-06-09
4283,030182,凌陽兆豐0B購01,0,0,0,0,0,0,0,0,0,4000,0,0,0,11000,7000,4000,4000,2021-06-09
4284,031166,道瓊指中信0C購02,0,0,0,0,0,0,0,0,0,4000,0,0,0,4000,0,4000,4000,2021-06-09
4285,033148,群創元大0A購26,0,0,0,0,0,0,0,0,0,4000,0,0,0,44000,40000,4000,4000,2021-06-09
4286,032636,長榮統一11購04,0,0,0,0,0,0,0,0,0,4000,0,0,0,4000,0,4000,4000,2021-06-09
4287,030869,精成科永豐0A購01,0,0,0,0,0,0,0,0,0,4000,0,0,0,35000,31000,4000,4000,2021-06-09
4288,05571P,金像電元大07售04,0,0,0,0,0,0,0,0,0,4000,0,0,0,4000,0,4000,4000,2021-06-09
4289,036269,元石油元大0C購02,0,0,0,0,0,0,0,0,0,4000,0,0,0,5000,1000,4000,4000,2021-06-09
4290,032479,友達第一14購01,0,0,0,0,0,0,0,0,0,4000,0,0,0,5000,1000,4000,4000,2021-06-09
4291,032499,中鋼永豐0A購07,0,0,0,0,0,0,0,0,0,4000,0,0,0,9000,5000,4000,4000,2021-06-09
4292,033597,金像電兆豐0C購01,0,0,0,0,0,0,0,0,0,4000,0,0,0,39000,35000,4000,4000,2021-06-09
4293,033270,華邦電富邦0B購01,0,0,0,0,0,0,0,0,0,4000,0,0,0,4000,0,4000,4000,2021-06-09
4294,032276,華邦電富邦0A購02,0,0,0,0,0,0,0,0,0,4000,0,0,0,4000,0,4000,4000,2021-06-09
4295,033003,長榮航元富0B購01,0,0,0,0,0,0,0,0,0,4000,0,0,0,4000,0,4000,4000,2021-06-09
4296,032848,聯發科永豐0A購04,0,0,0,0,0,0,0,0,0,4000,0,0,0,4000,0,4000,4000,2021-06-09
4297,036078,台達化元大12購01,0,0,0,0,0,0,0,0,0,4000,0,0,0,11000,7000,4000,4000,2021-06-09
4298,035091,長榮凱基11購03,0,0,0,0,0,0,0,0,0,4000,0,0,0,5000,1000,4000,4000,2021-06-09
4299,035087,燁輝凱基11購01,0,0,0,0,0,0,0,0,0,4000,0,0,0,4000,0,4000,4000,2021-06-09
4300,03511B,臺股指元大12熊02,0,0,0,0,0,0,0,0,0,4000,0,0,0,7000,3000,4000,4000,2021-06-09
4301,035235,萬海永豐0B購03,0,0,0,0,0,0,0,0,0,4000,0,0,0,10000,6000,4000,4000,2021-06-09
4302,035232,聯電永豐0B購01,0,0,0,0,0,0,0,0,0,4000,0,0,0,4000,0,4000,4000,2021-06-09
4303,035299,萬海富邦0C購04,0,0,0,0,0,0,0,0,0,4000,0,0,0,4000,0,4000,4000,2021-06-09
4304,035275,國喬國票11購01,0,0,0,0,0,0,0,0,0,4000,0,0,0,32000,28000,4000,4000,2021-06-09
4305,05768P,台灣50群益08售02,0,0,0,0,0,0,0,0,0,4000,0,0,0,4000,0,4000,4000,2021-06-09
4306,035982,美時國票11購01,0,0,0,0,0,0,0,0,0,4000,0,0,0,20000,16000,4000,4000,2021-06-09
4307,035823,聚陽元大0B購03,0,0,0,0,0,0,0,0,0,4000,0,0,0,4000,0,4000,4000,2021-06-09
4308,034829,鴻海元富12購09,0,0,0,0,0,0,0,0,0,4000,0,0,0,4000,0,4000,4000,2021-06-09
4309,034369,儒鴻元大0B購01,0,0,0,0,0,0,0,0,0,4000,0,0,0,5000,1000,4000,4000,2021-06-09
4310,034393,玉晶光元大0B購04,0,0,0,0,0,0,0,0,0,4000,0,0,0,200000,196000,4000,4000,2021-06-09
4311,034394,和碩元大0B購02,0,0,0,0,0,0,0,0,0,4000,0,0,0,26000,22000,4000,4000,2021-06-09
4312,034700,嘉聯益群益0B購03,0,0,0,0,0,0,0,0,0,4000,0,0,0,4000,0,4000,4000,2021-06-09
4313,034084,台積電元大0B購09,0,0,0,0,0,0,0,0,0,4000,0,0,0,173000,169000,4000,4000,2021-06-09
4314,034343,儒鴻元富0C購01,0,0,0,0,0,0,0,0,0,4000,0,0,0,26000,22000,4000,4000,2021-06-09
4315,033843,日月光兆豐0B購01,0,0,0,0,0,0,0,0,0,4000,0,0,0,5000,1000,4000,4000,2021-06-09
4316,06008P,聯發科群益07售04,0,0,0,0,0,0,0,0,0,4000,0,0,0,4000,0,4000,4000,2021-06-09
4317,033688,富邦金元大0B購02,0,0,0,0,0,0,0,0,0,4000,0,0,0,4000,0,4000,4000,2021-06-09
4318,033731,嘉澤國票0C購01,0,0,0,0,0,0,0,0,0,4000,0,0,0,12000,8000,4000,4000,2021-06-09
4319,034893,國巨凱基0B購08,0,0,0,0,0,0,0,0,0,4000,0,0,0,4000,0,4000,4000,2021-06-09
4320,06885P,臺股指群益0A售15,0,0,0,0,0,0,0,0,0,4000,0,0,0,4000,0,4000,4000,2021-06-09
4321,06875P,中鋼元富0A售02,0,0,0,0,0,0,0,0,0,4000,0,0,0,4000,0,4000,4000,2021-06-09
4322,07142P,台灣50元富0B售09,0,0,0,0,0,0,0,0,0,4000,0,0,0,5000,1000,4000,4000,2021-06-09
4323,07031P,中鋼日盛0B售03,0,0,0,0,0,0,0,0,0,4000,0,0,0,21000,17000,4000,4000,2021-06-09
4324,06605P,臺股指中信11售02,0,0,0,0,0,0,0,0,0,4000,0,0,0,4000,0,4000,4000,2021-06-09
4325,06588P,可成元富0C售02,0,0,0,0,0,0,0,0,0,4000,0,0,0,8000,4000,4000,4000,2021-06-09
4326,06729P,台灣50元富0B售07,0,0,0,0,0,0,0,0,0,4000,0,0,0,4000,0,4000,4000,2021-06-09
4327,06790P,臺股指凱基0A售08,0,0,0,0,0,0,0,0,0,4000,0,0,0,4000,0,4000,4000,2021-06-09
4328,06777P,大立光凱基0A售05,0,0,0,0,0,0,0,0,0,4000,0,0,0,16000,12000,4000,4000,2021-06-09
4329,075517,立積統一08購03,0,0,0,0,0,0,0,0,0,4000,0,0,0,14000,10000,4000,4000,2021-06-09
4330,076016,台積電元大08購02,0,0,0,0,0,0,0,0,0,4000,0,0,0,4000,0,4000,4000,2021-06-09
4331,077240,力麗元大06購01,0,0,0,0,0,0,0,0,0,4000,0,0,0,4000,0,4000,4000,2021-06-09
4332,078293,立積國票08購01,0,0,0,0,0,0,0,0,0,4000,0,0,0,12000,8000,4000,4000,2021-06-09
4333,079973,長榮群益06購07,0,0,0,0,0,0,0,0,0,4000,0,0,0,4000,0,4000,4000,2021-06-09
4334,080304,敬鵬群益06購01,0,0,0,0,0,0,0,0,0,4000,0,0,0,4000,0,4000,4000,2021-06-09
4335,080330,強茂凱基07購01,0,0,0,0,0,0,0,0,0,4000,0,0,0,5000,1000,4000,4000,2021-06-09
4336,079359,嘉晶凱基06購02,0,0,0,0,0,0,0,0,0,4000,0,0,0,4000,0,4000,4000,2021-06-09
4337,081224,長榮統一09購03,0,0,0,0,0,0,0,0,0,4000,0,0,0,4000,0,4000,4000,2021-06-09
4338,081055,潤泰全國票08購01,0,0,0,0,0,0,0,0,0,4000,0,0,0,4000,0,4000,4000,2021-06-09
4339,080721,金像電群益07購02,0,0,0,0,0,0,0,0,0,4000,0,0,0,10000,6000,4000,4000,2021-06-09
4340,083291,聯發科元大07購28,0,0,0,0,0,0,0,0,0,4000,0,0,0,4000,0,4000,4000,2021-06-09
4341,083215,聯詠統一09購02,0,0,0,0,0,0,0,0,0,4000,0,0,0,4000,0,4000,4000,2021-06-09
4342,083006,鴻海凱基0B購04,0,0,0,0,0,0,0,0,0,4000,0,0,0,4000,0,4000,4000,2021-06-09
4343,082996,臺股指元大08購09,0,0,0,0,0,0,0,0,0,4000,0,0,0,104000,100000,4000,4000,2021-06-09
4344,081627,台航元大07購02,0,0,0,0,0,0,0,0,0,4000,0,0,0,4000,0,4000,4000,2021-06-09
4345,081554,農林永豐07購01,0,0,0,0,0,0,0,0,0,4000,0,0,0,14000,10000,4000,4000,2021-06-09
4346,081572,鼎炫永豐07購01,0,0,0,0,0,0,0,0,0,4000,0,0,0,4000,0,4000,4000,2021-06-09
4347,081522,創意富邦08購01,0,0,0,0,0,0,0,0,0,4000,0,0,0,14000,10000,4000,4000,2021-06-09
4348,082388,上証2X凱基08購03,0,0,0,0,0,0,0,0,0,4000,0,0,0,4000,0,4000,4000,2021-06-09
4349,5525,順天,9000,5000,4000,0,0,0,0,0,0,0,0,0,0,0,0,0,4000,2021-06-09
4350,912398,友佳-DR,4000,0,4000,0,0,0,0,0,0,0,0,0,0,0,0,0,4000,2021-06-09
4351,8422,可寧衛,105000,101000,4000,0,0,0,0,0,0,0,0,0,0,0,0,0,4000,2021-06-09
4352,2891B,中信金乙特,0,0,0,0,0,0,0,0,0,4000,4000,0,4000,0,0,0,4000,2021-06-09
4353,3025,星通,161000,157000,4000,0,0,0,0,0,0,0,0,0,0,0,0,0,4000,2021-06-09
4354,3032,偉訓,60000,56000,4000,0,0,0,0,0,0,0,0,0,0,0,0,0,4000,2021-06-09
4355,3454,晶睿,13000,9000,4000,0,0,0,0,0,0,0,0,0,0,0,0,0,4000,2021-06-09
4356,3686,達能,191000,187000,4000,0,0,0,0,0,0,0,0,0,0,0,0,0,4000,2021-06-09
4357,5283,禾聯碩,13000,9000,4000,0,0,0,0,0,0,0,0,0,0,0,0,0,4000,2021-06-09
4358,4755,三福化,10000,6000,4000,0,0,0,0,0,0,0,0,0,0,0,0,0,4000,2021-06-09
4359,1101B,台泥乙特,0,0,0,0,0,0,0,0,0,4000,4000,0,4000,0,0,0,4000,2021-06-09
4360,089893,南電統一0C購01,0,0,0,0,0,0,0,0,0,4000,0,0,0,4000,0,4000,4000,2021-06-09
4361,1473,台南,16000,12000,4000,0,0,0,0,0,0,0,0,0,0,0,0,0,4000,2021-06-09
4362,1323,永裕,5000,1000,4000,0,0,0,0,0,0,0,0,0,0,0,0,0,4000,2021-06-09
4363,089050,上証2X永豐09購02,0,0,0,0,0,0,0,0,0,3000,0,0,0,3000,0,3000,3000,2021-06-09
4364,087863,景碩富邦09購01,0,0,0,0,0,0,0,0,0,3000,0,0,0,3000,0,3000,3000,2021-06-09
4365,088639,燿華國票09購01,0,0,0,0,0,0,0,0,0,3000,0,0,0,3000,0,3000,3000,2021-06-09
4366,088461,滬深2X元富09購09,0,0,0,0,0,0,0,0,0,3000,0,0,0,203000,200000,3000,3000,2021-06-09
4367,088475,鴻海國票13購04,0,0,0,0,0,0,0,0,0,3000,0,0,0,3000,0,3000,3000,2021-06-09
4368,087206,台達化凱基09購01,0,0,0,0,0,0,0,0,0,3000,0,0,0,35000,32000,3000,3000,2021-06-09
4369,087669,上証2X元大0A購01,0,0,0,0,0,0,0,0,0,3000,0,0,0,3000,0,3000,3000,2021-06-09
4370,087674,榮成元大09購02,0,0,0,0,0,0,0,0,0,3000,0,0,0,3000,0,3000,3000,2021-06-09
4371,087388,宏碁元大0B購02,0,0,0,0,0,0,0,0,0,3000,0,0,0,13000,10000,3000,3000,2021-06-09
4372,086477,聚陽統一0B購01,0,0,0,0,0,0,0,0,0,3000,0,0,0,3000,0,3000,3000,2021-06-09
4373,086438,矽創中信09購01,0,0,0,0,0,0,0,0,0,3000,0,0,0,3000,0,3000,3000,2021-06-09
4374,086685,玉晶光統一0B購03,0,0,0,0,0,0,0,0,0,3000,0,0,0,3000,0,3000,3000,2021-06-09
4375,084391,台灣50台新08購01,0,0,0,0,0,0,0,0,0,3000,0,0,0,3000,0,3000,3000,2021-06-09
4376,084436,緯創群益08購02,0,0,0,0,0,0,0,0,0,3000,0,0,0,3000,0,3000,3000,2021-06-09
4377,084328,香港2X元大07購01,0,0,0,0,0,0,0,0,0,3000,0,0,0,3000,0,3000,3000,2021-06-09
4378,083489,國巨元富11購01,0,0,0,0,0,0,0,0,0,3000,0,0,0,3000,0,3000,3000,2021-06-09
4379,083588,金寶國票08購01,0,0,0,0,0,0,0,0,0,3000,0,0,0,13000,10000,3000,3000,2021-06-09
4380,083972,矽創凱基09購01,0,0,0,0,0,0,0,0,0,3000,0,0,0,3000,0,3000,3000,2021-06-09
4381,085102,瀚宇博凱基08購01,0,0,0,0,0,0,0,0,0,3000,0,0,0,3000,0,3000,3000,2021-06-09
4382,085067,祥碩群益09購01,0,0,0,0,0,0,0,0,0,3000,0,0,0,3000,0,3000,3000,2021-06-09
4383,085134,玉晶光統一0A購04,0,0,0,0,0,0,0,0,0,3000,0,0,0,3000,0,3000,3000,2021-06-09
4384,085760,廣宇日盛08購01,0,0,0,0,0,0,0,0,0,3000,0,0,0,3000,0,3000,3000,2021-06-09
4385,085849,旺宏統一0A購02,0,0,0,0,0,0,0,0,0,3000,0,0,0,3000,0,3000,3000,2021-06-09
4386,085943,聯陽群益0A購01,0,0,0,0,0,0,0,0,0,3000,0,0,0,3000,0,3000,3000,2021-06-09
4387,086115,大亞群益08購02,0,0,0,0,0,0,0,0,0,3000,0,0,0,3000,0,3000,3000,2021-06-09
4388,086119,中橡群益08購02,0,0,0,0,0,0,0,0,0,3000,0,0,0,3000,0,3000,3000,2021-06-09
4389,086287,京鼎群益0B購01,0,0,0,0,0,0,0,0,0,3000,0,0,0,3000,0,3000,3000,2021-06-09
4390,086290,盛群群益09購01,0,0,0,0,0,0,0,0,0,3000,0,0,0,3000,0,3000,3000,2021-06-09
4391,032860,友達群益0A購07,0,0,0,0,0,0,0,0,0,3000,0,0,0,3000,0,3000,3000,2021-06-09
4392,033059,富邦金永豐0A購02,0,0,0,0,0,0,0,0,0,3000,0,0,0,3000,0,3000,3000,2021-06-09
4393,033027,潤泰全國泰0C購01,0,0,0,0,0,0,0,0,0,3000,0,0,0,18000,15000,3000,3000,2021-06-09
4394,032328,中鋼群益14購01,0,0,0,0,0,0,0,0,0,3000,0,0,0,3000,0,3000,3000,2021-06-09
4395,032445,國泰金元大0C購02,0,0,0,0,0,0,0,0,0,3000,0,0,0,3000,0,3000,3000,2021-06-09
4396,032111,台表科永豐0A購01,0,0,0,0,0,0,0,0,0,3000,0,0,0,152000,149000,3000,3000,2021-06-09
4397,032094,大亞永豐0A購02,0,0,0,0,0,0,0,0,0,3000,0,0,0,3000,0,3000,3000,2021-06-09
4398,036235,永豐餘第一16購01,0,0,0,0,0,0,0,0,0,3000,0,0,0,40000,37000,3000,3000,2021-06-09
4399,034274,中鋼富邦0C購01,0,0,0,0,0,0,0,0,0,3000,0,0,0,23000,20000,3000,3000,2021-06-09
4400,032597,長榮元大0C購07,0,0,0,0,0,0,0,0,0,3000,0,0,0,3000,0,3000,3000,2021-06-09
4401,031321,永豐餘元大0A購02,0,0,0,0,0,0,0,0,0,3000,0,0,0,3000,0,3000,3000,2021-06-09
4402,031572,台揚凱基0B購01,0,0,0,0,0,0,0,0,0,3000,0,0,0,3000,0,3000,3000,2021-06-09
4403,030824,中鋼中信0B購02,0,0,0,0,0,0,0,0,0,3000,0,0,0,3000,0,3000,3000,2021-06-09
4404,030722,正隆元大0A購01,0,0,0,0,0,0,0,0,0,3000,0,0,0,8000,5000,3000,3000,2021-06-09
4405,031034,義隆凱基0A購02,0,0,0,0,0,0,0,0,0,3000,0,0,0,3000,0,3000,3000,2021-06-09
4406,031050,光磊元大0A購01,0,0,0,0,0,0,0,0,0,3000,0,0,0,8000,5000,3000,3000,2021-06-09
4407,030101,新興永豐0A購01,0,0,0,0,0,0,0,0,0,3000,0,0,0,3000,0,3000,3000,2021-06-09
4408,030529,道瓊銀凱基0C購01,0,0,0,0,0,0,0,0,0,3000,0,0,0,3000,0,3000,3000,2021-06-09
4409,030478,正隆永豐0A購01,0,0,0,0,0,0,0,0,0,3000,0,0,0,8000,5000,3000,3000,2021-06-09
4410,031234,南紡群益0A購04,0,0,0,0,0,0,0,0,0,3000,0,0,0,3000,0,3000,3000,2021-06-09
4411,031220,智原凱基0A購01,0,0,0,0,0,0,0,0,0,3000,0,0,0,3000,0,3000,3000,2021-06-09
4412,030083,超眾群益11購02,0,0,0,0,0,0,0,0,0,3000,0,0,0,5000,2000,3000,3000,2021-06-09
4413,030267,宏全永豐0A購01,0,0,0,0,0,0,0,0,0,3000,0,0,0,3000,0,3000,3000,2021-06-09
4414,030414,長榮元大11購01,0,0,0,0,0,0,0,0,0,3000,0,0,0,3000,0,3000,3000,2021-06-09
4415,034770,長榮國票0C購03,0,0,0,0,0,0,0,0,0,3000,0,0,0,3000,0,3000,3000,2021-06-09
4416,034255,裕民統一11購01,0,0,0,0,0,0,0,0,0,3000,0,0,0,48000,45000,3000,3000,2021-06-09
4417,034073,SGBR2X元大0B購01,0,0,0,0,0,0,0,0,0,3000,0,0,0,3000,0,3000,3000,2021-06-09
4418,034197,友達元大0C購12,0,0,0,0,0,0,0,0,0,3000,0,0,0,123000,120000,3000,3000,2021-06-09
4419,034199,開發金元大0B購03,0,0,0,0,0,0,0,0,0,3000,0,0,0,3000,0,3000,3000,2021-06-09
4420,034617,國巨元富12購07,0,0,0,0,0,0,0,0,0,3000,0,0,0,3000,0,3000,3000,2021-06-09
4421,034554,滬深2X富邦0C購02,0,0,0,0,0,0,0,0,0,3000,0,0,0,3000,0,3000,3000,2021-06-09
4422,034558,台塑國泰11購01,0,0,0,0,0,0,0,0,0,3000,0,0,0,3000,0,3000,3000,2021-06-09
4423,034530,聯發科麥證0C購04,0,0,0,3000,0,3000,0,0,0,3000,0,0,0,3000,0,3000,3000,2021-06-09
4424,034850,中鋼構元大0C購01,0,0,0,0,0,0,0,0,0,3000,0,0,0,3000,0,3000,3000,2021-06-09
4425,034819,玉晶光群益0C購05,0,0,0,0,0,0,0,0,0,3000,0,0,0,10000,7000,3000,3000,2021-06-09
4426,034854,長榮元大0B購18,0,0,0,0,0,0,0,0,0,3000,0,0,0,3000,0,3000,3000,2021-06-09
4427,034290,中鋼中信0B購03,0,0,0,0,0,0,0,0,0,3000,0,0,0,8000,5000,3000,3000,2021-06-09
4428,035698,華夏元大0B購04,0,0,0,0,0,0,0,0,0,3000,0,0,0,3000,0,3000,3000,2021-06-09
4429,035170,長榮國票12購02,0,0,0,0,0,0,0,0,0,3000,0,0,0,141000,138000,3000,3000,2021-06-09
4430,036056,和桐群益11購01,0,0,0,0,0,0,0,0,0,3000,0,0,0,116000,113000,3000,3000,2021-06-09
4431,05086P,聯電兆豐06售06,0,0,0,0,0,0,0,0,0,3000,0,0,0,3000,0,3000,3000,2021-06-09
4432,04831P,玉晶光元富0B售01,0,0,0,0,0,0,0,0,0,3000,0,0,0,3000,0,3000,3000,2021-06-09
4433,04710P,T50正2中信0B售01,0,0,0,0,0,0,0,0,0,3000,0,0,0,3000,0,3000,3000,2021-06-09
4434,082280,金像電元大07購08,0,0,0,0,0,0,0,0,0,3000,0,0,0,3000,0,3000,3000,2021-06-09
4435,082064,S&P反1元大07購03,0,0,0,0,0,0,0,0,0,3000,0,0,0,3000,0,3000,3000,2021-06-09
4436,081495,榮運凱基07購01,0,0,0,0,0,0,0,0,0,3000,0,0,0,3000,0,3000,3000,2021-06-09
4437,081544,立隆電永豐07購01,0,0,0,0,0,0,0,0,0,3000,0,0,0,3000,0,3000,3000,2021-06-09
4438,081696,鴻海日盛09購01,0,0,0,0,0,0,0,0,0,3000,0,0,0,13000,10000,3000,3000,2021-06-09
4439,081814,台達電凱基08購01,0,0,0,0,0,0,0,0,0,3000,0,0,0,3000,0,3000,3000,2021-06-09
4440,081803,中鋼凱基09購01,0,0,0,0,0,0,0,0,0,3000,0,0,0,3000,0,3000,3000,2021-06-09
4441,082740,欣興群益09購01,0,0,0,0,0,0,0,0,0,3000,0,0,0,5000,2000,3000,3000,2021-06-09
4442,082532,國巨日盛11購01,0,0,0,0,0,0,0,0,0,3000,0,0,0,3000,0,3000,3000,2021-06-09
4443,082546,日月光凱基08購03,0,0,0,0,0,0,0,0,0,3000,0,0,0,3000,0,3000,3000,2021-06-09
4444,080686,長榮富邦07購01,0,0,0,0,0,0,0,0,0,3000,0,0,0,3000,0,3000,3000,2021-06-09
4445,080812,和碩凱基06購01,0,0,0,0,0,0,0,0,0,3000,0,0,0,3000,0,3000,3000,2021-06-09
4446,081044,智原富邦07購01,0,0,0,0,0,0,0,0,0,3000,0,0,0,3000,0,3000,3000,2021-06-09
4447,081367,潤泰新凱基08購01,0,0,0,0,0,0,0,0,0,3000,0,0,0,3000,0,3000,3000,2021-06-09
4448,081309,長榮元大07購07,0,0,0,0,0,0,0,0,0,3000,0,0,0,3000,0,3000,3000,2021-06-09
4449,081251,長榮國票08購03,0,0,0,0,0,0,0,0,0,3000,0,0,0,8000,5000,3000,3000,2021-06-09
4450,081252,材料國票08購01,0,0,0,0,0,0,0,0,0,3000,0,0,0,3000,0,3000,3000,2021-06-09
4451,081221,聯發科統一09購02,0,0,0,0,0,0,0,0,0,3000,0,0,0,3000,0,3000,3000,2021-06-09
4452,079272,台積電國票09購04,0,0,0,0,0,0,0,0,0,3000,0,0,0,13000,10000,3000,3000,2021-06-09
4453,079549,聯發科群益07購01,0,0,0,0,0,0,0,0,0,3000,0,0,0,3000,0,3000,3000,2021-06-09
4454,079844,欣興元大06購05,0,0,0,0,0,0,0,0,0,3000,0,0,0,3000,0,3000,3000,2021-06-09
4455,079008,上緯控凱基08購01,0,0,0,0,0,0,0,0,0,3000,0,0,0,3000,0,3000,3000,2021-06-09
4456,078933,禾伸堂永豐06購01,0,0,0,0,0,0,0,0,0,3000,0,0,0,3000,0,3000,3000,2021-06-09
4457,076986,世芯元大07購01,0,0,0,0,0,0,0,0,0,3000,0,0,0,3000,0,3000,3000,2021-06-09
4458,076795,台積電國票06購05,0,0,0,0,0,0,0,0,0,3000,0,0,0,3000,0,3000,3000,2021-06-09
4459,075524,台表科元富0B購01,0,0,0,0,0,0,0,0,0,3000,0,0,0,3000,0,3000,3000,2021-06-09
4460,075561,國巨元大07購02,0,0,0,0,0,0,0,0,0,3000,0,0,0,3000,0,3000,3000,2021-06-09
4461,073398,國巨元富07購24,0,0,0,0,0,0,0,0,0,3000,0,0,0,3000,0,3000,3000,2021-06-09
4462,072903,聯強凱基07購01,0,0,0,0,0,0,0,0,0,3000,0,0,0,3000,0,3000,3000,2021-06-09
4463,071892,國喬元富09購02,0,0,0,0,0,0,0,0,0,3000,0,0,0,3000,0,3000,3000,2021-06-09
4464,06552P,台灣50群益0A售04,0,0,0,0,0,0,0,0,0,3000,0,0,0,39000,36000,3000,3000,2021-06-09
4465,06559P,台積電統一0A售10,0,0,0,0,0,0,0,0,0,3000,0,0,0,3000,0,3000,3000,2021-06-09
4466,06392P,台積電凱基08售35,0,0,0,0,0,0,0,0,0,3000,0,0,0,3000,0,3000,3000,2021-06-09
4467,06397P,大立光中信08售03,0,0,0,0,0,0,0,0,0,3000,0,0,0,3000,0,3000,3000,2021-06-09
4468,06489P,臺股指元大0A售20,0,0,0,0,0,0,0,0,0,3000,0,0,0,3000,0,3000,3000,2021-06-09
4469,07040P,聯發科統一0C售05,0,0,0,0,0,0,0,0,0,3000,0,0,0,10000,7000,3000,3000,2021-06-09
4470,07030P,臺股指群益0B售02,0,0,0,0,0,0,0,0,0,3000,0,0,0,76000,73000,3000,3000,2021-06-09
4471,07086P,T50反1元富12售09,0,0,0,0,0,0,0,0,0,3000,0,0,0,3000,0,3000,3000,2021-06-09
4472,07161P,大立光凱基0B售05,0,0,0,0,0,0,0,0,0,3000,0,0,0,3000,0,3000,3000,2021-06-09
4473,06856P,中石化中信0A售02,0,0,0,0,0,0,0,0,0,3000,0,0,0,45000,42000,3000,3000,2021-06-09
4474,083339,漢唐統一09購01,0,0,0,0,0,0,0,0,0,3000,0,0,0,3000,0,3000,3000,2021-06-09
4475,083308,欣興元大07購12,0,0,0,0,0,0,0,0,0,3000,0,0,0,40000,37000,3000,3000,2021-06-09
4476,083330,國巨統一08購05,4000,1000,3000,0,0,0,0,0,0,0,0,0,0,30000,30000,0,3000,2021-06-09
4477,1475,業旺,3000,0,3000,0,0,0,0,0,0,0,0,0,0,0,0,0,3000,2021-06-09
4478,1529,樂士,10000,7000,3000,0,0,0,0,0,0,0,0,0,0,0,0,0,3000,2021-06-09
4479,089896,台揚凱基11購01,0,0,0,0,0,0,0,0,0,3000,0,0,0,3000,0,3000,3000,2021-06-09
4480,089857,晶碩元大09購05,0,0,0,0,0,0,0,0,0,3000,0,0,0,463000,460000,3000,3000,2021-06-09
4481,089419,東鋼永豐09購02,0,0,0,0,0,0,0,0,0,3000,0,0,0,3000,0,3000,3000,2021-06-09
4482,089623,東鋼凱基09購04,0,0,0,0,0,0,0,0,0,3000,0,0,0,3000,0,3000,3000,2021-06-09
4483,3705,永信,24000,21000,3000,0,0,0,0,0,0,0,0,0,0,0,0,0,3000,2021-06-09
4484,2881B,富邦金乙特,0,0,0,0,0,0,0,0,0,3000,3000,0,3000,0,0,0,3000,2021-06-09
4485,2450,神腦,23000,20000,3000,0,0,0,0,0,0,0,0,0,0,0,0,0,3000,2021-06-09
4486,2397,友通,11000,8000,3000,0,0,0,0,0,0,0,0,0,0,0,0,0,3000,2021-06-09
4487,2540,愛山林,23000,23000,0,0,0,0,0,0,0,3000,3000,0,3000,0,0,0,3000,2021-06-09
4488,6120,達運,345000,351000,-6000,0,0,0,0,0,0,9000,0,0,0,9000,0,9000,3000,2021-06-09
4489,6625,必應,7000,4000,3000,0,0,0,0,0,0,0,0,0,0,0,0,0,3000,2021-06-09
4490,01003T,兆豐新光R1,2980,0,2980,0,0,0,0,0,0,0,0,0,0,0,0,0,2980,2021-06-09
4491,3376,新日興,72425,71000,1425,0,0,0,0,0,0,1000,0,0,0,3000,2000,1000,2425,2021-06-09
4492,2207,和泰車,130700,126400,4300,0,0,0,0,0,0,-2002,0,2002,-2002,0,0,0,2298,2021-06-09
4493,085979,聚陽元大08購01,0,0,0,0,0,0,0,0,0,2000,0,0,0,2000,0,2000,2000,2021-06-09
4494,085981,聯電元大0C購05,0,0,0,0,0,0,0,0,0,2000,0,0,0,6000,4000,2000,2000,2021-06-09
4495,085605,台橡元大08購01,0,0,0,0,0,0,0,0,0,2000,0,0,0,2000,0,2000,2000,2021-06-09
4496,085590,南電兆豐08購01,0,0,0,0,0,0,0,0,0,2000,0,0,0,12000,10000,2000,2000,2021-06-09
4497,085473,聯發科麥證0C購02,0,0,0,2000,0,2000,0,0,0,2000,0,0,0,2000,0,2000,2000,2021-06-09
4498,085448,A50正2元富0B購01,0,0,0,0,0,0,0,0,0,2000,0,0,0,3000,1000,2000,2000,2021-06-09
4499,084133,永冠永豐07購01,0,0,0,0,0,0,0,0,0,2000,0,0,0,2000,0,2000,2000,2021-06-09
4500,083635,晶技凱基07購02,0,0,0,0,0,0,0,0,0,2000,0,0,0,2000,0,2000,2000,2021-06-09
4501,084303,華城凱基07購01,0,0,0,0,0,0,0,0,0,2000,0,0,0,2000,0,2000,2000,2021-06-09
4502,084610,宏碁兆豐08購01,0,0,0,0,0,0,0,0,0,2000,0,0,0,2000,0,2000,2000,2021-06-09
4503,084696,宏碁統一0A購01,0,0,0,0,0,0,0,0,0,2000,0,0,0,19000,17000,2000,2000,2021-06-09
4504,087009,精英富邦0B購01,0,0,0,0,0,0,0,0,0,2000,0,0,0,2000,0,2000,2000,2021-06-09
4505,087401,聯詠元大0B購01,0,0,0,0,0,0,0,0,0,2000,0,0,0,2000,0,2000,2000,2021-06-09
4506,087546,國喬元富09購03,0,0,0,0,0,0,0,0,0,2000,0,0,0,2000,0,2000,2000,2021-06-09
4507,087581,微星元大0B購01,0,0,0,0,0,0,0,0,0,2000,0,0,0,2000,0,2000,2000,2021-06-09
4508,087209,聯電凱基09購06,0,0,0,0,0,0,0,0,0,2000,0,0,0,2000,0,2000,2000,2021-06-09
4509,087169,台積電康和0A購02,0,0,0,0,0,0,0,0,0,2000,0,0,0,2000,0,2000,2000,2021-06-09
4510,087107,宏碁元大0B購01,0,0,0,0,0,0,0,0,0,2000,0,0,0,6000,4000,2000,2000,2021-06-09
4511,088502,友達元大09購15,0,0,0,0,0,0,0,0,0,2000,0,0,0,12000,10000,2000,2000,2021-06-09
4512,088503,京元電元大0B購01,0,0,0,0,0,0,0,0,0,2000,0,0,0,2000,0,2000,2000,2021-06-09
4513,088590,聯陽統一0B購03,0,0,0,0,0,0,0,0,0,2000,0,0,0,12000,10000,2000,2000,2021-06-09
4514,088538,華新科中信09購02,0,0,0,0,0,0,0,0,0,2000,0,0,0,2000,0,2000,2000,2021-06-09
4515,088757,和碩統一0B購01,0,0,0,0,0,0,0,0,0,2000,0,0,0,2000,0,2000,2000,2021-06-09
4516,087856,兆豐金國票0A購01,0,0,0,0,0,0,0,0,0,2000,0,0,0,2000,0,2000,2000,2021-06-09
4517,087940,祥碩統一0C購01,0,0,0,0,0,0,0,0,0,2000,0,0,0,2000,0,2000,2000,2021-06-09
4518,087926,國巨統一0B購03,0,0,0,0,0,0,0,0,0,2000,0,0,0,2000,0,2000,2000,2021-06-09
4519,087955,臻鼎元富0C購01,0,0,0,0,0,0,0,0,0,2000,0,0,0,2000,0,2000,2000,2021-06-09
4520,087794,百和永豐09購01,0,0,0,0,0,0,0,0,0,2000,0,0,0,6000,4000,2000,2000,2021-06-09
4521,087757,元石油富邦0B購02,0,0,0,0,0,0,0,0,0,2000,0,0,0,7000,5000,2000,2000,2021-06-09
4522,088145,圓展永豐09購02,0,0,0,0,0,0,0,0,0,2000,0,0,0,12000,10000,2000,2000,2021-06-09
4523,088329,技嘉元大0C購01,0,0,0,0,0,0,0,0,0,2000,0,0,0,2000,0,2000,2000,2021-06-09
4524,00640L,富邦日本正2,0,0,0,0,0,0,0,0,0,2000,0,0,0,217000,215000,2000,2000,2021-06-09
4525,00736,國泰新興市場,1000,0,1000,0,0,0,0,0,0,1000,0,0,0,102000,101000,1000,2000,2021-06-09
4526,00688L,國泰20年美債正2,2000,0,2000,0,0,0,0,0,0,0,0,0,0,50000,50000,0,2000,2021-06-09
4527,030442,復盛元大0A購01,0,0,0,0,0,0,0,0,0,2000,0,0,0,2000,0,2000,2000,2021-06-09
4528,031262,彩晶群益0A購02,0,0,0,0,0,0,0,0,0,2000,0,0,0,2000,0,2000,2000,2021-06-09
4529,031389,長榮統一0B購08,0,0,0,0,0,0,0,0,0,2000,0,0,0,65000,63000,2000,2000,2021-06-09
4530,031458,宏碁群益0B購02,0,0,0,0,0,0,0,0,0,2000,0,0,0,2000,0,2000,2000,2021-06-09
4531,030500,晶技兆豐0B購01,0,0,0,0,0,0,0,0,0,2000,0,0,0,80000,78000,2000,2000,2021-06-09
4532,031110,長榮航群益0B購01,0,0,0,0,0,0,0,0,0,2000,0,0,0,2000,0,2000,2000,2021-06-09
4533,030732,旺宏元大0A購02,0,0,0,0,0,0,0,0,0,2000,0,0,0,2000,0,2000,2000,2021-06-09
4534,031178,泰豐永豐0A購02,0,0,0,0,0,0,0,0,0,2000,0,0,0,2000,0,2000,2000,2021-06-09
4535,032669,國泰金富邦0C購01,0,0,0,0,0,0,0,0,0,2000,0,0,0,2000,0,2000,2000,2021-06-09
4536,030831,華新科中信0C購01,0,0,0,0,0,0,0,0,0,2000,0,0,0,12000,10000,2000,2000,2021-06-09
4537,031334,長榮元大0A購16,0,0,0,0,0,0,0,0,0,2000,0,0,0,2000,0,2000,2000,2021-06-09
4538,031297,彩晶康和0A購01,0,0,0,0,0,0,0,0,0,2000,0,0,0,4000,2000,2000,2000,2021-06-09
4539,030615,長榮元大0A購10,0,0,0,0,0,0,0,0,0,2000,0,0,0,2000,0,2000,2000,2021-06-09
4540,030899,中鴻凱基0B購02,0,0,0,0,0,0,0,0,0,2000,0,0,0,2000,0,2000,2000,2021-06-09
4541,031777,上銀日盛0A購01,0,0,0,0,0,0,0,0,0,2000,0,0,0,2000,0,2000,2000,2021-06-09
4542,032629,允強統一0C購01,0,0,0,0,0,0,0,0,0,2000,0,0,0,2000,0,2000,2000,2021-06-09
4543,05636P,臺股指中信0B售03,0,0,0,0,0,0,0,0,0,2000,0,0,0,2000,0,2000,2000,2021-06-09
4544,036212,永豐餘國泰12購01,0,0,0,0,0,0,0,0,0,2000,0,0,0,2000,0,2000,2000,2021-06-09
4545,05667P,鴻海中信07售05,0,0,0,0,0,0,0,0,0,2000,0,0,0,2000,0,2000,2000,2021-06-09
4546,031906,新光鋼永豐0A購03,0,0,0,0,0,0,0,0,0,2000,0,0,0,2000,0,2000,2000,2021-06-09
4547,031983,南紡群益0C購01,0,0,0,0,0,0,0,0,0,2000,0,0,0,2000,0,2000,2000,2021-06-09
4548,032151,萬海凱基0B購02,0,0,0,0,0,0,0,0,0,2000,0,0,0,2000,0,2000,2000,2021-06-09
4549,033304,中信金國泰11購01,0,0,0,0,0,0,0,0,0,2000,0,0,0,5000,3000,2000,2000,2021-06-09
4550,033033,新光金群益0B購04,0,0,0,0,0,0,0,0,0,2000,0,0,0,2000,0,2000,2000,2021-06-09
4551,033555,台航中信0B購01,0,0,0,0,0,0,0,0,0,2000,0,0,0,2000,0,2000,2000,2021-06-09
4552,032441,長榮元大0A購24,0,0,0,0,0,0,0,0,0,2000,0,0,0,2000,0,2000,2000,2021-06-09
4553,031888,台航凱基11購01,0,0,0,0,0,0,0,0,0,2000,0,0,0,2000,0,2000,2000,2021-06-09
4554,033365,矽創群益0B購05,0,0,0,0,0,0,0,0,0,2000,0,0,0,194000,192000,2000,2000,2021-06-09
4555,033361,聯發科群益0B購03,0,0,0,0,0,0,0,0,0,2000,0,0,0,2000,0,2000,2000,2021-06-09
4556,04793P,T50正2國票09售01,0,0,0,0,0,0,0,0,0,2000,0,0,0,2000,0,2000,2000,2021-06-09
4557,05168P,宏碁元富0C售02,0,0,0,0,0,0,0,0,0,2000,0,0,0,2000,0,2000,2000,2021-06-09
4558,05208P,聯電凱基07售04,0,0,0,0,0,0,0,0,0,2000,0,0,0,2000,0,2000,2000,2021-06-09
4559,035250,台聚凱基11購01,0,0,0,0,0,0,0,0,0,2000,0,0,0,2000,0,2000,2000,2021-06-09
4560,034009,可成群益11購01,0,0,0,0,0,0,0,0,0,2000,0,0,0,69000,67000,2000,2000,2021-06-09
4561,034563,旺宏國泰11購01,0,0,0,0,0,0,0,0,0,2000,0,0,0,10000,8000,2000,2000,2021-06-09
4562,034517,大亞元富0B購02,0,0,0,0,0,0,0,0,0,2000,0,0,0,2000,0,2000,2000,2021-06-09
4563,034606,榮運統一0B購02,0,0,0,0,0,0,0,0,0,2000,0,0,0,53000,51000,2000,2000,2021-06-09
4564,034165,華新科永豐0B購01,0,0,0,0,0,0,0,0,0,2000,0,0,0,203000,201000,2000,2000,2021-06-09
4565,034109,華邦電群益0B購06,0,0,0,0,0,0,0,0,0,2000,0,0,0,2000,0,2000,2000,2021-06-09
4566,034103,新光鋼群益0B購04,0,0,0,0,0,0,0,0,0,2000,0,0,0,5000,3000,2000,2000,2021-06-09
4567,034266,禾伸堂國票0C購01,0,0,0,0,0,0,0,0,0,2000,0,0,0,2000,0,2000,2000,2021-06-09
4568,05879P,台積電群益07售11,0,0,0,0,0,0,0,0,0,2000,0,0,0,2000,0,2000,2000,2021-06-09
4569,034936,永豐餘群益11購01,0,0,0,0,0,0,0,0,0,2000,0,0,0,2000,0,2000,2000,2021-06-09
4570,05902P,臺股指中信0A售04,0,0,0,0,0,0,0,0,0,2000,0,0,0,10000,8000,2000,2000,2021-06-09
4571,033738,臺股指國票0B購11,0,0,0,0,0,0,0,0,0,2000,0,0,0,2000,0,2000,2000,2021-06-09
4572,033697,元翎元大0B購01,0,0,0,0,0,0,0,0,0,2000,0,0,0,2000,0,2000,2000,2021-06-09
4573,06178P,台灣50元富0B售04,0,0,0,0,0,0,0,0,0,2000,0,0,0,2000,0,2000,2000,2021-06-09
4574,05938P,台積電凱基0A售06,0,0,0,0,0,0,0,0,0,2000,0,0,0,7000,5000,2000,2000,2021-06-09
4575,035596,華邦電元大0C購06,0,0,0,0,0,0,0,0,0,2000,0,0,0,4000,2000,2000,2000,2021-06-09
4576,06461P,台積電兆豐0A售01,0,0,0,0,0,0,0,0,0,2000,0,0,0,2000,0,2000,2000,2021-06-09
4577,06511P,台積電國票0A售05,0,0,0,0,0,0,0,0,0,2000,0,0,0,2000,0,2000,2000,2021-06-09
4578,06540P,臺股指凱基09售26,0,0,0,0,0,0,0,0,0,2000,0,0,0,2000,0,2000,2000,2021-06-09
4579,068032,大毅元富07購01,0,0,0,0,0,0,0,0,0,2000,0,0,0,2000,0,2000,2000,2021-06-09
4580,06710P,臺股指元大09售19,0,0,0,0,0,0,0,0,0,2000,0,0,0,2000,0,2000,2000,2021-06-09
4581,07258P,T50正2群益0B售02,0,0,0,0,0,0,0,0,0,2000,0,0,0,7000,5000,2000,2000,2021-06-09
4582,07236P,臺股指群益0B售11,0,0,0,0,0,0,0,0,0,2000,0,0,0,2000,0,2000,2000,2021-06-09
4583,072837,聯強元大07購01,0,0,0,0,0,0,0,0,0,2000,0,0,0,4000,2000,2000,2000,2021-06-09
4584,076613,南亞科國票07購01,0,0,0,0,0,0,0,0,0,2000,0,0,0,5000,3000,2000,2000,2021-06-09
4585,076633,台積電元大07購03,0,0,0,0,0,0,0,0,0,2000,0,0,0,2000,0,2000,2000,2021-06-09
4586,077031,世芯凱基07購01,0,0,0,0,0,0,0,0,0,2000,0,0,0,2000,0,2000,2000,2021-06-09
4587,078090,強茂統一07購01,0,0,0,0,0,0,0,0,0,2000,0,0,0,2000,0,2000,2000,2021-06-09
4588,078269,國巨國票09購01,0,0,0,0,0,0,0,0,0,2000,0,0,0,2000,0,2000,2000,2021-06-09
4589,079478,欣興兆豐07購01,0,0,0,0,0,0,0,0,0,2000,0,0,0,2000,0,2000,2000,2021-06-09
4590,079564,寶齡國票08購01,0,0,0,0,0,0,0,0,0,2000,0,0,0,2000,0,2000,2000,2021-06-09
4591,079431,長榮航統一06購01,0,0,0,0,0,0,0,0,0,2000,0,0,0,2000,0,2000,2000,2021-06-09
4592,080331,華新科凱基06購09,0,0,0,0,0,0,0,0,0,2000,0,0,0,2000,0,2000,2000,2021-06-09
4593,080339,盛群凱基06購01,0,0,0,0,0,0,0,0,0,2000,0,0,0,2000,0,2000,2000,2021-06-09
4594,080287,康那香永豐06購01,0,0,0,0,0,0,0,0,0,2000,0,0,0,2000,0,2000,2000,2021-06-09
4595,080515,世紀鋼元大06購07,0,0,0,0,0,0,0,0,0,2000,0,0,0,2000,0,2000,2000,2021-06-09
4596,080444,強茂中信06購01,0,0,0,0,0,0,0,0,0,2000,0,0,0,2000,0,2000,2000,2021-06-09
4597,080447,大成凱基09購01,0,0,0,0,0,0,0,0,0,2000,0,0,0,2000,0,2000,2000,2021-06-09
4598,080168,中鋼統一09購01,0,0,0,0,0,0,0,0,0,2000,0,0,0,2000,0,2000,2000,2021-06-09
4599,081199,大毅元大07購01,0,0,0,0,0,0,0,0,0,2000,0,0,0,2000,0,2000,2000,2021-06-09
4600,081125,世紀鋼群益08購01,0,0,0,0,0,0,0,0,0,2000,0,0,0,2000,0,2000,2000,2021-06-09
4601,080935,華新群益08購01,0,0,0,0,0,0,0,0,0,2000,0,0,0,2000,0,2000,2000,2021-06-09
4602,080914,長榮凱基0B購01,0,0,0,0,0,0,0,0,0,2000,0,0,0,2000,0,2000,2000,2021-06-09
4603,081011,勤誠永豐07購01,0,0,0,0,0,0,0,0,0,2000,0,0,0,2000,0,2000,2000,2021-06-09
4604,080595,榮成統一08購01,0,0,0,0,0,0,0,0,0,2000,0,0,0,12000,10000,2000,2000,2021-06-09
4605,080546,欣興統一08購02,0,0,0,0,0,0,0,0,0,2000,0,0,0,2000,0,2000,2000,2021-06-09
4606,082629,聯電國泰0A購01,0,0,0,0,0,0,0,0,0,2000,0,0,0,2000,0,2000,2000,2021-06-09
4607,082694,台船凱基08購01,0,0,0,0,0,0,0,0,0,2000,0,0,0,2000,0,2000,2000,2021-06-09
4608,082988,玉晶光元大08購05,0,0,0,0,0,0,0,0,0,2000,0,0,0,2000,0,2000,2000,2021-06-09
4609,083079,滬深2X元大08購06,0,0,0,0,0,0,0,0,0,2000,0,0,0,2000,0,2000,2000,2021-06-09
4610,081884,國巨群益08購04,0,0,0,0,0,0,0,0,0,2000,0,0,0,2000,0,2000,2000,2021-06-09
4611,081749,旺宏元大07購03,0,0,0,0,0,0,0,0,0,2000,0,0,0,2000,0,2000,2000,2021-06-09
4612,081488,立隆電凱基07購01,0,0,0,0,0,0,0,0,0,2000,0,0,0,2000,0,2000,2000,2021-06-09
4613,082119,南電群益08購01,0,0,0,0,0,0,0,0,0,2000,0,0,0,2000,0,2000,2000,2021-06-09
4614,082271,台達電元大07購03,0,0,0,0,0,0,0,0,0,2000,0,0,0,2000,0,2000,2000,2021-06-09
4615,082253,致新凱基07購01,0,0,0,0,0,0,0,0,0,2000,0,0,0,2000,0,2000,2000,2021-06-09
4616,082442,T50正2元大0A購02,0,0,0,0,0,0,0,0,0,2000,0,0,0,2000,0,2000,2000,2021-06-09
4617,2236,百達-KY,6000,4000,2000,0,0,0,0,0,0,0,0,0,0,0,0,0,2000,2021-06-09
4618,2881A,富邦特,0,0,0,0,0,0,0,0,0,2000,2000,0,2000,0,0,0,2000,2021-06-09
4619,2882A,國泰特,0,0,0,0,0,0,0,0,0,2000,2000,0,2000,0,0,0,2000,2021-06-09
4620,2891C,中信金丙特,0,0,0,0,0,0,0,0,0,2000,2000,0,2000,0,0,0,2000,2021-06-09
4621,089485,道瓊銅元富09購01,0,0,0,0,0,0,0,0,0,2000,0,0,0,2000,0,2000,2000,2021-06-09
4622,089517,智原元大09購01,0,0,0,0,0,0,0,0,0,2000,0,0,0,2000,0,2000,2000,2021-06-09
4623,089312,台航國票09購01,0,0,0,0,0,0,0,0,0,2000,0,0,0,3000,1000,2000,2000,2021-06-09
4624,089288,長榮元富12購01,0,0,0,0,0,0,0,0,0,2000,0,0,0,2000,0,2000,2000,2021-06-09
4625,089090,凌陽統一0B購01,0,0,0,0,0,0,0,0,0,2000,0,0,0,2000,0,2000,2000,2021-06-09
4626,1537,廣隆,26000,24000,2000,0,0,0,0,0,0,0,0,0,0,0,0,0,2000,2021-06-09
4627,1312A,國喬特,0,0,0,0,0,0,0,0,0,2000,2000,0,2000,0,0,0,2000,2021-06-09
4628,6277,宏正,7000,5000,2000,0,0,0,0,0,0,0,0,0,0,0,0,0,2000,2021-06-09
4629,5258,虹堡,46000,44000,2000,0,0,0,0,0,0,0,0,0,0,0,0,0,2000,2021-06-09
4630,6206,飛捷,15000,13000,2000,0,0,0,0,0,0,0,0,0,0,0,0,0,2000,2021-06-09
4631,9906,欣巴巴,20000,18000,2000,0,0,0,0,0,0,0,0,0,0,0,0,0,2000,2021-06-09
4632,01007T,兆豐國泰R2,1592,0,1592,0,0,0,0,0,0,0,0,0,0,0,0,0,1592,2021-06-09
4633,00645,富邦日本,0,0,0,0,0,0,0,0,0,1286,0,0,0,105304,104018,1286,1286,2021-06-09
4634,1516,川飛,7000,6000,1000,0,0,0,0,0,0,1,1,0,1,0,0,0,1001,2021-06-09
4635,087748,南帝國票0A購02,0,0,0,0,0,0,0,0,0,1000,0,0,0,1000,0,1000,1000,2021-06-09
4636,087984,臻鼎凱基0B購01,0,0,0,0,0,0,0,0,0,1000,0,0,0,3000,2000,1000,1000,2021-06-09
4637,087920,晶碩群益0B購01,0,0,0,0,0,0,0,0,0,1000,0,0,0,2000,1000,1000,1000,2021-06-09
4638,088726,臻鼎凱基11購01,0,0,0,0,0,0,0,0,0,1000,0,0,0,1000,0,1000,1000,2021-06-09
4639,088877,立積康和09購01,0,0,0,0,0,0,0,0,0,1000,0,0,0,1000,0,1000,1000,2021-06-09
4640,088869,立積永豐09購03,0,0,0,0,0,0,0,0,0,1000,0,0,0,100000,99000,1000,1000,2021-06-09
4641,088567,偉詮電凱基09購01,0,0,0,0,0,0,0,0,0,1000,0,0,0,1000,0,1000,1000,2021-06-09
4642,088646,瑞昱富邦09購01,0,0,0,0,0,0,0,0,0,1000,0,0,0,1000,0,1000,1000,2021-06-09
4643,088602,滬深2X永豐09購02,0,0,0,0,0,0,0,0,0,1000,0,0,0,1000,0,1000,1000,2021-06-09
4644,087131,大成鋼國票0A購02,0,0,0,0,0,0,0,0,0,1000,0,0,0,1000,0,1000,1000,2021-06-09
4645,087636,華邦電凱基11購01,0,0,0,0,0,0,0,0,0,1000,0,0,0,1000,0,1000,1000,2021-06-09
4646,087374,國喬元大09購02,0,0,0,0,0,0,0,0,0,1000,0,0,0,1000,0,1000,1000,2021-06-09
4647,087410,滬深2X統一0B購02,0,0,0,0,0,0,0,0,0,1000,0,0,0,1000,0,1000,1000,2021-06-09
4648,087006,元金2X富邦0B購01,0,0,0,0,0,0,0,0,0,1000,0,0,0,1000,0,1000,1000,2021-06-09
4649,086798,長榮航統一0B購03,0,0,0,0,0,0,0,0,0,1000,0,0,0,1000,0,1000,1000,2021-06-09
4650,086687,群創統一11購01,0,0,0,0,0,0,0,0,0,1000,0,0,0,1000,0,1000,1000,2021-06-09
4651,086612,SGBR2X群益09購01,0,0,0,0,0,0,0,0,0,1000,0,0,0,1000,0,1000,1000,2021-06-09
4652,086642,群創凱基0A購01,0,0,0,0,0,0,0,0,0,1000,0,0,0,239000,238000,1000,1000,2021-06-09
4653,084849,T50反1元大0B購03,0,0,0,0,0,0,0,0,0,1000,0,0,0,1000,0,1000,1000,2021-06-09
4654,084988,宏碁群益09購01,0,0,0,0,0,0,0,0,0,1000,0,0,0,26000,25000,1000,1000,2021-06-09
4655,084645,上証2X群益08購01,0,0,0,0,0,0,0,0,0,1000,0,0,0,1000,0,1000,1000,2021-06-09
4656,084262,大成鋼國票08購03,0,0,0,0,0,0,0,0,0,1000,0,0,0,1000,0,1000,1000,2021-06-09
4657,084273,智易國票08購01,0,0,0,0,0,0,0,0,0,1000,0,0,0,10000,9000,1000,1000,2021-06-09
4658,084360,全漢元大07購01,0,0,0,0,0,0,0,0,0,1000,0,0,0,1000,0,1000,1000,2021-06-09
4659,083638,致伸凱基07購02,0,0,0,0,0,0,0,0,0,1000,0,0,0,1000,0,1000,1000,2021-06-09
4660,083728,聚鼎元大07購02,0,0,0,0,0,0,0,0,0,1000,0,0,0,1000,0,1000,1000,2021-06-09
4661,083710,亞泥元大07購01,0,0,0,0,0,0,0,0,0,1000,0,0,0,1000,0,1000,1000,2021-06-09
4662,083759,鴻海兆豐09購07,0,0,0,0,0,0,0,0,0,1000,0,0,0,1000,0,1000,1000,2021-06-09
4663,083600,聯陽國泰09購01,0,0,0,0,0,0,0,0,0,1000,0,0,0,1000,0,1000,1000,2021-06-09
4664,084036,聯發科元富11購04,0,0,0,0,0,0,0,0,0,1000,0,0,0,1000,0,1000,1000,2021-06-09
4665,084155,漢唐麥證07購01,0,0,0,1000,0,1000,0,0,0,1000,0,0,0,1000,0,1000,1000,2021-06-09
4666,083823,台積電凱基08購13,0,0,0,0,0,0,0,0,0,1000,0,0,0,1000,0,1000,1000,2021-06-09
4667,085432,金像電統一0A購01,0,0,0,0,0,0,0,0,0,1000,0,0,0,1000,0,1000,1000,2021-06-09
4668,085385,聯陽兆豐09購01,0,0,0,0,0,0,0,0,0,1000,0,0,0,1000,0,1000,1000,2021-06-09
4669,085601,臺指反元大0B購04,0,0,0,0,0,0,0,0,0,1000,0,0,0,1000,0,1000,1000,2021-06-09
4670,085703,台達化富邦0A購02,0,0,0,0,0,0,0,0,0,1000,0,0,0,1000,0,1000,1000,2021-06-09
4671,085236,聯詠元大08購02,0,0,0,0,0,0,0,0,0,1000,0,0,0,1000,0,1000,1000,2021-06-09
4672,085230,聯發科元大0C購01,0,0,0,0,0,0,0,0,0,1000,0,0,0,1000,0,1000,1000,2021-06-09
4673,085999,晶豪科元大08購06,0,0,0,0,0,0,0,0,0,1000,0,0,0,1000,0,1000,1000,2021-06-09
4674,086044,中鴻元富08購01,0,0,0,0,0,0,0,0,0,1000,0,0,0,1000,0,1000,1000,2021-06-09
4675,085783,國巨元大0C購02,0,0,0,0,0,0,0,0,0,1000,0,0,0,1000,0,1000,1000,2021-06-09
4676,086195,京元電凱基08購03,0,0,0,0,0,0,0,0,0,1000,0,0,0,1000,0,1000,1000,2021-06-09
4677,086180,長華元大08購02,0,0,0,0,0,0,0,0,0,1000,0,0,0,1000,0,1000,1000,2021-06-09
4678,089037,聲寶國泰0B購01,0,0,0,0,0,0,0,0,0,1000,0,0,0,2000,1000,1000,1000,2021-06-09
4679,00657,國泰日經225,21000,0,21000,0,0,0,0,0,0,-20000,0,0,0,100000,120000,-20000,1000,2021-06-09
4680,0054,元大台商50,0,0,0,0,0,0,0,0,0,1000,0,0,0,2000,1000,1000,1000,2021-06-09
4681,020008,元大特股高息N,0,0,0,0,0,0,0,0,0,1000,0,0,0,2000,1000,1000,1000,2021-06-09
4682,00668,國泰美國道瓊,1000,0,1000,0,0,0,0,0,0,0,0,0,0,1000,1000,0,1000,2021-06-09
4683,00685L,群益臺灣加權正2,1000,0,1000,0,0,0,0,0,0,0,0,0,0,0,0,0,1000,2021-06-09
4684,020016,統一MSCI美科技N,0,0,0,0,0,0,0,0,0,1000,0,0,0,2000,1000,1000,1000,2021-06-09
4685,030243,華邦電永豐0A購01,0,0,0,0,0,0,0,0,0,1000,0,0,0,1000,0,1000,1000,2021-06-09
4686,030280,長榮日盛0A購01,0,0,0,0,0,0,0,0,0,1000,0,0,0,1000,0,1000,1000,2021-06-09
4687,030298,威鋒電元富11購02,0,0,0,0,0,0,0,0,0,1000,0,0,0,6000,5000,1000,1000,2021-06-09
4688,030019,南帝康和0A購01,0,0,0,0,0,0,0,0,0,1000,0,0,0,1000,0,1000,1000,2021-06-09
4689,030021,台達電日盛0C購01,0,0,0,0,0,0,0,0,0,1000,0,0,0,1000,0,1000,1000,2021-06-09
4690,030530,中鴻凱基0A購02,0,0,0,0,0,0,0,0,0,1000,0,0,0,1000,0,1000,1000,2021-06-09
4691,031344,智易元大0C購02,0,0,0,0,0,0,0,0,0,1000,0,0,0,11000,10000,1000,1000,2021-06-09
4692,031415,中鋼凱基12購01,0,0,0,0,0,0,0,0,0,1000,0,0,0,1000,0,1000,1000,2021-06-09
4693,031363,彩晶中信0A購03,0,0,0,0,0,0,0,0,0,1000,0,0,0,1000,0,1000,1000,2021-06-09
4694,031366,正隆永豐0A購02,0,0,0,0,0,0,0,0,0,1000,0,0,0,1000,0,1000,1000,2021-06-09
4695,031219,萬海凱基0B購01,0,0,0,0,0,0,0,0,0,1000,0,0,0,1000,0,1000,1000,2021-06-09
4696,031526,乙盛康和11購01,0,0,0,0,0,0,0,0,0,1000,0,0,0,1000,0,1000,1000,2021-06-09
4697,030636,巨大元大0A購01,0,0,0,0,0,0,0,0,0,1000,0,0,0,41000,40000,1000,1000,2021-06-09
4698,031656,華邦電元大0A購06,0,0,0,0,0,0,0,0,0,1000,0,0,0,1000,0,1000,1000,2021-06-09
4699,030599,東鋼元大0A購02,0,0,0,0,0,0,0,0,0,1000,0,0,0,1000,0,1000,1000,2021-06-09
4700,031335,長榮元大12購03,0,0,0,0,0,0,0,0,0,1000,0,0,0,1000,0,1000,1000,2021-06-09
4701,031555,道瓊銀群益0A購02,0,0,0,0,0,0,0,0,0,1000,0,0,0,1000,0,1000,1000,2021-06-09
4702,030783,中鴻凱基12購01,0,0,0,0,0,0,0,0,0,1000,0,0,0,1000,0,1000,1000,2021-06-09
4703,031614,長榮康和0A購05,0,0,0,0,0,0,0,0,0,1000,0,0,0,1000,0,1000,1000,2021-06-09
4704,032678,長榮中信11購03,0,0,0,0,0,0,0,0,0,1000,0,0,0,1000,0,1000,1000,2021-06-09
4705,032246,中石化元大0A購05,0,0,0,0,0,0,0,0,0,1000,0,0,0,1000,0,1000,1000,2021-06-09
4706,031171,亞聚永豐0A購01,0,0,0,0,0,0,0,0,0,1000,0,0,0,1000,0,1000,1000,2021-06-09
4707,030769,長榮康和0A購02,0,0,0,0,0,0,0,0,0,1000,0,0,0,1000,0,1000,1000,2021-06-09
4708,031118,新纖統一0B購02,0,0,0,0,0,0,0,0,0,1000,0,0,0,1000,0,1000,1000,2021-06-09
4709,031147,聯發科兆豐0A購05,0,0,0,0,0,0,0,0,0,1000,0,0,0,1000,0,1000,1000,2021-06-09
4710,031036,長榮航凱基0A購03,0,0,0,0,0,0,0,0,0,1000,0,0,0,1000,0,1000,1000,2021-06-09
4711,031023,華邦電凱基0A購06,0,0,0,0,0,0,0,0,0,1000,0,0,0,1000,0,1000,1000,2021-06-09
4712,033577,華新凱基15購01,0,0,0,0,0,0,0,0,0,1000,0,0,0,10000,9000,1000,1000,2021-06-09
4713,032345,群創群益12購01,0,0,0,0,0,0,0,0,0,1000,0,0,0,1000,0,1000,1000,2021-06-09
4714,033118,SGBR2X元大12購01,0,0,0,0,0,0,0,0,0,1000,0,0,0,1000,0,1000,1000,2021-06-09
4715,032265,台航元大0B購01,0,0,0,0,0,0,0,0,0,1000,0,0,0,1000,0,1000,1000,2021-06-09
4716,033317,元石油凱基0C購02,0,0,0,0,0,0,0,0,0,1000,0,0,0,8000,7000,1000,1000,2021-06-09
4717,031999,長榮群益13購01,0,0,0,0,0,0,0,0,0,1000,0,0,0,1000,0,1000,1000,2021-06-09
4718,032040,永光國票0B購01,0,0,0,0,0,0,0,0,0,1000,0,0,0,1000,0,1000,1000,2021-06-09
4719,05592P,中興電元富07售02,0,0,0,0,0,0,0,0,0,1000,0,0,0,18000,17000,1000,1000,2021-06-09
4720,031764,長榮元富0A購10,0,0,0,0,0,0,0,0,0,1000,0,0,0,1000,0,1000,1000,2021-06-09
4721,031761,力麗元富0B購01,0,0,0,0,0,0,0,0,0,1000,0,0,0,3000,2000,1000,1000,2021-06-09
4722,032576,台泥元大0A購03,0,0,0,0,0,0,0,0,0,1000,0,0,0,32000,31000,1000,1000,2021-06-09
4723,035005,佳世達元大0B購02,0,0,0,0,0,0,0,0,0,1000,0,0,0,4000,3000,1000,1000,2021-06-09
4724,05970P,台積電元大07售23,0,0,0,0,0,0,0,0,0,1000,0,0,0,1000,0,1000,1000,2021-06-09
4725,05969P,台積電元大07售22,0,0,0,0,0,0,0,0,0,1000,0,0,0,1000,0,1000,1000,2021-06-09
4726,06234P,群創凱基08售08,0,0,0,0,0,0,0,0,0,1000,0,0,0,1000,0,1000,1000,2021-06-09
4727,06161P,臺指2X中信0B售01,0,0,0,0,0,0,0,0,0,1000,0,0,0,1000,0,1000,1000,2021-06-09
4728,06000P,日月光元大07售09,0,0,0,0,0,0,0,0,0,1000,0,0,0,1000,0,1000,1000,2021-06-09
4729,06051P,鴻海國票09售02,0,0,0,0,0,0,0,0,0,1000,0,0,0,1000,0,1000,1000,2021-06-09
4730,033825,祥碩統一0C購03,0,0,0,0,0,0,0,0,0,1000,0,0,0,1000,0,1000,1000,2021-06-09
4731,033836,欣興國泰11購02,0,0,0,0,0,0,0,0,0,1000,0,0,0,1000,0,1000,1000,2021-06-09
4732,034583,國產凱基0B購01,0,0,0,0,0,0,0,0,0,1000,0,0,0,1000,0,1000,1000,2021-06-09
4733,034456,燁輝群益11購01,0,0,0,0,0,0,0,0,0,1000,0,0,0,1000,0,1000,1000,2021-06-09
4734,036100,台表科元大0C購01,0,0,0,0,0,0,0,0,0,1000,0,0,0,27000,26000,1000,1000,2021-06-09
4735,036126,矽創群益0C購02,0,0,0,0,0,0,0,0,0,1000,0,0,0,97000,96000,1000,1000,2021-06-09
4736,033893,東鋼統一0C購06,0,0,0,0,0,0,0,0,0,1000,0,0,0,1000,0,1000,1000,2021-06-09
4737,035941,欣興凱基0C購04,0,0,0,0,0,0,0,0,0,1000,0,0,0,1000,0,1000,1000,2021-06-09
4738,05798P,聯電元大07售07,0,0,0,0,0,0,0,0,0,1000,0,0,0,1000,0,1000,1000,2021-06-09
4739,05800P,T50正2群益08售09,0,0,0,0,0,0,0,0,0,1000,0,0,0,1000,0,1000,1000,2021-06-09
4740,05834P,臺股指凱基07售12,0,0,0,0,0,0,0,0,0,1000,0,0,0,1000,0,1000,1000,2021-06-09
4741,034320,大亞群益0C購01,0,0,0,0,0,0,0,0,0,1000,0,0,0,1000,0,1000,1000,2021-06-09
4742,035277,華新國票0C購01,0,0,0,0,0,0,0,0,0,1000,0,0,0,24000,23000,1000,1000,2021-06-09
4743,035116,宏碁兆豐12購01,0,0,0,0,0,0,0,0,0,1000,0,0,0,52000,51000,1000,1000,2021-06-09
4744,05032P,台積電中信09售05,0,0,0,0,0,0,0,0,0,1000,0,0,0,1000,0,1000,1000,2021-06-09
4745,05161P,世芯統一07售01,0,0,0,0,0,0,0,0,0,1000,0,0,0,1000,0,1000,1000,2021-06-09
4746,05418P,臺股指國票0B售03,0,0,0,0,0,0,0,0,0,1000,0,0,0,1000,0,1000,1000,2021-06-09
4747,036428,旺宏凱基0C購03,0,0,0,0,0,0,0,0,0,1000,0,0,0,1000,0,1000,1000,2021-06-09
4748,06323P,台積電元大08售30,0,0,0,0,0,0,0,0,0,1000,0,0,0,1000,0,1000,1000,2021-06-09
4749,082387,矽創兆豐08購01,0,0,0,0,0,0,0,0,0,1000,0,0,0,1000,0,1000,1000,2021-06-09
4750,082307,愛普元大07購06,0,0,0,0,0,0,0,0,0,1000,0,0,0,1008000,1007000,1000,1000,2021-06-09
4751,082264,南亞元大07購01,0,0,0,0,0,0,0,0,0,1000,0,0,0,1000,0,1000,1000,2021-06-09
4752,082178,義隆兆豐07購01,0,0,0,0,0,0,0,0,0,1000,0,0,0,1000,0,1000,1000,2021-06-09
4753,081493,長榮凱基0B購02,0,0,0,0,0,0,0,0,0,1000,0,0,0,1000,0,1000,1000,2021-06-09
4754,081595,台揚元大07購02,0,0,0,0,0,0,0,0,0,1000,0,0,0,1000,0,1000,1000,2021-06-09
4755,081599,國巨元大07購11,0,0,0,0,0,0,0,0,0,1000,0,0,0,1000,0,1000,1000,2021-06-09
4756,081763,欣興元大08購02,0,0,0,0,0,0,0,0,0,1000,0,0,0,1000,0,1000,1000,2021-06-09
4757,081613,益航元大07購02,0,0,0,0,0,0,0,0,0,1000,0,0,0,1000,0,1000,1000,2021-06-09
4758,081883,鴻海群益08購04,0,0,0,0,0,0,0,0,0,1000,0,0,0,1000,0,1000,1000,2021-06-09
4759,081850,強茂永豐07購01,0,0,0,0,0,0,0,0,0,1000,0,0,0,1000,0,1000,1000,2021-06-09
4760,083163,聯陽群益08購01,0,0,0,0,0,0,0,0,0,1000,0,0,0,1000,0,1000,1000,2021-06-09
4761,083245,祥碩群益08購04,0,0,0,0,0,0,0,0,0,1000,0,0,0,1000,0,1000,1000,2021-06-09
4762,082666,鴻海兆豐0A購01,0,0,0,0,0,0,0,0,0,1000,0,0,0,1000,0,1000,1000,2021-06-09
4763,082617,凌陽永豐07購02,0,0,0,0,0,0,0,0,0,1000,0,0,0,1000,0,1000,1000,2021-06-09
4764,082531,鴻海日盛11購01,0,0,0,0,0,0,0,0,0,1000,0,0,0,11000,10000,1000,1000,2021-06-09
4765,080585,中石化中信07購01,0,0,0,0,0,0,0,0,0,1000,0,0,0,1000,0,1000,1000,2021-06-09
4766,080589,富邦金兆豐06購01,0,0,0,0,0,0,0,0,0,1000,0,0,0,1000,0,1000,1000,2021-06-09
4767,080843,長榮元富06購06,0,0,0,0,0,0,0,0,0,1000,0,0,0,61000,60000,1000,1000,2021-06-09
4768,081141,華邦電凱基08購02,0,0,0,0,0,0,0,0,0,1000,0,0,0,1000,0,1000,1000,2021-06-09
4769,081145,中工凱基09購01,0,0,0,0,0,0,0,0,0,1000,0,0,0,1000,0,1000,1000,2021-06-09
4770,081116,長榮群益07購06,0,0,0,0,0,0,0,0,0,1000,0,0,0,3000,2000,1000,1000,2021-06-09
4771,081088,欣興中信08購01,0,0,0,0,0,0,0,0,0,1000,0,0,0,1000,0,1000,1000,2021-06-09
4772,081381,台積電麥證07購01,0,0,0,1000,0,1000,0,0,0,1000,0,0,0,1000,0,1000,1000,2021-06-09
4773,080066,上銀元大06購06,0,0,0,0,0,0,0,0,0,1000,0,0,0,1000,0,1000,1000,2021-06-09
4774,079912,欣興國泰08購03,0,0,0,0,0,0,0,0,0,1000,0,0,0,1000,0,1000,1000,2021-06-09
4775,079980,上銀統一08購04,0,0,0,0,0,0,0,0,0,1000,0,0,0,1000,0,1000,1000,2021-06-09
4776,080404,聯陽元大06購01,0,0,0,0,0,0,0,0,0,1000,0,0,0,1000,0,1000,1000,2021-06-09
4777,080309,欣興群益06購03,0,0,0,0,0,0,0,0,0,1000,0,0,0,1000,0,1000,1000,2021-06-09
4778,080272,中工富邦08購01,0,0,0,0,0,0,0,0,0,1000,0,0,0,1000,0,1000,1000,2021-06-09
4779,080227,新光鋼元大06購03,0,0,0,0,0,0,0,0,0,1000,0,0,0,1000,0,1000,1000,2021-06-09
4780,080369,矽創國泰08購01,0,0,0,0,0,0,0,0,0,1000,0,0,0,1000,0,1000,1000,2021-06-09
4781,079372,華新元大06購01,0,0,0,0,0,0,0,0,0,1000,0,0,0,1000,0,1000,1000,2021-06-09
4782,079305,正新富邦08購01,0,0,0,0,0,0,0,0,0,1000,0,0,0,1000,0,1000,1000,2021-06-09
4783,079455,聯發科元富0C購03,0,0,0,0,0,0,0,0,0,1000,0,0,0,1000,0,1000,1000,2021-06-09
4784,079557,SGBR2X國票0A購01,0,0,0,0,0,0,0,0,0,1000,0,0,0,1000,0,1000,1000,2021-06-09
4785,079837,長榮元大06購14,0,0,0,0,0,0,0,0,0,1000,0,0,0,1000,0,1000,1000,2021-06-09
4786,079738,長榮統一07購04,0,0,0,0,0,0,0,0,0,1000,0,0,0,1000,0,1000,1000,2021-06-09
4787,079703,台灣50群益08購01,0,0,0,0,0,0,0,0,0,1000,0,0,0,4000,3000,1000,1000,2021-06-09
4788,078616,景碩兆豐07購01,0,0,0,0,0,0,0,0,0,1000,0,0,0,1000,0,1000,1000,2021-06-09
4789,078945,技嘉統一07購02,0,0,0,0,0,0,0,0,0,1000,0,0,0,11000,10000,1000,1000,2021-06-09
4790,078985,國巨麥證06購04,0,0,0,1000,0,1000,0,0,0,1000,0,0,0,1000,0,1000,1000,2021-06-09
4791,078885,京元電元大06購01,0,0,0,0,0,0,0,0,0,1000,0,0,0,1000,0,1000,1000,2021-06-09
4792,078914,新唐富邦06購01,0,0,0,0,0,0,0,0,0,1000,0,0,0,201000,200000,1000,1000,2021-06-09
4793,078868,滬深2X元大07購08,0,0,0,0,0,0,0,0,0,1000,0,0,0,1000,0,1000,1000,2021-06-09
4794,078085,世芯永豐07購02,0,0,0,0,0,0,0,0,0,1000,0,0,0,1000,0,1000,1000,2021-06-09
4795,077930,大立光群益07購01,0,0,0,0,0,0,0,0,0,1000,0,0,0,1000,0,1000,1000,2021-06-09
4796,077530,金像電凱基06購01,0,0,0,0,0,0,0,0,0,1000,0,0,0,1000,0,1000,1000,2021-06-09
4797,077125,長榮群益06購03,0,0,0,0,0,0,0,0,0,1000,0,0,0,1000,0,1000,1000,2021-06-09
4798,077207,聯發科兆豐06購01,0,0,0,0,0,0,0,0,0,1000,0,0,0,1000,0,1000,1000,2021-06-09
4799,077462,國巨國票07購02,0,0,0,0,0,0,0,0,0,1000,0,0,0,1000,0,1000,1000,2021-06-09
4800,076636,華碩元大06購01,0,0,0,0,0,0,0,0,0,1000,0,0,0,1000,0,1000,1000,2021-06-09
4801,077001,世芯國票07購01,0,0,0,0,0,0,0,0,0,1000,0,0,0,100000,99000,1000,1000,2021-06-09
4802,077029,世芯凱基06購01,0,0,0,0,0,0,0,0,0,1000,0,0,0,1000,0,1000,1000,2021-06-09
4803,076984,世芯元大06購01,0,0,0,0,0,0,0,0,0,1000,0,0,0,1000,0,1000,1000,2021-06-09
4804,076815,世紀鋼國泰07購01,0,0,0,0,0,0,0,0,0,1000,0,0,0,1000,0,1000,1000,2021-06-09
4805,076379,日月光凱基06購02,0,0,0,0,0,0,0,0,0,1000,0,0,0,1000,0,1000,1000,2021-06-09
4806,076060,聯詠統一07購01,0,0,0,0,0,0,0,0,0,1000,0,0,0,1000,0,1000,1000,2021-06-09
4807,075945,國泰金富邦07購01,0,0,0,0,0,0,0,0,0,1000,0,0,0,1000,0,1000,1000,2021-06-09
4808,074966,聯發科國泰06購03,0,0,0,0,0,0,0,0,0,1000,0,0,0,1000,0,1000,1000,2021-06-09
4809,074973,華邦電富邦06購01,0,0,0,0,0,0,0,0,0,1000,0,0,0,1000,0,1000,1000,2021-06-09
4810,074902,華擎統一07購01,0,0,0,0,0,0,0,0,0,1000,0,0,0,1000,0,1000,1000,2021-06-09
4811,074173,香港2X元富0A購01,0,0,0,0,0,0,0,0,0,1000,0,0,0,1000,0,1000,1000,2021-06-09
4812,072817,祥碩元富08購01,0,0,0,0,0,0,0,0,0,1000,0,0,0,26000,25000,1000,1000,2021-06-09
4813,07289P,台積電台新0C售01,0,0,0,0,0,0,0,0,0,1000,0,0,0,1000,0,1000,1000,2021-06-09
4814,073049,緯穎元富0A購01,0,0,0,0,0,0,0,0,0,1000,0,0,0,1000,0,1000,1000,2021-06-09
4815,06743P,台灣50元大0A售13,0,0,0,0,0,0,0,0,0,1000,0,0,0,1000,0,1000,1000,2021-06-09
4816,06796P,友達康和0B售01,0,0,0,0,0,0,0,0,0,1000,0,0,0,1000,0,1000,1000,2021-06-09
4817,06821P,國巨群益0A售02,0,0,0,0,0,0,0,0,0,1000,0,0,0,1000,0,1000,1000,2021-06-09
4818,06837P,立積群益0A售03,0,0,0,0,0,0,0,0,0,1000,0,0,0,1000,0,1000,1000,2021-06-09
4819,06446P,滬深2X凱基0B售03,0,0,0,0,0,0,0,0,0,1000,0,0,0,1000,0,1000,1000,2021-06-09
4820,06433P,鴻海元大09售11,0,0,0,0,0,0,0,0,0,1000,0,0,0,1000,0,1000,1000,2021-06-09
4821,06421P,臺股指國票09售19,0,0,0,0,0,0,0,0,0,1000,0,0,0,1000,0,1000,1000,2021-06-09
4822,06843P,聯電康和0A售02,0,0,0,0,0,0,0,0,0,1000,0,0,0,1000,0,1000,1000,2021-06-09
4823,07016P,富邦金元富12售04,0,0,0,0,0,0,0,0,0,1000,0,0,0,5000,4000,1000,1000,2021-06-09
4824,083388,臺股指富邦0A購01,0,0,0,0,0,0,0,0,0,1000,0,0,0,1000,0,1000,1000,2021-06-09
4825,1533,車王電,68000,67000,1000,0,0,0,0,0,0,0,0,0,0,0,0,0,1000,2021-06-09
4826,1539,巨庭,1000,0,1000,0,0,0,0,0,0,0,0,0,0,0,0,0,1000,2021-06-09
4827,1604,聲寶,135000,132000,3000,0,0,0,0,0,0,-2000,0,0,0,0,2000,-2000,1000,2021-06-09
4828,1339,昭輝,7000,6000,1000,0,0,0,0,0,0,0,0,0,0,0,0,0,1000,2021-06-09
4829,1419,新紡,8000,7000,1000,0,0,0,0,0,0,0,0,0,0,0,0,0,1000,2021-06-09
4830,089869,矽創中信0C購01,0,0,0,0,0,0,0,0,0,1000,0,0,0,1000,0,1000,1000,2021-06-09
4831,089084,台船統一0B購02,0,0,0,0,0,0,0,0,0,1000,0,0,0,1000,0,1000,1000,2021-06-09
4832,089236,長榮永豐09購05,0,0,0,0,0,0,0,0,0,1000,0,0,0,1000,0,1000,1000,2021-06-09
4833,089219,緯創群益09購01,0,0,0,0,0,0,0,0,0,1000,0,0,0,1000,0,1000,1000,2021-06-09
4834,089319,群創國票0B購02,0,0,0,0,0,0,0,0,0,1000,0,0,0,1000,0,1000,1000,2021-06-09
4835,089518,總太元大09購01,0,0,0,0,0,0,0,0,0,1000,0,0,0,9000,8000,1000,1000,2021-06-09
4836,089455,長榮統一0C購01,0,0,0,0,0,0,0,0,0,1000,0,0,0,1000,0,1000,1000,2021-06-09
4837,08953P,大立光元富07售02,0,0,0,0,0,0,0,0,0,1000,0,0,0,1000,0,1000,1000,2021-06-09
4838,089670,南帝元大09購09,0,0,0,0,0,0,0,0,0,1000,0,0,0,3000,2000,1000,1000,2021-06-09
4839,089748,聯發科統一11購01,0,0,0,0,0,0,0,0,0,1000,0,0,0,1000,0,1000,1000,2021-06-09
4840,2888B,新光金乙特,1000,0,1000,0,0,0,0,0,0,0,0,0,0,0,0,0,1000,2021-06-09
4841,2705,六福,2000,1000,1000,0,0,0,0,0,0,0,0,0,0,0,0,0,1000,2021-06-09
4842,2936,客思達-KY,4000,3000,1000,0,0,0,0,0,0,0,0,0,0,0,0,0,1000,2021-06-09
4843,3702A,大聯大甲特,0,0,0,0,0,0,0,18000,-18000,19000,19000,0,19000,0,0,0,1000,2021-06-09
4844,4560,強信-KY,68000,67000,1000,0,0,0,0,0,0,0,0,0,0,0,0,0,1000,2021-06-09
4845,1735,日勝化,2000,1000,1000,0,0,0,0,0,0,0,0,0,0,0,0,0,1000,2021-06-09
4846,9941A,裕融甲特,0,0,0,0,0,0,0,0,0,1000,1000,0,1000,0,0,0,1000,2021-06-09
4847,6515,穎崴,3000,2000,1000,0,0,0,0,0,0,0,0,0,0,0,0,0,1000,2021-06-09
4848,6525,捷敏-KY,21000,20000,1000,0,0,0,0,0,0,0,0,0,0,0,0,0,1000,2021-06-09
4849,00690,兆豐藍籌30,0,0,0,0,0,0,0,0,0,195,0,0,0,101195,101000,195,195,2021-06-09
4850,086192,宏碁凱基08購05,0,0,0,0,0,0,0,0,0,0,0,0,0,6000,6000,0,0,2021-06-09
4851,086233,群創統一0A購02,0,0,0,0,0,0,0,0,0,0,0,0,0,15000,15000,0,0,2021-06-09
4852,086107,台積電兆豐09購06,0,0,0,0,0,0,0,0,0,0,0,0,0,499000,499000,0,0,2021-06-09
4853,086108,華邦電兆豐09購01,0,0,0,0,0,0,0,0,0,0,0,0,0,10000,10000,0,0,2021-06-09
4854,086294,滬深2X日盛09購01,0,0,0,0,0,0,0,0,0,0,0,0,0,400000,400000,0,0,2021-06-09
4855,086322,致新凱基0A購01,0,0,0,0,0,0,0,0,0,0,0,0,0,50000,50000,0,0,2021-06-09
4856,086329,中興電元大09購03,0,0,0,0,0,0,0,0,0,0,0,0,0,2000,2000,0,0,2021-06-09
4857,086011,京鼎元大0A購01,0,0,0,0,0,0,0,0,0,0,0,0,0,20000,20000,0,0,2021-06-09
4858,086066,智原統一0A購01,0,0,0,0,0,0,0,0,0,0,0,0,0,30000,30000,0,0,2021-06-09
4859,086083,中鋼中信0A購01,0,0,0,0,0,0,0,0,0,0,0,0,0,11000,11000,0,0,2021-06-09
4860,085934,旺宏群益0A購03,0,0,0,0,0,0,0,0,0,0,0,0,0,8000,8000,0,0,2021-06-09
4861,085946,玉晶光群益0A購01,0,0,0,0,0,0,0,0,0,0,0,0,0,9000,9000,0,0,2021-06-09
4862,085950,祥碩群益08購05,0,0,0,0,0,0,0,0,0,0,0,0,0,1000,1000,0,0,2021-06-09
4863,085313,群創元大09購03,0,0,0,0,0,0,0,0,0,0,0,0,0,1000,1000,0,0,2021-06-09
4864,085316,台表科元大08購01,0,0,0,0,0,0,0,0,0,0,0,0,0,10000,10000,0,0,2021-06-09
4865,085327,旺宏群益0A購02,0,0,0,0,0,0,0,0,0,0,0,0,0,1000,1000,0,0,2021-06-09
4866,085187,佳世達元富0A購01,0,0,0,0,0,0,0,0,0,0,0,0,0,30000,30000,0,0,2021-06-09
4867,085056,大立光國票09購01,0,0,0,0,0,0,0,0,0,0,0,0,0,40000,40000,0,0,2021-06-09
4868,085057,晶技國票09購01,0,0,0,0,0,0,0,0,0,0,0,0,0,6000,6000,0,0,2021-06-09
4869,085059,群創國票09購03,0,0,0,0,0,0,0,0,0,0,0,0,0,2000,2000,0,0,2021-06-09
4870,085080,玉晶光永豐08購02,0,0,0,0,0,0,0,0,0,0,0,0,0,8000,8000,0,0,2021-06-09
4871,085106,大亞元大08購01,0,0,0,0,0,0,0,0,0,0,0,0,0,26000,26000,0,0,2021-06-09
4872,085748,聯陽永豐08購02,0,0,0,0,0,0,0,0,0,0,0,0,0,71000,71000,0,0,2021-06-09
4873,085732,鴻海兆豐0B購02,0,0,0,0,0,0,0,0,0,0,0,0,0,10000,10000,0,0,2021-06-09
4874,085686,南電元富08購03,0,0,0,0,0,0,0,0,0,0,0,0,0,3000,3000,0,0,2021-06-09
4875,085388,群創兆豐08購01,0,0,0,0,0,0,0,0,0,0,0,0,0,10000,10000,0,0,2021-06-09
4876,085486,三陽凱基08購01,0,0,0,0,0,0,0,0,0,0,0,0,0,1000,1000,0,0,2021-06-09
4877,083905,義隆元大07購08,0,0,0,0,0,0,0,0,0,0,0,0,0,1000,1000,0,0,2021-06-09
4878,084156,日月光麥證07購02,0,0,0,38000,38000,0,0,0,0,0,0,0,0,38000,38000,0,0,2021-06-09
4879,084188,聯電元大07購21,0,0,0,0,0,0,0,0,0,0,0,0,0,55000,55000,0,0,2021-06-09
4880,084216,欣興元大07購17,0,0,0,0,0,0,0,0,0,0,0,0,0,10000,10000,0,0,2021-06-09
4881,084213,智原元大07購04,0,0,0,0,0,0,0,0,0,0,0,0,0,1000,1000,0,0,2021-06-09
4882,084222,日月光元大07購15,0,0,0,0,0,0,0,0,0,0,0,0,0,18000,18000,0,0,2021-06-09
4883,083534,欣興元大07購14,0,0,0,0,0,0,0,0,0,0,0,0,0,8000,8000,0,0,2021-06-09
4884,083459,臺股指麥證09購02,0,0,0,300000,0,300000,0,0,0,0,0,0,0,300000,300000,0,0,2021-06-09
4885,083436,瑞昱凱基08購02,0,0,0,0,0,0,0,0,0,0,0,0,0,4000,4000,0,0,2021-06-09
4886,083732,恆大國票08購02,20000,0,20000,0,0,0,0,0,0,-20000,0,0,0,0,20000,-20000,0,2021-06-09
4887,083642,緯穎凱基07購03,0,0,0,0,0,0,0,0,0,0,0,0,0,20000,20000,0,0,2021-06-09
4888,083608,聯電兆豐08購02,0,0,0,0,0,0,0,0,0,0,0,0,0,10000,10000,0,0,2021-06-09
4889,083621,鴻海凱基08購09,0,0,0,0,0,0,0,0,0,0,0,0,0,100000,100000,0,0,2021-06-09
4890,084450,宏碁永豐08購01,0,0,0,0,0,0,0,0,0,0,0,0,0,6000,6000,0,0,2021-06-09
4891,084297,台積電兆豐08購11,0,0,0,0,0,0,0,0,0,0,0,0,0,698000,698000,0,0,2021-06-09
4892,084607,滬深2X兆豐09購01,0,0,0,0,0,0,0,0,0,0,0,0,0,10000,10000,0,0,2021-06-09
4893,084569,義隆國票08購01,0,0,0,0,0,0,0,0,0,0,0,0,0,3000,3000,0,0,2021-06-09
4894,084600,聯電永豐08購04,0,0,0,0,0,0,0,0,0,0,0,0,0,1000,1000,0,0,2021-06-09
4895,084463,中興電凱基0B購03,0,0,0,0,0,0,0,0,0,0,0,0,0,2000,2000,0,0,2021-06-09
4896,084528,百和元大08購02,0,0,0,0,0,0,0,0,0,0,0,0,0,27000,27000,0,0,2021-06-09
4897,084984,鴻海群益09購08,0,0,0,0,0,0,0,0,0,0,0,0,0,147000,147000,0,0,2021-06-09
4898,084950,智邦凱基08購01,0,0,0,0,0,0,0,0,0,0,0,0,0,10000,10000,0,0,2021-06-09
4899,084948,旺宏凱基08購05,0,0,0,0,0,0,0,0,0,0,0,0,0,1000,1000,0,0,2021-06-09
4900,084955,義隆凱基08購04,0,0,0,0,0,0,0,0,0,0,0,0,0,10000,10000,0,0,2021-06-09
4901,084956,王品凱基0A購01,0,0,0,0,0,0,0,0,0,0,0,0,0,5000,5000,0,0,2021-06-09
4902,085001,宏碁永豐08購02,0,0,0,0,0,0,0,0,0,0,0,0,0,2000,2000,0,0,2021-06-09
4903,084927,宏碁元大08購03,0,0,0,0,0,0,0,0,0,0,0,0,0,6000,6000,0,0,2021-06-09
4904,084717,聯發科元富0B購02,0,0,0,0,0,0,0,0,0,0,0,0,0,345000,345000,0,0,2021-06-09
4905,084791,百和凱基09購01,0,0,0,0,0,0,0,0,0,0,0,0,0,45000,45000,0,0,2021-06-09
4906,084768,聯電凱基08購11,0,0,0,0,0,0,0,0,0,0,0,0,0,1000,1000,0,0,2021-06-09
4907,086638,長榮航凱基09購01,0,0,0,0,0,0,0,0,0,0,0,0,0,35000,35000,0,0,2021-06-09
4908,086679,友達統一11購01,0,0,0,0,0,0,0,0,0,0,0,0,0,10000,10000,0,0,2021-06-09
4909,086668,可成國泰0B購01,0,0,0,0,0,0,0,0,0,0,0,0,0,18000,18000,0,0,2021-06-09
4910,086449,滬深2X群益09購03,0,0,0,0,0,0,0,0,0,0,0,0,0,60000,60000,0,0,2021-06-09
4911,086454,旺宏群益0B購01,0,0,0,0,0,0,0,0,0,0,0,0,0,2000,2000,0,0,2021-06-09
4912,086794,矽創兆豐0A購01,0,0,0,0,0,0,0,0,0,0,0,0,0,2000,2000,0,0,2021-06-09
4913,086750,宏碁日盛09購01,0,0,0,0,0,0,0,0,0,0,0,0,0,729000,729000,0,0,2021-06-09
4914,086759,臺股指麥證09購04,0,0,0,179000,0,179000,0,0,0,0,0,0,0,179000,179000,0,0,2021-06-09
4915,086995,聯發科國票0B購03,0,0,0,0,0,0,0,0,0,0,0,0,0,2000,2000,0,0,2021-06-09
4916,086941,華新科元大0B購01,0,0,0,0,0,0,0,0,0,0,0,0,0,1000000,1000000,0,0,2021-06-09
4917,086950,日月光元大09購03,0,0,0,0,0,0,0,0,0,0,0,0,0,13000,13000,0,0,2021-06-09
4918,087479,旺宏永豐09購02,0,0,0,0,0,0,0,0,0,0,0,0,0,68000,68000,0,0,2021-06-09
4919,087377,中興電元大0B購01,0,0,0,0,0,0,0,0,0,0,0,0,0,2000,2000,0,0,2021-06-09
4920,087612,群創永豐09購04,0,0,0,0,0,0,0,0,0,0,0,0,0,1000,1000,0,0,2021-06-09
4921,087661,華新科兆豐09購02,0,0,0,0,0,0,0,0,0,0,0,0,0,322000,322000,0,0,2021-06-09
4922,087565,聚鼎國票0A購01,0,0,0,0,0,0,0,0,0,0,0,0,0,100000,100000,0,0,2021-06-09
4923,087551,華邦電元富0B購01,0,0,0,0,0,0,0,0,0,0,0,0,0,462000,462000,0,0,2021-06-09
4924,087105,旺宏元大09購05,0,0,0,0,0,0,0,0,0,0,0,0,0,1000,1000,0,0,2021-06-09
4925,087106,旺宏元大09購06,0,0,0,0,0,0,0,0,0,0,0,0,0,1000,1000,0,0,2021-06-09
4926,087067,TPK群益09購01,0,0,0,0,0,0,0,0,0,0,0,0,0,350000,350000,0,0,2021-06-09
4927,087242,聯發科兆豐09購02,0,0,0,0,0,0,0,0,0,0,0,0,0,40000,40000,0,0,2021-06-09
4928,087290,華新科元大0A購01,0,0,0,0,0,0,0,0,0,0,0,0,0,1000000,1000000,0,0,2021-06-09
4929,087293,信邦元大09購01,0,0,0,0,0,0,0,0,0,0,0,0,0,10000,10000,0,0,2021-06-09
4930,087340,金像電凱基0A購01,0,0,0,0,0,0,0,0,0,0,0,0,0,20000,20000,0,0,2021-06-09
4931,087316,東鋼永豐09購01,0,0,0,0,0,0,0,0,0,0,0,0,0,10000,10000,0,0,2021-06-09
4932,088550,訊芯群益0A購01,0,0,0,0,0,0,0,0,0,0,0,0,0,28000,28000,0,0,2021-06-09
4933,088497,旺宏元大09購10,0,0,0,0,0,0,0,0,0,0,0,0,0,1000,1000,0,0,2021-06-09
4934,088442,智易凱基0B購01,0,0,0,0,0,0,0,0,0,0,0,0,0,1000,1000,0,0,2021-06-09
4935,088347,乙盛元大0B購02,0,0,0,0,0,0,0,0,0,0,0,0,0,10000,10000,0,0,2021-06-09
4936,088429,友達日盛0A購01,0,0,0,0,0,0,0,0,0,0,0,0,0,10000,10000,0,0,2021-06-09
4937,088949,宏碁日盛09購02,0,0,0,0,0,0,0,0,0,0,0,0,0,849000,849000,0,0,2021-06-09
4938,088965,祥碩國票09購01,0,0,0,0,0,0,0,0,0,0,0,0,0,30000,30000,0,0,2021-06-09
4939,088740,益航永豐09購01,0,0,0,0,0,0,0,0,0,0,0,0,0,10000,10000,0,0,2021-06-09
4940,088828,台表科元大09購05,0,0,0,0,0,0,0,0,0,0,0,0,0,20000,20000,0,0,2021-06-09
4941,088818,聯詠元大09購10,0,0,0,0,0,0,0,0,0,0,0,0,0,1000,1000,0,0,2021-06-09
4942,087946,儒鴻元富0B購02,0,0,0,0,0,0,0,0,0,0,0,0,0,10000,10000,0,0,2021-06-09
4943,087976,瑞昱凱基09購02,0,0,0,0,0,0,0,0,0,0,0,0,0,4000,4000,0,0,2021-06-09
4944,087829,宏碁凱基09購03,0,0,0,0,0,0,0,0,0,0,0,0,0,1000,1000,0,0,2021-06-09
4945,087833,華新科凱基0A購02,0,0,0,0,0,0,0,0,0,0,0,0,0,5000,5000,0,0,2021-06-09
4946,087874,儒鴻元大09購01,0,0,0,0,0,0,0,0,0,0,0,0,0,1000,1000,0,0,2021-06-09
4947,087883,富邦金元大09購03,0,0,0,0,0,0,0,0,0,0,0,0,0,50000,50000,0,0,2021-06-09
4948,087686,宏碁元大09購03,0,0,0,0,0,0,0,0,0,0,0,0,0,4000,4000,0,0,2021-06-09
4949,087684,旺宏元大09購07,0,0,0,0,0,0,0,0,0,0,0,0,0,19000,19000,0,0,2021-06-09
4950,087696,TPK元大09購01,0,0,0,0,0,0,0,0,0,0,0,0,0,23000,23000,0,0,2021-06-09
4951,087821,聚陽凱基09購01,0,0,0,0,0,0,0,0,0,0,0,0,0,30000,30000,0,0,2021-06-09
4952,088339,中信金元大09購02,0,0,0,0,0,0,0,0,0,0,0,0,0,2000,2000,0,0,2021-06-09
4953,088231,滬深2X國票0A購08,0,0,0,0,0,0,0,0,0,0,0,0,0,12000,12000,0,0,2021-06-09
4954,088238,聯發科國票0C購03,0,0,0,0,0,0,0,0,0,0,0,0,0,80000,80000,0,0,2021-06-09
4955,088258,華新科第一13購01,0,0,0,0,0,0,0,0,0,0,0,0,0,20000,20000,0,0,2021-06-09
4956,088218,南茂統一0A購01,0,0,0,0,0,0,0,0,0,0,0,0,0,29000,29000,0,0,2021-06-09
4957,088015,潤泰新兆豐09購01,0,0,0,0,0,0,0,0,0,0,0,0,0,10000,10000,0,0,2021-06-09
4958,00732,國泰RMB短期報酬,0,0,0,0,0,0,0,0,0,0,0,0,0,100000,100000,0,0,2021-06-09
4959,00774B,新光中國政金綠債,0,0,0,0,0,0,0,0,0,0,0,0,0,2000,2000,0,0,2021-06-09
4960,00743,國泰中國A150,0,20000,-20000,0,0,0,0,0,0,20000,0,0,0,120000,100000,20000,0,2021-06-09
4961,00668K,國泰美國道瓊+U,0,0,0,0,0,0,0,0,0,0,0,0,0,200,200,0,0,2021-06-09
4962,00666R,富邦恒生國企反1,0,1000,-1000,0,0,0,0,0,0,1000,0,0,0,71000,70000,1000,0,2021-06-09
4963,00775B,新光投等債15+,0,0,0,0,0,0,0,0,0,0,0,0,0,2000,2000,0,0,2021-06-09
4964,02001L,富邦蘋果正二N,0,0,0,0,0,0,0,0,0,0,0,0,0,2000,2000,0,0,2021-06-09
4965,006204,永豐臺灣加權,0,0,0,0,0,0,0,0,0,0,0,0,0,20000,20000,0,0,2021-06-09
4966,00636K,國泰中國A50+U,0,0,0,0,0,0,0,0,0,0,0,0,0,200,200,0,0,2021-06-09
4967,00657K,國泰日經225+U,0,0,0,0,0,0,0,0,0,0,0,0,0,600,600,0,0,2021-06-09
4968,031197,彩晶兆豐0A購03,0,0,0,0,0,0,0,0,0,0,0,0,0,10000,10000,0,0,2021-06-09
4969,031191,永豐餘兆豐0A購01,0,0,0,0,0,0,0,0,0,0,0,0,0,42000,42000,0,0,2021-06-09
4970,031367,中鋼永豐0A購02,0,0,0,0,0,0,0,0,0,0,0,0,0,10000,10000,0,0,2021-06-09
4971,030502,群創兆豐0A購01,0,0,0,0,0,0,0,0,0,0,0,0,0,10000,10000,0,0,2021-06-09
4972,030496,東鋼兆豐0A購01,0,0,0,0,0,0,0,0,0,0,0,0,0,10000,10000,0,0,2021-06-09
4973,031137,中鋼日盛0A購01,0,0,0,0,0,0,0,0,0,0,0,0,0,10000,10000,0,0,2021-06-09
4974,031138,中鋼日盛0B購01,0,0,0,0,0,0,0,0,0,0,0,0,0,10000,10000,0,0,2021-06-09
4975,030681,中鋼兆豐0A購01,0,0,0,0,0,0,0,0,0,0,0,0,0,10000,10000,0,0,2021-06-09
4976,030695,大成鋼群益0B購01,0,0,0,0,0,0,0,0,0,0,0,0,0,2000,2000,0,0,2021-06-09
4977,032657,南亞麥證0C購01,0,0,0,140000,140000,0,0,0,0,0,0,0,0,140000,140000,0,0,2021-06-09
4978,032799,達方元大0C購01,0,0,0,0,0,0,0,0,0,0,0,0,0,1000,1000,0,0,2021-06-09
4979,031610,聯電康和0A購03,0,0,0,0,0,0,0,0,0,0,0,0,0,10000,10000,0,0,2021-06-09
4980,030651,遠東新永豐0A購01,0,0,0,0,0,0,0,0,0,0,0,0,0,10000,10000,0,0,2021-06-09
4981,030982,宏達電元大11購01,0,0,0,0,0,0,0,0,0,0,0,0,0,100000,100000,0,0,2021-06-09
4982,030966,大成鋼元大0A購05,0,0,0,0,0,0,0,0,0,0,0,0,0,8000,8000,0,0,2021-06-09
4983,032566,富邦金群益0C購03,0,0,0,0,0,0,0,0,0,0,0,0,0,363000,363000,0,0,2021-06-09
4984,032567,玉晶光群益12購01,0,0,0,0,0,0,0,0,0,0,0,0,0,8000,8000,0,0,2021-06-09
4985,032613,祥碩元大0A購04,0,0,0,0,0,0,0,0,0,0,0,0,0,150000,150000,0,0,2021-06-09
4986,031725,玉晶光群益0C購02,0,0,0,0,0,0,0,0,0,0,0,0,0,12000,12000,0,0,2021-06-09
4987,031719,新光鋼群益0B購02,0,0,0,0,0,0,0,0,0,0,0,0,0,1000,1000,0,0,2021-06-09
4988,05600P,華新科元富08售02,0,0,0,0,0,0,0,0,0,0,0,0,0,10000,10000,0,0,2021-06-09
4989,05544P,台積電元富0A售04,0,0,0,0,0,0,0,0,0,0,0,0,0,10000,10000,0,0,2021-06-09
4990,05660P,華新科元富07售07,0,0,0,0,0,0,0,0,0,0,0,0,0,10000,10000,0,0,2021-06-09
4991,036258,聯成群益0C購01,0,0,0,0,0,0,0,0,0,0,0,0,0,14000,14000,0,0,2021-06-09
4992,036262,中鋼群益12購02,0,0,0,0,0,0,0,0,0,0,0,0,0,5000,5000,0,0,2021-06-09
4993,036297,富邦金元大13購01,0,0,0,0,0,0,0,0,0,0,0,0,0,1000,1000,0,0,2021-06-09
4994,036323,華新科康和11購01,0,0,0,0,0,0,0,0,0,0,0,0,0,5000,5000,0,0,2021-06-09
4995,032058,聯詠國票0B購04,0,0,0,0,0,0,0,0,0,0,0,0,0,20000,20000,0,0,2021-06-09
4996,032079,大成鋼兆豐0B購02,0,0,0,0,0,0,0,0,0,0,0,0,0,10000,10000,0,0,2021-06-09
4997,032245,聯成元大0C購01,0,0,0,0,0,0,0,0,0,0,0,0,0,45000,45000,0,0,2021-06-09
4998,032171,A50正2群益0A購02,0,0,0,0,0,0,0,0,0,0,0,0,0,15000,15000,0,0,2021-06-09
4999,033320,華新凱基0C購02,0,0,0,0,0,0,0,0,0,0,0,0,0,27000,27000,0,0,2021-06-09
5000,033332,新纖永豐0B購02,0,0,0,0,0,0,0,0,0,0,0,0,0,10000,10000,0,0,2021-06-09
5001,032474,長榮航中信0A購03,0,0,0,0,0,0,0,0,0,0,0,0,0,18000,18000,0,0,2021-06-09
5002,032490,明泰兆豐0B購01,0,0,0,0,0,0,0,0,0,0,0,0,0,400000,400000,0,0,2021-06-09
5003,033137,開發金元大13購01,0,0,0,0,0,0,0,0,0,0,0,0,0,55000,55000,0,0,2021-06-09
5004,032342,玉晶光群益0B購03,0,0,0,0,0,0,0,0,0,0,0,0,0,8000,8000,0,0,2021-06-09
5005,033228,聯電康和0B購03,0,0,0,0,0,0,0,0,0,0,0,0,0,100000,100000,0,0,2021-06-09
5006,032349,世紀鋼群益0B購01,0,0,0,0,0,0,0,0,0,0,0,0,0,26000,26000,0,0,2021-06-09
5007,033237,台玻元大0B購03,0,0,0,0,0,0,0,0,0,0,0,0,0,10000,10000,0,0,2021-06-09
5008,033234,國喬元大0B購02,0,0,0,0,0,0,0,0,0,0,0,0,0,23000,23000,0,0,2021-06-09
5009,032808,東鋼國票0B購04,0,0,0,0,0,0,0,0,0,0,0,0,0,89000,89000,0,0,2021-06-09
5010,033608,旺宏群益0C購05,0,0,0,0,0,0,0,0,0,0,0,0,0,10000,10000,0,0,2021-06-09
5011,033604,東鋼群益0C購03,0,0,0,0,0,0,0,0,0,0,0,0,0,21000,21000,0,0,2021-06-09
5012,032359,瑞昱凱基0A購03,0,0,0,0,0,0,0,0,0,0,0,0,0,14000,14000,0,0,2021-06-09
5013,033564,鴻準永豐0B購02,0,0,0,0,0,0,0,0,0,0,0,0,0,75000,75000,0,0,2021-06-09
5014,031838,大成鋼兆豐0B購01,0,0,0,0,0,0,0,0,0,0,0,0,0,10000,10000,0,0,2021-06-09
5015,032390,長榮統一0C購10,0,0,0,0,0,0,0,0,0,0,0,0,0,10000,10000,0,0,2021-06-09
5016,033358,上銀群益0C購01,0,0,0,0,0,0,0,0,0,0,0,0,0,30000,30000,0,0,2021-06-09
5017,033428,台灣5G元大11購02,0,0,0,0,0,0,0,0,0,0,0,0,0,20000,20000,0,0,2021-06-09
5018,033423,玉晶光永豐0B購01,0,0,0,0,0,0,0,0,0,0,0,0,0,8000,8000,0,0,2021-06-09
5019,033387,台航元大0B購03,0,0,0,0,0,0,0,0,0,0,0,0,0,10000,10000,0,0,2021-06-09
5020,033371,滬深2X元大13購01,0,0,0,0,0,0,0,0,0,0,0,0,0,50000,50000,0,0,2021-06-09
5021,033375,華新元大11購01,0,0,0,0,0,0,0,0,0,0,0,0,0,8000,8000,0,0,2021-06-09
5022,033529,富邦金國票0B購01,0,0,0,0,0,0,0,0,0,0,0,0,0,1000,1000,0,0,2021-06-09
5023,033441,長榮航元大0B購04,0,0,0,0,0,0,0,0,0,0,0,0,0,8000,8000,0,0,2021-06-09
5024,036389,華新國泰12購01,0,0,0,0,0,0,0,0,0,0,0,0,0,19000,19000,0,0,2021-06-09
5025,036390,華新國泰12購02,0,0,0,0,0,0,0,0,0,0,0,0,0,7000,7000,0,0,2021-06-09
5026,036374,聯詠國票11購01,0,0,0,0,0,0,0,0,0,0,0,0,0,32000,32000,0,0,2021-06-09
5027,036371,宏達電國票11購01,0,0,0,0,0,0,0,0,0,0,0,0,0,4000,4000,0,0,2021-06-09
5028,036353,聯電國票11購04,0,0,0,0,0,0,0,0,0,0,0,0,0,1000,1000,0,0,2021-06-09
5029,036354,聯電國票13購01,0,0,0,0,0,0,0,0,0,0,0,0,0,1000,1000,0,0,2021-06-09
5030,036346,聯成國票11購01,0,0,0,0,0,0,0,0,0,0,0,0,0,14000,14000,0,0,2021-06-09
5031,036348,中興電國票11購01,0,0,0,0,0,0,0,0,0,0,0,0,0,2000,2000,0,0,2021-06-09
5032,036362,旺宏國票11購01,0,0,0,0,0,0,0,0,0,0,0,0,0,1000,1000,0,0,2021-06-09
5033,06333P,台灣50台新08售03,0,0,0,0,0,0,0,0,0,0,0,0,0,100000,100000,0,0,2021-06-09
5034,06326P,南電元大08售07,0,0,0,0,0,0,0,0,0,0,0,0,0,20000,20000,0,0,2021-06-09
5035,06355P,南電元富08售05,0,0,0,0,0,0,0,0,0,0,0,0,0,2000,2000,0,0,2021-06-09
5036,036430,技嘉凱基0C購02,0,0,0,0,0,0,0,0,0,0,0,0,0,21000,21000,0,0,2021-06-09
5037,036451,華新康和11購01,0,0,0,0,0,0,0,0,0,0,0,0,0,19000,19000,0,0,2021-06-09
5038,036444,聯成元富0C購01,0,0,0,0,0,0,0,0,0,0,0,0,0,4000,4000,0,0,2021-06-09
5039,036406,聯電群益12購01,0,0,0,0,0,0,0,0,0,0,0,0,0,1000,1000,0,0,2021-06-09
5040,036393,聯發科國泰12購03,0,0,0,0,0,0,0,0,0,0,0,0,0,21000,21000,0,0,2021-06-09
5041,036461,儒鴻元大0C購03,0,0,0,0,0,0,0,0,0,0,0,0,0,20000,20000,0,0,2021-06-09
5042,036462,儒鴻元大0C購04,0,0,0,0,0,0,0,0,0,0,0,0,0,20000,20000,0,0,2021-06-09
5043,036480,創意元大0C購02,0,0,0,0,0,0,0,0,0,0,0,0,0,100000,100000,0,0,2021-06-09
5044,036516,國喬群益0C購02,0,0,0,0,0,0,0,0,0,0,0,0,0,9000,9000,0,0,2021-06-09
5045,036522,TPK群益0C購01,0,0,0,0,0,0,0,0,0,0,0,0,0,1000,1000,0,0,2021-06-09
5046,036562,欣興元大0C購05,0,0,0,0,0,0,0,0,0,0,0,0,0,20000,20000,0,0,2021-06-09
5047,036557,長榮航元大11購04,0,0,0,0,0,0,0,0,0,0,0,0,0,20000,20000,0,0,2021-06-09
5048,036559,長榮航元大12購02,0,0,0,0,0,0,0,0,0,0,0,0,0,20000,20000,0,0,2021-06-09
5049,036565,健策元大0C購02,0,0,0,0,0,0,0,0,0,0,0,0,0,2000,2000,0,0,2021-06-09
5050,035422,聯電元大0B購05,0,0,0,0,0,0,0,0,0,0,0,0,0,1000,1000,0,0,2021-06-09
5051,035401,儒鴻元富0C購04,0,0,0,0,0,0,0,0,0,0,0,0,0,10000,10000,0,0,2021-06-09
5052,036059,允強群益0C購01,0,0,0,0,0,0,0,0,0,0,0,0,0,5000,5000,0,0,2021-06-09
5053,036025,允強統一0C購03,0,0,0,0,0,0,0,0,0,0,0,0,0,5000,5000,0,0,2021-06-09
5054,036080,國喬元大0C購05,0,0,0,0,0,0,0,0,0,0,0,0,0,38000,38000,0,0,2021-06-09
5055,035019,中興電凱基0B購04,0,0,0,0,0,0,0,0,0,0,0,0,0,2000,2000,0,0,2021-06-09
5056,035158,東鋼國票11購01,0,0,0,0,0,0,0,0,0,0,0,0,0,96000,96000,0,0,2021-06-09
5057,035174,中信金國票0B購02,0,0,0,0,0,0,0,0,0,0,0,0,0,4000,4000,0,0,2021-06-09
5058,035096,萬海凱基11購03,0,0,0,0,0,0,0,0,0,0,0,0,0,3000,3000,0,0,2021-06-09
5059,035105,富邦金元大0C購03,0,0,0,0,0,0,0,0,0,0,0,0,0,1000,1000,0,0,2021-06-09
5060,035248,祥碩群益0B購03,0,0,0,0,0,0,0,0,0,0,0,0,0,2000,2000,0,0,2021-06-09
5061,05797P,聯電元大07售06,0,0,0,0,0,0,0,0,0,0,0,0,0,2426000,2426000,0,0,2021-06-09
5062,05767P,台灣50群益07售09,0,0,0,0,0,0,0,0,0,0,0,0,0,10000,10000,0,0,2021-06-09
5063,035325,富邦金元大0B購06,0,0,0,0,0,0,0,0,0,0,0,0,0,1000,1000,0,0,2021-06-09
5064,034319,華新群益0C購03,0,0,0,0,0,0,0,0,0,0,0,0,0,8000,8000,0,0,2021-06-09
5065,034324,中鋼群益0C購05,0,0,0,0,0,0,0,0,0,0,0,0,0,10000,10000,0,0,2021-06-09
5066,034315,滬深2X群益0B購01,0,0,0,0,0,0,0,0,0,0,0,0,0,26000,26000,0,0,2021-06-09
5067,034804,群創凱基11購04,0,0,0,0,0,0,0,0,0,0,0,0,0,5000,5000,0,0,2021-06-09
5068,035446,華新國票0C購02,0,0,0,0,0,0,0,0,0,0,0,0,0,33000,33000,0,0,2021-06-09
5069,034276,聯電富邦13購03,0,0,0,0,0,0,0,0,0,0,0,0,0,800000,800000,0,0,2021-06-09
5070,035453,聯發科國票0B購09,0,0,0,0,0,0,0,0,0,0,0,0,0,1000,1000,0,0,2021-06-09
5071,035454,聯發科國票0C購08,0,0,0,0,0,0,0,0,0,0,0,0,0,2000,2000,0,0,2021-06-09
5072,035459,富邦金國票0B購05,0,0,0,0,0,0,0,0,0,0,0,0,0,1000,1000,0,0,2021-06-09
5073,035700,聯成元大0B購04,0,0,0,0,0,0,0,0,0,0,0,0,0,26000,26000,0,0,2021-06-09
5074,035718,富邦金元大0B購08,0,0,0,0,0,0,0,0,0,0,0,0,0,1000,1000,0,0,2021-06-09
5075,035732,儒鴻國票0B購02,0,0,0,0,0,0,0,0,0,0,0,0,0,30000,30000,0,0,2021-06-09
5076,035498,富邦金國泰12購01,0,0,0,0,0,0,0,0,0,0,0,0,0,1000,1000,0,0,2021-06-09
5077,035618,中興電國票0C購01,0,0,0,0,0,0,0,0,0,0,0,0,0,2000,2000,0,0,2021-06-09
5078,035626,智原國票0C購02,0,0,0,0,0,0,0,0,0,0,0,0,0,34000,34000,0,0,2021-06-09
5079,035664,聯電統一0B購13,0,0,0,0,0,0,0,0,0,0,0,0,0,1000,1000,0,0,2021-06-09
5080,035930,聯成凱基0C購01,0,0,0,0,0,0,0,0,0,0,0,0,0,4000,4000,0,0,2021-06-09
5081,035875,華新群益0B購04,0,0,0,0,0,0,0,0,0,0,0,0,0,18000,18000,0,0,2021-06-09
5082,035885,東鋼國票11購02,0,0,0,0,0,0,0,0,0,0,0,0,0,2000,2000,0,0,2021-06-09
5083,035890,祥碩國票0B購03,0,0,0,0,0,0,0,0,0,0,0,0,0,11000,11000,0,0,2021-06-09
5084,035891,祥碩國票11購01,0,0,0,0,0,0,0,0,0,0,0,0,0,11000,11000,0,0,2021-06-09
5085,035842,富邦金元大0B購10,0,0,0,0,0,0,0,0,0,0,0,0,0,1000,1000,0,0,2021-06-09
5086,036124,嘉澤群益12購01,0,0,0,0,0,0,0,0,0,0,0,0,0,20000,20000,0,0,2021-06-09
5087,036130,宏碁凱基11購02,0,0,0,0,0,0,0,0,0,0,0,0,0,9000,9000,0,0,2021-06-09
5088,036119,群光群益11購01,0,0,0,0,0,0,0,0,0,0,0,0,0,6000,6000,0,0,2021-06-09
5089,033918,華新元大0B購05,0,0,0,0,0,0,0,0,0,0,0,0,0,14000,14000,0,0,2021-06-09
5090,035984,新光鋼國票11購01,0,0,0,0,0,0,0,0,0,0,0,0,0,6000,6000,0,0,2021-06-09
5091,033991,奇力新兆豐0B購01,0,0,0,0,0,0,0,0,0,0,0,0,0,10000,10000,0,0,2021-06-09
5092,033937,臺股指元大0B購17,0,0,0,0,0,0,0,0,0,0,0,0,0,5000,5000,0,0,2021-06-09
5093,033931,富邦金元大11購03,0,0,0,0,0,0,0,0,0,0,0,0,0,3000,3000,0,0,2021-06-09
5094,034460,中信金群益0B購01,0,0,0,0,0,0,0,0,0,0,0,0,0,8000,8000,0,0,2021-06-09
5095,034482,國巨元大0C購09,0,0,0,0,0,0,0,0,0,0,0,0,0,138000,138000,0,0,2021-06-09
5096,034383,國巨元大0B購09,0,0,0,0,0,0,0,0,0,0,0,0,0,227000,227000,0,0,2021-06-09
5097,034370,華新元大0B購06,0,0,0,0,0,0,0,0,0,0,0,0,0,14000,14000,0,0,2021-06-09
5098,034533,華新統一11購04,0,0,0,0,0,0,0,0,0,0,0,0,0,42000,42000,0,0,2021-06-09
5099,034705,臺股指群益0B購04,0,0,0,0,0,0,0,0,0,0,0,0,0,7000,7000,0,0,2021-06-09
5100,034697,富邦金群益0C購04,0,0,0,0,0,0,0,0,0,0,0,0,0,1000,1000,0,0,2021-06-09
5101,034730,鴻海元大0C購12,0,0,0,0,0,0,0,0,0,0,0,0,0,5000,5000,0,0,2021-06-09
5102,033837,群創國泰11購01,0,0,0,0,0,0,0,0,0,0,0,0,0,100000,100000,0,0,2021-06-09
5103,033835,萬海國泰11購01,0,0,0,0,0,0,0,0,0,0,0,0,0,1000,1000,0,0,2021-06-09
5104,05839P,臺股指元大0A售01,0,0,0,0,0,0,0,0,0,0,0,0,0,2000,2000,0,0,2021-06-09
5105,034257,萬海統一11購02,0,0,0,0,0,0,0,0,0,0,0,0,0,1000,1000,0,0,2021-06-09
5106,034104,新光鋼群益0B購05,0,0,0,0,0,0,0,0,0,0,0,0,0,10000,10000,0,0,2021-06-09
5107,034074,亞德客元大0B購02,0,0,0,0,0,0,0,0,0,0,0,0,0,35000,35000,0,0,2021-06-09
5108,034154,瀚宇博凱基0B購01,0,0,0,0,0,0,0,0,0,0,0,0,0,8000,8000,0,0,2021-06-09
5109,034171,玉晶光永豐0B購03,0,0,0,0,0,0,0,0,0,0,0,0,0,7000,7000,0,0,2021-06-09
5110,034189,新光鋼元大11購01,0,0,0,0,0,0,0,0,0,0,0,0,0,3000,3000,0,0,2021-06-09
5111,034191,允強元大0B購02,0,0,0,0,0,0,0,0,0,0,0,0,0,4000,4000,0,0,2021-06-09
5112,06157P,台積電國票08售17,0,0,0,0,0,0,0,0,0,0,0,0,0,321000,321000,0,0,2021-06-09
5113,06166P,台積電凱基08售17,0,0,0,0,0,0,0,0,0,0,0,0,0,20000,20000,0,0,2021-06-09
5114,06170P,鴻海元大08售08,0,0,0,0,0,0,0,0,0,0,0,0,0,84000,84000,0,0,2021-06-09
5115,06105P,台積電凱基07售19,0,0,0,0,0,0,0,0,0,0,0,0,0,14000,14000,0,0,2021-06-09
5116,06246P,聯詠元大08售01,0,0,0,0,0,0,0,0,0,0,0,0,0,994000,994000,0,0,2021-06-09
5117,06257P,鴻海台新08售02,0,0,0,0,0,0,0,0,0,0,0,0,0,100000,100000,0,0,2021-06-09
5118,05988P,鴻海元富07售31,0,0,0,0,0,0,0,0,0,0,0,0,0,300000,300000,0,0,2021-06-09
5119,034444,健策凱基0B購01,0,0,0,0,0,0,0,0,0,0,0,0,0,1000,1000,0,0,2021-06-09
5120,033873,玉晶光群益0C購03,0,0,0,0,0,0,0,0,0,0,0,0,0,19000,19000,0,0,2021-06-09
5121,034411,華新統一11購03,0,0,0,0,0,0,0,0,0,0,0,0,0,2000,2000,0,0,2021-06-09
5122,035601,富邦金元大0B購07,0,0,0,0,0,0,0,0,0,0,0,0,0,1000,1000,0,0,2021-06-09
5123,035591,聯電元大0B購06,0,0,0,0,0,0,0,0,0,0,0,0,0,1000,1000,0,0,2021-06-09
5124,034952,萬海凱基11購02,0,0,0,0,0,0,0,0,0,0,0,0,0,4000,4000,0,0,2021-06-09
5125,034954,玉晶光凱基0B購05,0,0,0,0,0,0,0,0,0,0,0,0,0,1000,1000,0,0,2021-06-09
5126,035617,聯成國票0C購01,0,0,0,0,0,0,0,0,0,0,0,0,0,18000,18000,0,0,2021-06-09
5127,034985,新光鋼群益0B購07,0,0,0,0,0,0,0,0,0,0,0,0,0,21000,21000,0,0,2021-06-09
5128,034978,華新科富邦0B購01,0,0,0,0,0,0,0,0,0,0,0,0,0,5000,5000,0,0,2021-06-09
5129,034970,玉晶光元大12購03,0,0,0,0,0,0,0,0,0,0,0,0,0,3000,3000,0,0,2021-06-09
5130,033689,富邦金元大12購01,0,0,0,0,0,0,0,0,0,0,0,0,0,4000,4000,0,0,2021-06-09
5131,033723,富邦金國票0C購01,0,0,0,0,0,0,0,0,0,0,0,0,0,2000,2000,0,0,2021-06-09
5132,033665,玉晶光統一13購01,0,0,0,0,0,0,0,0,0,0,0,0,0,17000,17000,0,0,2021-06-09
5133,033646,華新統一15購01,0,0,0,0,0,0,0,0,0,0,0,0,0,45000,45000,0,0,2021-06-09
5134,033624,鴻準元富0B購02,0,0,0,0,0,0,0,0,0,0,0,0,0,10000,10000,0,0,2021-06-09
5135,036147,允強元大12購01,0,0,0,0,0,0,0,0,0,0,0,0,0,5000,5000,0,0,2021-06-09
5136,036137,聯電兆豐12購01,0,0,0,0,0,0,0,0,0,0,0,0,0,1000,1000,0,0,2021-06-09
5137,035568,佳世達元富0C購02,0,0,0,0,0,0,0,0,0,0,0,0,0,10000,10000,0,0,2021-06-09
5138,036160,晶技元大0C購03,0,0,0,0,0,0,0,0,0,0,0,0,0,9000,9000,0,0,2021-06-09
5139,036171,華新麥證11購01,0,0,0,24000,0,24000,0,0,0,0,0,0,0,24000,24000,0,0,2021-06-09
5140,034939,旺宏群益11購03,0,0,0,0,0,0,0,0,0,0,0,0,0,1000,1000,0,0,2021-06-09
5141,034900,國喬元大0B購04,0,0,0,0,0,0,0,0,0,0,0,0,0,26000,26000,0,0,2021-06-09
5142,034909,聯發科元大0B購10,0,0,0,0,0,0,0,0,0,0,0,0,0,77000,77000,0,0,2021-06-09
5143,035513,正新永豐0B購01,0,0,0,0,0,0,0,0,0,0,0,0,0,14000,14000,0,0,2021-06-09
5144,034798,華新凱基0B購03,0,0,0,0,0,0,0,0,0,0,0,0,0,25000,25000,0,0,2021-06-09
5145,035524,儒鴻群益0B購01,0,0,0,0,0,0,0,0,0,0,0,0,0,22000,22000,0,0,2021-06-09
5146,035519,玉晶光永豐0B購06,0,0,0,0,0,0,0,0,0,0,0,0,0,14000,14000,0,0,2021-06-09
5147,035520,愛普永豐0B購03,0,1000,-1000,0,0,0,0,0,0,1000,0,0,0,1000,0,1000,0,2021-06-09
5148,035543,聯電統一0C購08,0,0,0,0,0,0,0,0,0,0,0,0,0,1000,1000,0,0,2021-06-09
5149,083371,旺宏國票09購01,0,0,0,0,0,0,0,0,0,0,0,0,0,1000,1000,0,0,2021-06-09
5150,083353,聯電永豐07購04,0,0,0,0,0,0,0,0,0,0,0,0,0,72000,72000,0,0,2021-06-09
5151,07027P,臺股指凱基0B售09,0,0,0,0,0,0,0,0,0,0,0,0,0,40000,40000,0,0,2021-06-09
5152,07028P,臺股指凱基0B售10,0,0,0,0,0,0,0,0,0,0,0,0,0,60000,60000,0,0,2021-06-09
5153,07167P,裕民元富12售06,0,0,0,0,0,0,0,0,0,0,0,0,0,2000,2000,0,0,2021-06-09
5154,071448,矽力統一07購01,0,0,0,0,0,0,0,0,0,0,0,0,0,2000,2000,0,0,2021-06-09
5155,069696,國巨元富08購04,0,0,0,0,0,0,0,0,0,0,0,0,0,10000,10000,0,0,2021-06-09
5156,069045,國巨元富08購01,0,0,0,0,0,0,0,0,0,0,0,0,0,4000,4000,0,0,2021-06-09
5157,06990P,聯發科康和11售02,0,0,0,0,0,0,0,0,0,0,0,0,0,10000,10000,0,0,2021-06-09
5158,06453P,鴻海富邦0B售02,0,0,0,0,0,0,0,0,0,0,0,0,0,100000,100000,0,0,2021-06-09
5159,06470P,華新科元富0A售04,0,0,0,0,0,0,0,0,0,0,0,0,0,10000,10000,0,0,2021-06-09
5160,06561P,台灣50元富09售04,0,0,0,0,0,0,0,0,0,0,0,0,0,19000,19000,0,0,2021-06-09
5161,065622,鴻海中信06購01,0,0,0,0,0,0,0,0,0,0,0,0,0,9000,9000,0,0,2021-06-09
5162,06817P,華邦電凱基0A售08,0,0,0,0,0,0,0,0,0,0,0,0,0,10000,10000,0,0,2021-06-09
5163,06797P,群創康和0A售03,0,0,0,0,0,0,0,0,0,0,0,0,0,10000,10000,0,0,2021-06-09
5164,067842,微星元富07購01,0,0,0,0,0,0,0,0,0,0,0,0,0,30000,30000,0,0,2021-06-09
5165,06609P,台灣50凱基09售11,0,0,0,0,0,0,0,0,0,0,0,0,0,105000,105000,0,0,2021-06-09
5166,072979,鴻海元富07購14,0,0,0,0,0,0,0,0,0,0,0,0,0,100000,100000,0,0,2021-06-09
5167,07276P,臺股指元大0C售32,0,0,0,0,0,0,0,0,0,0,0,0,0,3000,3000,0,0,2021-06-09
5168,073755,台積電元富08購24,0,0,0,0,0,0,0,0,0,0,0,0,0,10000,10000,0,0,2021-06-09
5169,072055,英業達元富09購01,0,0,0,0,0,0,0,0,0,0,0,0,0,10000,10000,0,0,2021-06-09
5170,074167,聯電統一06購07,0,0,0,0,0,0,0,0,0,0,0,0,0,1000,1000,0,0,2021-06-09
5171,074234,鴻海凱基07購01,0,0,0,0,0,0,0,0,0,0,0,0,0,5000,5000,0,0,2021-06-09
5172,074276,鴻海國泰06購02,0,0,0,0,0,0,0,0,0,0,0,0,0,50000,50000,0,0,2021-06-09
5173,074359,順德元富07購04,0,0,0,0,0,0,0,0,0,0,0,0,0,3000,3000,0,0,2021-06-09
5174,075948,台積電國泰08購01,0,0,0,0,0,0,0,0,0,0,0,0,0,1000,1000,0,0,2021-06-09
5175,075971,創意統一07購02,0,0,0,0,0,0,0,0,0,0,0,0,0,10000,10000,0,0,2021-06-09
5176,076001,聯發科兆豐07購01,0,0,0,0,0,0,0,0,0,0,0,0,0,450000,450000,0,0,2021-06-09
5177,076008,滬深2X元大06購02,0,0,0,0,0,0,0,0,0,0,0,0,0,200000,200000,0,0,2021-06-09
5178,076069,亞德客元富0B購01,0,0,0,0,0,0,0,0,0,0,0,0,0,27000,27000,0,0,2021-06-09
5179,075849,創意富邦07購01,0,0,0,0,0,0,0,0,0,0,0,0,0,30000,30000,0,0,2021-06-09
5180,076439,惠特國票07購01,0,0,0,0,0,0,0,0,0,0,0,0,0,200000,200000,0,0,2021-06-09
5181,076430,道瓊銀國票06購02,0,0,0,0,0,0,0,0,0,0,0,0,0,20000,20000,0,0,2021-06-09
5182,076834,台泥兆豐06購01,0,0,0,0,0,0,0,0,0,0,0,0,0,77000,77000,0,0,2021-06-09
5183,076835,台積電兆豐06購04,0,0,0,0,0,0,0,0,0,0,0,0,0,376000,376000,0,0,2021-06-09
5184,077177,聯電富邦06購03,0,0,0,0,0,0,0,0,0,0,0,0,0,10000,10000,0,0,2021-06-09
5185,077205,台積電兆豐06購05,0,0,0,0,0,0,0,0,0,0,0,0,0,992000,992000,0,0,2021-06-09
5186,077643,景碩國票07購01,0,0,0,0,0,0,0,0,0,0,0,0,0,1000,1000,0,0,2021-06-09
5187,077648,金像電統一07購01,0,0,0,0,0,0,0,0,0,0,0,0,0,45000,45000,0,0,2021-06-09
5188,077795,日月光凱基07購01,0,0,0,0,0,0,0,0,0,0,0,0,0,22000,22000,0,0,2021-06-09
5189,078110,聯電元富08購03,0,0,0,0,0,0,0,0,0,0,0,0,0,180000,180000,0,0,2021-06-09
5190,078205,同欣電元大07購01,0,0,0,0,0,0,0,0,0,0,0,0,0,20000,20000,0,0,2021-06-09
5191,078892,智原元大07購01,0,0,0,0,0,0,0,0,0,0,0,0,0,11000,11000,0,0,2021-06-09
5192,078783,鴻海日盛06購01,0,0,0,0,0,0,0,0,0,0,0,0,0,10000,10000,0,0,2021-06-09
5193,078784,鴻海日盛07購01,0,0,0,0,0,0,0,0,0,0,0,0,0,20000,20000,0,0,2021-06-09
5194,079012,台灣50元大06購08,0,0,0,0,0,0,0,0,0,0,0,0,0,350000,350000,0,0,2021-06-09
5195,079026,鴻海元大06購11,0,0,0,0,0,0,0,0,0,0,0,0,0,10000,10000,0,0,2021-06-09
5196,078970,群創兆豐06購02,0,0,0,0,0,0,0,0,0,0,0,0,0,843000,843000,0,0,2021-06-09
5197,078957,新興群益06購01,0,0,0,0,0,0,0,0,0,0,0,0,0,2000,2000,0,0,2021-06-09
5198,078963,東鋼兆豐06購01,0,0,0,0,0,0,0,0,0,0,0,0,0,119000,119000,0,0,2021-06-09
5199,078691,鴻海國泰08購03,0,0,0,0,0,0,0,0,0,0,0,0,0,9000,9000,0,0,2021-06-09
5200,078291,智原國票07購01,0,0,0,0,0,0,0,0,0,0,0,0,0,20000,20000,0,0,2021-06-09
5201,078299,聯電兆豐07購02,0,0,0,0,0,0,0,0,0,0,0,0,0,10000,10000,0,0,2021-06-09
5202,079799,南亞科凱基06購04,0,0,0,0,0,0,0,0,0,0,0,0,0,4000,4000,0,0,2021-06-09
5203,079868,華邦電統一08購03,0,0,0,0,0,0,0,0,0,0,0,0,0,238000,238000,0,0,2021-06-09
5204,079876,聯電元富06購11,0,0,0,0,0,0,0,0,0,0,0,0,0,20000,20000,0,0,2021-06-09
5205,079452,友達元富09購05,0,0,0,0,0,0,0,0,0,0,0,0,0,1000,1000,0,0,2021-06-09
5206,079529,宏達電元大06購03,0,0,0,0,0,0,0,0,0,0,0,0,0,30000,30000,0,0,2021-06-09
5207,079640,長榮兆豐06購02,0,0,0,0,0,0,0,0,0,0,0,0,0,248000,248000,0,0,2021-06-09
5208,079308,臺股指富邦06購01,0,0,0,0,0,0,0,0,0,0,0,0,0,200000,200000,0,0,2021-06-09
5209,079277,國泰金國票07購01,0,0,0,0,0,0,0,0,0,0,0,0,0,140000,140000,0,0,2021-06-09
5210,079281,TPK國票07購01,0,0,0,0,0,0,0,0,0,0,0,0,0,1000,1000,0,0,2021-06-09
5211,079429,長榮統一07購03,0,0,0,0,0,0,0,0,0,0,0,0,0,1020000,1020000,0,0,2021-06-09
5212,079338,長榮麥證06購02,0,0,0,116000,0,116000,0,0,0,0,0,0,0,116000,116000,0,0,2021-06-09
5213,079215,鴻海凱基06購07,0,0,0,0,0,0,0,0,0,0,0,0,0,700000,700000,0,0,2021-06-09
5214,079232,臺股指凱基06購28,0,0,0,0,0,0,0,0,0,0,0,0,0,68000,68000,0,0,2021-06-09
5215,079139,智邦元大07購01,0,0,0,0,0,0,0,0,0,0,0,0,0,7000,7000,0,0,2021-06-09
5216,079143,金像電元大06購02,0,0,0,0,0,0,0,0,0,0,0,0,0,190000,190000,0,0,2021-06-09
5217,079065,台達電國泰08購01,0,0,0,0,0,0,0,0,0,0,0,0,0,20000,20000,0,0,2021-06-09
5218,080222,中纖元大08購01,0,0,0,0,0,0,0,0,0,0,0,0,0,13000,13000,0,0,2021-06-09
5219,080422,大成鋼富邦06購01,0,0,0,0,0,0,0,0,0,0,0,0,0,120000,120000,0,0,2021-06-09
5220,080542,宏達電統一08購01,0,0,0,0,0,0,0,0,0,0,0,0,0,100000,100000,0,0,2021-06-09
5221,079935,鴻海日盛07購02,0,0,0,0,0,0,0,0,0,0,0,0,0,88000,88000,0,0,2021-06-09
5222,080043,新興永豐06購03,0,0,0,0,0,0,0,0,0,0,0,0,0,250000,250000,0,0,2021-06-09
5223,079909,金像電國泰08購02,0,0,0,0,0,0,0,0,0,0,0,0,0,30000,30000,0,0,2021-06-09
5224,079899,長榮國票07購09,0,0,0,0,0,0,0,0,0,0,0,0,0,55000,55000,0,0,2021-06-09
5225,080177,長榮統一07購05,0,0,0,0,0,0,0,0,0,0,0,0,0,260000,260000,0,0,2021-06-09
5226,080178,長榮統一07購06,0,0,0,0,0,0,0,0,0,0,0,0,0,92000,92000,0,0,2021-06-09
5227,080180,萬海統一07購06,0,0,0,0,0,0,0,0,0,0,0,0,0,1000,1000,0,0,2021-06-09
5228,081238,儒鴻元富08購03,0,0,0,0,0,0,0,0,0,0,0,0,0,9000,9000,0,0,2021-06-09
5229,081303,順德元大07購01,0,0,0,0,0,0,0,0,0,0,0,0,0,100000,100000,0,0,2021-06-09
5230,081089,群創中信09購02,0,0,0,0,0,0,0,0,0,0,0,0,0,4000,4000,0,0,2021-06-09
5231,080785,上証2X凱基09購01,0,0,0,0,0,0,0,0,0,0,0,0,0,100000,100000,0,0,2021-06-09
5232,080982,聯茂元大07購01,0,0,0,0,0,0,0,0,0,0,0,0,0,15000,15000,0,0,2021-06-09
5233,080916,台灣大凱基09購01,0,0,0,0,0,0,0,0,0,0,0,0,0,5000,5000,0,0,2021-06-09
5234,080580,緯創元富08購01,0,0,0,0,0,0,0,0,0,0,0,0,0,4000,4000,0,0,2021-06-09
5235,080615,華邦電元富06購03,0,0,0,0,0,0,0,0,0,0,0,0,0,165000,165000,0,0,2021-06-09
5236,080602,日月光統一08購02,0,0,0,0,0,0,0,0,0,0,0,0,0,90000,90000,0,0,2021-06-09
5237,080621,長榮元富06購05,0,0,0,0,0,0,0,0,0,0,0,0,0,460000,460000,0,0,2021-06-09
5238,080731,華邦電兆豐07購04,0,0,0,0,0,0,0,0,0,0,0,0,0,10000,10000,0,0,2021-06-09
5239,082507,聯電兆豐08購01,0,0,0,0,0,0,0,0,0,0,0,0,0,10000,10000,0,0,2021-06-09
5240,082511,聯發科兆豐08購01,0,0,0,0,0,0,0,0,0,0,0,0,0,464000,464000,0,0,2021-06-09
5241,082488,台積電統一09購04,0,0,0,0,0,0,0,0,0,0,0,0,0,1000,1000,0,0,2021-06-09
5242,082624,中興電國票08購01,0,0,0,0,0,0,0,0,0,0,0,0,0,20000,20000,0,0,2021-06-09
5243,082574,日月光統一09購03,0,0,0,0,0,0,0,0,0,0,0,0,0,41000,41000,0,0,2021-06-09
5244,082566,新興統一09購01,0,0,0,0,0,0,0,0,0,0,0,0,0,38000,38000,0,0,2021-06-09
5245,082668,精英兆豐07購01,0,0,0,0,0,0,0,0,0,0,0,0,0,20000,20000,0,0,2021-06-09
5246,082665,鴻海兆豐09購04,0,0,0,0,0,0,0,0,0,0,0,0,0,10000,10000,0,0,2021-06-09
5247,082698,旺宏凱基07購04,0,0,0,0,0,0,0,0,0,0,0,0,0,5000,5000,0,0,2021-06-09
5248,082851,和碩國票08購01,0,0,0,0,0,0,0,0,0,0,0,0,0,20000,20000,0,0,2021-06-09
5249,083307,欣興元大07購11,0,0,0,0,0,0,0,0,0,0,0,0,0,8000,8000,0,0,2021-06-09
5250,083270,中興電元大07購04,0,0,0,0,0,0,0,0,0,0,0,0,0,2000,2000,0,0,2021-06-09
5251,083052,聯發科兆豐07購07,0,0,0,0,0,0,0,0,0,0,0,0,0,191000,191000,0,0,2021-06-09
5252,083048,滬深2X兆豐08購01,0,0,0,0,0,0,0,0,0,0,0,0,0,10000,10000,0,0,2021-06-09
5253,082875,聯發科兆豐08購02,0,0,0,0,0,0,0,0,0,0,0,0,0,461000,461000,0,0,2021-06-09
5254,082871,大成鋼兆豐07購01,0,0,0,0,0,0,0,0,0,0,0,0,0,129000,129000,0,0,2021-06-09
5255,082951,聯陽元富08購01,0,0,0,0,0,0,0,0,0,0,0,0,0,30000,30000,0,0,2021-06-09
5256,081910,聯發科凱基07購03,0,0,0,0,0,0,0,0,0,0,0,0,0,60000,60000,0,0,2021-06-09
5257,081764,欣興元大09購01,0,0,0,0,0,0,0,0,0,0,0,0,0,5000,5000,0,0,2021-06-09
5258,081772,日月光元大07購02,0,0,0,0,0,0,0,0,0,0,0,0,0,21000,21000,0,0,2021-06-09
5259,081709,聯電統一08購05,0,0,0,0,0,0,0,0,0,0,0,0,0,10000,10000,0,0,2021-06-09
5260,081695,和碩群益07購01,0,0,0,0,0,0,0,0,0,0,0,0,0,10000,10000,0,0,2021-06-09
5261,081543,聯發科永豐07購01,0,0,0,0,0,0,0,0,0,0,0,0,0,320000,320000,0,0,2021-06-09
5262,082183,台表科兆豐08購01,0,0,0,0,0,0,0,0,0,0,0,0,0,20000,20000,0,0,2021-06-09
5263,082265,聯成元大07購02,0,0,0,0,0,0,0,0,0,0,0,0,0,14000,14000,0,0,2021-06-09
5264,082029,大立光麥證07購01,0,0,0,500000,0,500000,0,0,0,0,0,0,0,500000,500000,0,0,2021-06-09
5265,082306,愛普元大07購05,0,0,0,0,0,0,0,0,0,0,0,0,0,1200000,1200000,0,0,2021-06-09
5266,082286,聯發科元大07購17,0,0,0,0,0,0,0,0,0,0,0,0,0,180000,180000,0,0,2021-06-09
5267,082346,聯發科國泰09購03,0,0,0,0,0,0,0,0,0,0,0,0,0,70000,70000,0,0,2021-06-09
5268,082338,南電統一09購04,0,0,0,0,0,0,0,0,0,0,0,0,0,2000,2000,0,0,2021-06-09
5269,082368,宏碁群益07購02,0,0,0,0,0,0,0,0,0,0,0,0,0,170000,170000,0,0,2021-06-09
5270,082421,大立光永豐07購02,0,0,0,0,0,0,0,0,0,0,0,0,0,438000,438000,0,0,2021-06-09
5271,6271,同欣電,150000,187000,-37000,0,0,0,0,0,0,37000,19000,22000,-3000,44000,4000,40000,0,2021-06-09
5272,6776,展碁國際,41000,41000,0,0,0,0,0,0,0,0,0,0,0,0,0,0,0,2021-06-09
5273,8481,政伸,6000,6000,0,0,0,0,0,0,0,0,0,0,0,0,0,0,0,2021-06-09
5274,2466,冠西電,8000,8000,0,0,0,0,0,0,0,0,0,0,0,0,0,0,0,2021-06-09
5275,4555,氣立,2000,2000,0,0,0,0,0,0,0,0,0,0,0,0,0,0,0,2021-06-09
5276,4807,日成-KY,2000,2000,0,0,0,0,0,0,0,0,0,0,0,0,0,0,0,2021-06-09
5277,3015,全漢,88000,88000,0,0,0,0,0,0,0,0,0,0,0,0,0,0,0,2021-06-09
5278,2712,遠雄來,2000,2000,0,0,0,0,0,0,0,0,0,0,0,0,0,0,0,2021-06-09
5279,089739,彩晶永豐09購02,0,0,0,0,0,0,0,0,0,0,0,0,0,10000,10000,0,0,2021-06-09
5280,089730,宏達電永豐09購01,0,0,0,0,0,0,0,0,0,0,0,0,0,280000,280000,0,0,2021-06-09
5281,089731,裕民永豐09購01,0,0,0,0,0,0,0,0,0,0,0,0,0,10000,10000,0,0,2021-06-09
5282,089733,華晶科永豐09購03,0,0,0,0,0,0,0,0,0,0,0,0,0,55000,55000,0,0,2021-06-09
5283,089678,英業達元大09購02,0,0,0,0,0,0,0,0,0,0,0,0,0,14000,14000,0,0,2021-06-09
5284,089709,T50反1中信13購01,0,0,0,0,0,0,0,0,0,0,0,0,0,43000,43000,0,0,2021-06-09
5285,089604,宏碁群益0B購01,0,0,0,0,0,0,0,0,0,0,0,0,0,1000,1000,0,0,2021-06-09
5286,089470,宏達電國票09購02,0,0,0,0,0,0,0,0,0,0,0,0,0,21000,21000,0,0,2021-06-09
5287,089477,力山富邦09購01,0,0,0,0,0,0,0,0,0,0,0,0,0,10000,10000,0,0,2021-06-09
5288,089496,新興元富09購01,0,0,0,0,0,0,0,0,0,0,0,0,0,50000,50000,0,0,2021-06-09
5289,089073,亞光凱基09購04,0,0,0,0,0,0,0,0,0,0,0,0,0,10000,10000,0,0,2021-06-09
5290,089115,祥碩國票0B購02,0,0,0,0,0,0,0,0,0,0,0,0,0,1000,1000,0,0,2021-06-09
5291,089883,東鋼日盛0A購01,0,0,0,0,0,0,0,0,0,0,0,0,0,10000,10000,0,0,2021-06-09
5292,089813,富邦金群益0B購04,0,0,0,0,0,0,0,0,0,0,0,0,0,1000,1000,0,0,2021-06-09
5293,089800,宏達電元富0B購01,0,0,0,0,0,0,0,0,0,0,0,0,0,10000,10000,0,0,2021-06-09
5294,089747,華邦電統一0B購05,0,1000,-1000,0,0,0,0,0,0,1000,0,0,0,1000,0,1000,0,2021-06-09
5295,089760,國巨日盛0B購01,0,0,0,0,0,0,0,0,0,0,0,0,0,499000,499000,0,0,2021-06-09
5296,1203,味王,8000,8000,0,0,0,0,0,0,0,0,0,0,0,0,0,0,0,2021-06-09
5297,089969,凌陽元大0C購01,0,0,0,0,0,0,0,0,0,0,0,0,0,5000,5000,0,0,2021-06-09
5298,089946,南帝富邦0A購01,0,0,0,0,0,0,0,0,0,0,0,0,0,10000,10000,0,0,2021-06-09
5299,1442,名軒,4000,4000,0,0,0,0,0,0,0,0,0,0,0,0,0,0,0,2021-06-09
5300,1525,江申,13000,12000,1000,0,0,0,0,0,0,-1000,0,1000,-1000,0,0,0,0,2021-06-09
5301,008201,BP上證50,0,0,0,0,0,0,0,0,0,-100,0,0,0,0,100,-100,-100,2021-06-09
5302,5871A,中租-KY甲特,0,832,-832,0,0,0,0,0,0,0,0,0,0,0,0,0,-832,2021-06-09
5303,087982,欣興凱基0B購02,0,0,0,0,0,0,0,0,0,-1000,0,0,0,0,1000,-1000,-1000,2021-06-09
5304,088237,微星國票0A購01,0,0,0,0,0,0,0,0,0,-1000,0,0,0,0,1000,-1000,-1000,2021-06-09
5305,088240,聯發科國票11購04,0,0,0,0,0,0,0,0,0,-1000,0,0,0,0,1000,-1000,-1000,2021-06-09
5306,088314,力成凱基0B購01,0,0,0,0,0,0,0,0,0,-1000,0,0,0,0,1000,-1000,-1000,2021-06-09
5307,087721,申豐統一0B購01,0,0,0,0,0,0,0,0,0,-1000,0,0,0,0,1000,-1000,-1000,2021-06-09
5308,087980,大立光凱基09購11,0,0,0,0,0,0,0,0,0,-1000,0,0,0,7000,8000,-1000,-1000,2021-06-09
5309,087959,寶成元富09購01,0,0,0,0,0,0,0,0,0,-1000,0,0,0,2000,3000,-1000,-1000,2021-06-09
5310,087922,金融類群益09購01,0,0,0,0,0,0,0,0,0,-1000,0,0,0,0,1000,-1000,-1000,2021-06-09
5311,088756,新興統一0A購01,0,0,0,0,0,0,0,0,0,-1000,0,0,0,15000,16000,-1000,-1000,2021-06-09
5312,088921,鴻海統一13購03,0,0,0,0,0,0,0,0,0,-1000,0,0,0,0,1000,-1000,-1000,2021-06-09
5313,088362,美指2X元富09購02,0,0,0,0,0,0,0,0,0,-1000,0,0,0,0,1000,-1000,-1000,2021-06-09
5314,088387,京元電富邦0B購01,0,0,0,0,0,0,0,0,0,-1000,0,0,0,9000,10000,-1000,-1000,2021-06-09
5315,088457,玉晶光統一0B購05,0,0,0,0,0,0,0,0,0,-1000,0,0,0,465000,466000,-1000,-1000,2021-06-09
5316,088478,聯詠國票0B購02,0,0,0,0,0,0,0,0,0,-1000,0,0,0,18000,19000,-1000,-1000,2021-06-09
5317,088571,大立光凱基09購12,0,0,0,0,0,0,0,0,0,-1000,0,0,0,0,1000,-1000,-1000,2021-06-09
5318,088610,宏碁永豐09購01,0,0,0,0,0,0,0,0,0,-1000,0,0,0,20000,21000,-1000,-1000,2021-06-09
5319,087322,聯發科永豐09購03,0,0,0,0,0,0,0,0,0,-1000,0,0,0,0,1000,-1000,-1000,2021-06-09
5320,087277,國喬元大0B購01,0,0,0,0,0,0,0,0,0,-1000,0,0,0,0,1000,-1000,-1000,2021-06-09
5321,087543,A50正2元富09購03,0,0,0,0,0,0,0,0,0,-1000,0,0,0,40000,41000,-1000,-1000,2021-06-09
5322,087643,台達化群益0A購02,0,0,0,0,0,0,0,0,0,-1000,0,0,0,2000,3000,-1000,-1000,2021-06-09
5323,087598,台積電第一0C購02,0,0,0,0,0,0,0,0,0,-1000,0,0,0,0,1000,-1000,-1000,2021-06-09
5324,087396,晶豪科元大09購02,0,0,0,0,0,0,0,0,0,-1000,0,0,0,0,1000,-1000,-1000,2021-06-09
5325,087478,國巨永豐09購02,0,0,0,0,0,0,0,0,0,-1000,0,0,0,0,1000,-1000,-1000,2021-06-09
5326,086762,台灣50凱基0B購01,0,0,0,0,0,0,0,0,0,-1000,0,0,0,0,1000,-1000,-1000,2021-06-09
5327,086431,鴻海第一13購01,0,0,0,0,0,0,0,0,0,-1000,0,0,0,0,1000,-1000,-1000,2021-06-09
5328,084702,可成統一08購03,0,0,0,0,0,0,0,0,0,-1000,0,0,0,0,1000,-1000,-1000,2021-06-09
5329,084489,可成凱基08購02,0,0,0,0,0,0,0,0,0,-1000,0,0,0,0,1000,-1000,-1000,2021-06-09
5330,084630,可成凱基09購01,0,0,0,0,0,0,0,0,0,-1000,0,0,0,0,1000,-1000,-1000,2021-06-09
5331,084400,仁寶國票08購01,0,0,0,0,0,0,0,0,0,-1000,0,0,0,0,1000,-1000,-1000,2021-06-09
5332,083773,瑞昱永豐07購02,0,0,0,0,0,0,0,0,0,-1000,0,0,0,0,1000,-1000,-1000,2021-06-09
5333,083442,健策凱基07購02,0,0,0,0,0,0,0,0,0,-1000,0,0,0,0,1000,-1000,-1000,2021-06-09
5334,083546,矽格元大07購02,0,0,0,0,0,0,0,0,0,-1000,0,0,0,10000,11000,-1000,-1000,2021-06-09
5335,083517,旺宏元大07購05,0,0,0,0,0,0,0,0,0,-1000,0,0,0,85000,86000,-1000,-1000,2021-06-09
5336,084037,聯發科元富11購05,0,0,0,0,0,0,0,0,0,-1000,0,0,0,0,1000,-1000,-1000,2021-06-09
5337,084093,大立光元大09購02,0,0,0,0,0,0,0,0,0,-1000,0,0,0,0,1000,-1000,-1000,2021-06-09
5338,083830,聯發科凱基0B購02,0,0,0,0,0,0,0,0,0,-1000,0,0,0,0,1000,-1000,-1000,2021-06-09
5339,085525,日月光富邦09購01,0,0,0,0,0,0,0,0,0,-1000,0,0,0,2000,3000,-1000,-1000,2021-06-09
5340,085694,聯發科國泰0A購06,0,0,0,0,0,0,0,0,0,-1000,0,0,0,0,1000,-1000,-1000,2021-06-09
5341,085265,台達電統一0A購01,0,0,0,0,0,0,0,0,0,-1000,0,0,0,0,1000,-1000,-1000,2021-06-09
5342,086063,大立光統一0B購02,0,0,0,0,0,0,0,0,0,-1000,0,0,0,9000,10000,-1000,-1000,2021-06-09
5343,085847,台積電統一12購01,9000,0,9000,0,0,0,0,0,0,-10000,0,0,0,0,10000,-10000,-1000,2021-06-09
5344,085913,台積電第一0B購01,0,0,0,0,0,0,0,0,0,-1000,0,0,0,0,1000,-1000,-1000,2021-06-09
5345,086412,群創統一0B購01,0,0,0,0,0,0,0,0,0,-1000,0,0,0,0,1000,-1000,-1000,2021-06-09
5346,086356,群創元大09購04,0,0,0,0,0,0,0,0,0,-1000,0,0,0,18000,19000,-1000,-1000,2021-06-09
5347,086204,日月光凱基08購08,0,0,0,0,0,0,0,0,0,-1000,0,0,0,0,1000,-1000,-1000,2021-06-09
5348,02001R,富邦蘋果反一N,0,0,0,0,0,0,0,0,0,-1000,0,0,0,0,1000,-1000,-1000,2021-06-09
5349,00735,國泰臺韓科技,0,41000,-41000,0,0,0,0,0,0,40000,0,0,0,41000,1000,40000,-1000,2021-06-09
5350,030308,慧洋康和0A購01,0,0,0,0,0,0,0,0,0,-1000,0,0,0,0,1000,-1000,-1000,2021-06-09
5351,030287,長榮元富0A購09,0,0,0,0,0,0,0,0,0,-1000,0,0,0,0,1000,-1000,-1000,2021-06-09
5352,03026X,元展23,0,0,0,0,0,0,0,0,0,-1000,0,0,0,0,1000,-1000,-1000,2021-06-09
5353,030254,大立光永豐0A購01,0,0,0,0,0,0,0,0,0,-1000,0,0,0,0,1000,-1000,-1000,2021-06-09
5354,030226,亞翔凱基0B購01,0,0,0,0,0,0,0,0,0,-1000,0,0,0,9000,10000,-1000,-1000,2021-06-09
5355,030434,麗豐元大0A購01,0,0,0,0,0,0,0,0,0,-1000,0,0,0,0,1000,-1000,-1000,2021-06-09
5356,030515,松翰群益0A購01,0,0,0,0,0,0,0,0,0,-1000,0,0,0,0,1000,-1000,-1000,2021-06-09
5357,031340,群創元大0A購09,0,0,0,0,0,0,0,0,0,-1000,0,0,0,10000,11000,-1000,-1000,2021-06-09
5358,030469,聯發科國泰0C購02,0,0,0,0,0,0,0,0,0,-1000,0,0,0,0,1000,-1000,-1000,2021-06-09
5359,030140,台勝科凱基11購01,0,0,0,0,0,0,0,0,0,-1000,0,0,0,0,1000,-1000,-1000,2021-06-09
5360,031509,友達元大11購02,0,0,0,0,0,0,0,0,0,-1000,0,0,0,0,1000,-1000,-1000,2021-06-09
5361,031478,長榮國票0B購01,0,0,0,0,0,0,0,0,0,-1000,0,0,0,0,1000,-1000,-1000,2021-06-09
5362,031237,華紙群益0A購02,0,0,0,0,0,0,0,0,0,-1000,0,0,0,0,1000,-1000,-1000,2021-06-09
5363,030576,宏達電富邦0A購01,0,0,0,0,0,0,0,0,0,-1000,0,0,0,5000,6000,-1000,-1000,2021-06-09
5364,030781,中鋼凱基0A購01,0,0,0,0,0,0,0,0,0,-1000,0,0,0,0,1000,-1000,-1000,2021-06-09
5365,030839,大成鋼兆豐0A購01,0,0,0,0,0,0,0,0,0,-1000,0,0,0,8000,9000,-1000,-1000,2021-06-09
5366,030845,大立光兆豐0A購01,0,0,0,0,0,0,0,0,0,-1000,0,0,0,0,1000,-1000,-1000,2021-06-09
5367,031568,中鋼凱基0B購02,0,0,0,0,0,0,0,0,0,-1000,0,0,0,3000,4000,-1000,-1000,2021-06-09
5368,032708,南紡群益0A購05,0,0,0,0,0,0,0,0,0,-1000,0,0,0,1000,2000,-1000,-1000,2021-06-09
5369,030678,申豐國泰0C購01,0,0,0,0,0,0,0,0,0,-1000,0,0,0,10000,11000,-1000,-1000,2021-06-09
5370,031135,復盛統一0B購02,0,0,0,0,0,0,0,0,0,-1000,0,0,0,14000,15000,-1000,-1000,2021-06-09
5371,031124,全新統一0C購01,0,0,0,0,0,0,0,0,0,-1000,0,0,0,0,1000,-1000,-1000,2021-06-09
5372,031086,上証2X群益0A購01,0,0,0,0,0,0,0,0,0,-1000,0,0,0,0,1000,-1000,-1000,2021-06-09
5373,033473,聯發科凱基0C購06,0,0,0,0,0,0,0,0,0,-1000,0,0,0,43000,44000,-1000,-1000,2021-06-09
5374,032985,中石化元富0C購02,0,0,0,0,0,0,0,0,0,-1000,0,0,0,0,1000,-1000,-1000,2021-06-09
5375,032946,元石油元大0A購03,0,0,0,0,0,0,0,0,0,-1000,0,0,0,0,1000,-1000,-1000,2021-06-09
5376,033249,富邦金元大11購02,0,0,0,0,0,0,0,0,0,-1000,0,0,0,0,1000,-1000,-1000,2021-06-09
5377,032502,旺宏永豐0A購03,0,0,0,0,0,0,0,0,0,-1000,0,0,0,0,1000,-1000,-1000,2021-06-09
5378,032529,旺宏凱基0B購04,0,0,0,0,0,0,0,0,0,-1000,0,0,0,0,1000,-1000,-1000,2021-06-09
5379,036264,敬鵬群益0C購01,0,0,0,0,0,0,0,0,0,-1000,0,0,0,8000,9000,-1000,-1000,2021-06-09
5380,036224,聯詠中信0C購01,0,0,0,0,0,0,0,0,0,-1000,0,0,0,0,1000,-1000,-1000,2021-06-09
5381,05664P,台灣50中信0A售01,0,0,0,0,0,0,0,0,0,-1000,0,0,0,0,1000,-1000,-1000,2021-06-09
5382,036205,矽創統一12購02,0,0,0,0,0,0,0,0,0,-1000,0,0,0,6000,7000,-1000,-1000,2021-06-09
5383,05577P,T50正2凱基08售02,0,0,0,0,0,0,0,0,0,-1000,0,0,0,0,1000,-1000,-1000,2021-06-09
5384,05637P,臺股指中信0B售04,0,0,0,0,0,0,0,0,0,-1000,0,0,0,0,1000,-1000,-1000,2021-06-09
5385,031739,華榮凱基12購01,0,0,0,0,0,0,0,0,0,-1000,0,0,0,0,1000,-1000,-1000,2021-06-09
5386,05470P,上銀國票07售04,0,0,0,0,0,0,0,0,0,-1000,0,0,0,0,1000,-1000,-1000,2021-06-09
5387,033629,富邦金元富12購02,0,0,0,0,0,0,0,0,0,-1000,0,0,0,1000,2000,-1000,-1000,2021-06-09
5388,035597,聯發科元大0B購13,0,0,0,0,0,0,0,0,0,-1000,0,0,0,0,1000,-1000,-1000,2021-06-09
5389,06224P,南亞科元大08售01,0,0,0,0,0,0,0,0,0,-1000,0,0,0,0,1000,-1000,-1000,2021-06-09
5390,05931P,滬深2X元大08售04,0,0,0,0,0,0,0,0,0,-1000,0,0,0,0,1000,-1000,-1000,2021-06-09
5391,06143P,台積電群益07售15,0,0,0,0,0,0,0,0,0,-1000,0,0,0,0,1000,-1000,-1000,2021-06-09
5392,034272,臺股指國票0B購14,0,0,0,0,0,0,0,0,0,-1000,0,0,0,9000,10000,-1000,-1000,2021-06-09
5393,034253,聯發科統一0C購06,0,0,0,0,0,0,0,0,0,-1000,0,0,0,0,1000,-1000,-1000,2021-06-09
5394,034357,華碩康和0B購01,0,0,0,0,0,0,0,0,0,-1000,0,0,0,1065000,1066000,-1000,-1000,2021-06-09
5395,034587,臺股指凱基0B購14,0,0,0,0,0,0,0,0,0,-1000,0,0,0,0,1000,-1000,-1000,2021-06-09
5396,034500,臺股指元大0C購16,0,0,0,0,0,0,0,0,0,-1000,0,0,0,4000,5000,-1000,-1000,2021-06-09
5397,033930,富邦金元大0B購03,0,0,0,0,0,0,0,0,0,-1000,0,0,0,0,1000,-1000,-1000,2021-06-09
5398,033927,漢唐元大12購01,0,0,0,0,0,0,0,0,0,-1000,0,0,0,72000,73000,-1000,-1000,2021-06-09
5399,035912,聯電永豐0C購02,0,0,0,0,0,0,0,0,0,-1000,0,0,0,0,1000,-1000,-1000,2021-06-09
5400,035632,臺股指國票0B購20,0,0,0,0,0,0,0,0,0,-1000,0,0,0,10000,11000,-1000,-1000,2021-06-09
5401,035504,聯發科凱基0B購09,0,0,0,0,0,0,0,0,0,-1000,0,0,0,0,1000,-1000,-1000,2021-06-09
5402,035749,台聚元富13購01,0,0,0,0,0,0,0,0,0,-1000,0,0,0,5000,6000,-1000,-1000,2021-06-09
5403,035476,大立光富邦13購03,0,0,0,0,0,0,0,0,0,-1000,0,0,0,17000,18000,-1000,-1000,2021-06-09
5404,034288,富邦金兆豐0B購03,0,0,0,0,0,0,0,0,0,-1000,0,0,0,1000,2000,-1000,-1000,2021-06-09
5405,05773P,南亞科凱基07售03,0,0,0,0,0,0,0,0,0,-1000,0,0,0,0,1000,-1000,-1000,2021-06-09
5406,035217,友達第一15購02,0,0,0,0,0,0,0,0,0,-1000,0,0,0,29000,30000,-1000,-1000,2021-06-09
5407,03505B,臺股指元大0A熊33,0,0,0,0,0,0,0,0,0,-1000,0,0,0,0,1000,-1000,-1000,2021-06-09
5408,035412,台塑元大0B購01,0,0,0,0,0,0,0,0,0,-1000,0,0,0,0,1000,-1000,-1000,2021-06-09
5409,035424,國巨元大0C購11,0,0,0,0,0,0,0,0,0,-1000,0,0,0,141000,142000,-1000,-1000,2021-06-09
5410,03759C,臺股指元大15牛01,0,0,0,0,0,0,0,0,0,-1000,0,0,0,0,1000,-1000,-1000,2021-06-09
5411,04988P,大立光國泰09售01,0,0,0,0,0,0,0,0,0,-1000,0,0,0,10000,11000,-1000,-1000,2021-06-09
5412,036499,國喬凱基0C購02,0,0,0,0,0,0,0,0,0,-1000,0,0,0,0,1000,-1000,-1000,2021-06-09
5413,036484,台玻麥證0C購02,0,0,0,0,1000,-1000,0,0,0,-1000,0,0,0,0,1000,-1000,-1000,2021-06-09
5414,06328P,A50正2元富08售05,0,0,0,0,0,0,0,0,0,-1000,0,0,0,5000,6000,-1000,-1000,2021-06-09
5415,082402,正崴凱基08購01,0,0,0,0,0,0,0,0,0,-1000,0,0,0,22000,23000,-1000,-1000,2021-06-09
5416,082345,華邦電國泰09購01,0,0,0,0,0,0,0,0,0,-1000,0,0,0,0,1000,-1000,-1000,2021-06-09
5417,082350,台積電富邦08購11,0,0,0,0,0,0,0,0,0,-1000,0,0,0,0,1000,-1000,-1000,2021-06-09
5418,082310,臺股指元大0A購07,0,0,0,0,0,0,0,0,0,-1000,0,0,0,0,1000,-1000,-1000,2021-06-09
5419,082051,大立光凱基07購05,0,0,0,0,0,0,0,0,0,-1000,0,0,0,103000,104000,-1000,-1000,2021-06-09
5420,081486,台積電凱基0B購02,0,0,0,0,0,0,0,0,0,-1000,0,0,0,0,1000,-1000,-1000,2021-06-09
5421,081606,華邦電元大07購12,0,0,0,0,0,0,0,0,0,-1000,0,0,0,0,1000,-1000,-1000,2021-06-09
5422,082877,日月光兆豐08購01,0,0,0,0,0,0,0,0,0,-1000,0,0,0,0,1000,-1000,-1000,2021-06-09
5423,083089,鴻海元大07購18,0,0,0,0,0,0,0,0,0,-1000,0,0,0,0,1000,-1000,-1000,2021-06-09
5424,083204,台積電統一09購07,0,0,0,0,0,0,0,0,0,-1000,0,0,0,0,1000,-1000,-1000,2021-06-09
5425,082647,滬深2X永豐07購01,0,0,0,0,0,0,0,0,0,-1000,0,0,0,0,1000,-1000,-1000,2021-06-09
5426,082533,台積電日盛11購01,0,0,0,0,0,0,0,0,0,-1000,0,0,0,0,1000,-1000,-1000,2021-06-09
5427,080728,台積電第一0C購01,0,0,0,0,0,0,0,0,0,-1000,0,0,0,0,1000,-1000,-1000,2021-06-09
5428,081015,華新統一09購01,0,0,0,0,0,0,0,0,0,-1000,0,0,0,0,1000,-1000,-1000,2021-06-09
5429,080900,卜蜂凱基08購01,0,0,0,0,0,0,0,0,0,-1000,0,0,0,0,1000,-1000,-1000,2021-06-09
5430,081215,華邦電統一09購03,0,0,0,0,0,0,0,0,0,-1000,0,0,0,0,1000,-1000,-1000,2021-06-09
5431,081272,儒鴻統一08購01,0,0,0,0,0,0,0,0,0,-1000,0,0,0,0,1000,-1000,-1000,2021-06-09
5432,081369,台積電日盛07購02,0,0,0,0,0,0,0,0,0,-1000,0,0,0,0,1000,-1000,-1000,2021-06-09
5433,081366,寶成凱基08購01,0,0,0,0,0,0,0,0,0,-1000,0,0,0,0,1000,-1000,-1000,2021-06-09
5434,079826,友訊元大08購01,0,0,0,0,0,0,0,0,0,-1000,0,0,0,0,1000,-1000,-1000,2021-06-09
5435,080233,台積電元大06購15,0,0,0,0,0,0,0,0,0,-1000,0,0,0,0,1000,-1000,-1000,2021-06-09
5436,079057,台灣50國票07購03,0,0,0,0,0,0,0,0,0,-1000,0,0,0,1000,2000,-1000,-1000,2021-06-09
5437,079242,台積電元大08購04,0,0,0,0,0,0,0,0,0,-1000,0,0,0,35000,36000,-1000,-1000,2021-06-09
5438,079375,華新元大08購01,0,0,0,0,0,0,0,0,0,-1000,0,0,0,0,1000,-1000,-1000,2021-06-09
5439,079454,聯發科元富0C購02,0,0,0,0,0,0,0,0,0,-1000,0,0,0,0,1000,-1000,-1000,2021-06-09
5440,078751,台積電國票08購07,0,0,0,0,0,0,0,0,0,-1000,0,0,0,0,1000,-1000,-1000,2021-06-09
5441,078206,台表科元大07購02,0,0,0,0,0,0,0,0,0,-1000,0,0,0,0,1000,-1000,-1000,2021-06-09
5442,078091,強茂統一08購01,0,0,0,0,0,0,0,0,0,-1000,0,0,0,0,1000,-1000,-1000,2021-06-09
5443,077080,華新科元富07購05,0,0,0,0,0,0,0,0,0,-1000,0,0,0,0,1000,-1000,-1000,2021-06-09
5444,077244,聯電元大07購02,0,0,0,0,0,0,0,0,0,-1000,0,0,0,0,1000,-1000,-1000,2021-06-09
5445,076759,SP黃豆元大08購01,0,0,0,0,0,0,0,0,0,-1000,0,0,0,0,1000,-1000,-1000,2021-06-09
5446,076634,台積電元大07購04,0,0,0,0,0,0,0,0,0,-1000,0,0,0,0,1000,-1000,-1000,2021-06-09
5447,076279,儒鴻兆豐06購01,0,0,0,0,0,0,0,0,0,-1000,0,0,0,0,1000,-1000,-1000,2021-06-09
5448,074188,滬深2X國泰07購01,0,0,0,0,0,0,0,0,0,-1000,0,0,0,0,1000,-1000,-1000,2021-06-09
5449,075444,台積電麥證09購01,0,0,0,0,0,0,0,0,0,-1000,0,0,0,0,1000,-1000,-1000,2021-06-09
5450,071895,佳世達元富09購02,0,0,0,0,0,0,0,0,0,-1000,0,0,0,0,1000,-1000,-1000,2021-06-09
5451,07187P,長榮凱基0C售03,0,0,0,0,0,0,0,0,0,-1000,0,0,0,200000,201000,-1000,-1000,2021-06-09
5452,07264P,友達元富0C售02,0,0,0,0,0,0,0,0,0,-1000,0,0,0,4000,5000,-1000,-1000,2021-06-09
5453,07314P,玉晶光元大11售05,0,0,0,0,0,0,0,0,0,-1000,0,0,0,0,1000,-1000,-1000,2021-06-09
5454,07304P,台積電元大0C售23,0,0,0,0,0,0,0,0,0,-1000,0,0,0,0,1000,-1000,-1000,2021-06-09
5455,06621P,台積電元富0C售16,0,0,0,0,0,0,0,0,0,-1000,0,0,0,0,1000,-1000,-1000,2021-06-09
5456,06635P,立積康和09售02,0,0,0,0,0,0,0,0,0,-1000,0,0,0,0,1000,-1000,-1000,2021-06-09
5457,06709P,臺股指元大09售18,0,0,0,0,0,0,0,0,0,-1000,0,0,0,0,1000,-1000,-1000,2021-06-09
5458,067850,台郡元富07購01,0,0,0,0,0,0,0,0,0,-1000,0,0,0,0,1000,-1000,-1000,2021-06-09
5459,06829P,群創元大0A售12,0,0,0,0,0,0,0,0,0,-1000,0,0,0,0,1000,-1000,-1000,2021-06-09
5460,06547P,臺股指元大09售09,0,0,0,0,0,0,0,0,0,-1000,0,0,0,20000,21000,-1000,-1000,2021-06-09
5461,06518P,上証2X元富09售02,0,0,0,0,0,0,0,0,0,-1000,0,0,0,0,1000,-1000,-1000,2021-06-09
5462,06418P,臺股指元大0B售10,0,0,0,0,0,0,0,0,0,-1000,0,0,0,0,1000,-1000,-1000,2021-06-09
5463,06946P,SGBR2X群益0A售01,0,0,0,0,0,0,0,0,0,-1000,0,0,0,0,1000,-1000,-1000,2021-06-09
5464,06879P,中鋼群益0A售03,0,0,0,0,0,0,0,0,0,-1000,0,0,0,0,1000,-1000,-1000,2021-06-09
5465,06910P,台積電群益0A售15,0,0,0,0,0,0,0,0,0,-1000,0,0,0,0,1000,-1000,-1000,2021-06-09
5466,07092P,聯發科元大0B售06,0,0,0,0,0,0,0,0,0,-1000,0,0,0,5000,6000,-1000,-1000,2021-06-09
5467,6128,上福,0,1000,-1000,0,0,0,0,0,0,0,0,0,0,0,0,0,-1000,2021-06-09
5468,6117,迎廣,0,1000,-1000,0,0,0,0,0,0,0,0,0,0,0,0,0,-1000,2021-06-09
5469,6216,居易,0,1000,-1000,0,0,0,0,0,0,0,0,0,0,0,0,0,-1000,2021-06-09
5470,8101,華冠,0,1000,-1000,0,0,0,0,0,0,0,0,0,0,0,0,0,-1000,2021-06-09
5471,6641,基士德-KY,2000,3000,-1000,0,0,0,0,0,0,0,0,0,0,0,0,0,-1000,2021-06-09
5472,8427,基勝-KY,0,1000,-1000,0,0,0,0,0,0,0,0,0,0,0,0,0,-1000,2021-06-09
5473,8201,無敵,1000,2000,-1000,0,0,0,0,0,0,0,0,0,0,0,0,0,-1000,2021-06-09
5474,9929,秋雨,0,1000,-1000,0,0,0,0,0,0,0,0,0,0,0,0,0,-1000,2021-06-09
5475,9188,精熙-DR,0,1000,-1000,0,0,0,0,0,0,0,0,0,0,0,0,0,-1000,2021-06-09
5476,8480,泰昇-KY,0,1000,-1000,0,0,0,0,0,0,0,0,0,0,0,0,0,-1000,2021-06-09
5477,8488,吉源-KY,0,1000,-1000,0,0,0,0,0,0,0,0,0,0,0,0,0,-1000,2021-06-09
5478,9931,欣高,0,1000,-1000,0,0,0,0,0,0,0,0,0,0,0,0,0,-1000,2021-06-09
5479,1521,大億,7000,8000,-1000,0,0,0,0,0,0,0,0,0,0,0,0,0,-1000,2021-06-09
5480,1583,程泰,0,1000,-1000,0,0,0,0,0,0,0,0,0,0,0,0,0,-1000,2021-06-09
5481,1456,怡華,10000,11000,-1000,0,0,0,0,0,0,0,0,0,0,0,0,0,-1000,2021-06-09
5482,1324,地球,0,1000,-1000,0,0,0,0,0,0,0,0,0,0,0,0,0,-1000,2021-06-09
5483,089901,宏達電凱基0A購01,0,0,0,0,0,0,0,0,0,-1000,0,0,0,21000,22000,-1000,-1000,2021-06-09
5484,089247,南電永豐09購04,0,0,0,0,0,0,0,0,0,-1000,0,0,0,159000,160000,-1000,-1000,2021-06-09
5485,089673,鴻海元大0B購10,0,0,0,0,0,0,0,0,0,-1000,0,0,0,0,1000,-1000,-1000,2021-06-09
5486,089651,景碩國票0B購01,0,0,0,0,0,0,0,0,0,-1000,0,0,0,29000,30000,-1000,-1000,2021-06-09
5487,3164,景岳,30000,31000,-1000,0,0,0,0,0,0,0,0,0,0,0,0,0,-1000,2021-06-09
5488,4562,穎漢,3000,4000,-1000,0,0,0,0,0,0,0,0,0,0,0,0,0,-1000,2021-06-09
5489,2496,卓越,0,1000,-1000,0,0,0,0,0,0,0,0,0,0,0,0,0,-1000,2021-06-09
5490,2528,皇普,4000,5000,-1000,0,0,0,0,0,0,0,0,0,0,0,0,0,-1000,2021-06-09
5491,2443,億麗,0,1000,-1000,0,0,0,0,0,0,0,0,0,0,0,0,0,-1000,2021-06-09
5492,2429,銘旺科,2000,3000,-1000,0,0,0,0,0,0,0,0,0,0,0,0,0,-1000,2021-06-09
5493,6715,嘉基,18000,19000,-1000,0,0,0,0,0,0,-28,0,28,-28,0,0,0,-1028,2021-06-09
5494,2247,汎德永業,1000,2099,-1099,0,0,0,0,0,0,0,0,0,0,0,0,0,-1099,2021-06-09
5495,086177,日月光元大0C購03,0,0,0,0,0,0,0,0,0,-2000,0,0,0,0,2000,-2000,-2000,2021-06-09
5496,086175,日月光元大08購08,0,0,0,0,0,0,0,0,0,-2000,0,0,0,8000,10000,-2000,-2000,2021-06-09
5497,085808,日月光康和09購01,0,0,0,0,0,0,0,0,0,-2000,0,0,0,0,2000,-2000,-2000,2021-06-09
5498,086010,京鼎元大08購01,0,0,0,0,0,0,0,0,0,-2000,0,0,0,19000,21000,-2000,-2000,2021-06-09
5499,085270,信邦統一0A購02,0,0,0,0,0,0,0,0,0,-2000,0,0,0,0,2000,-2000,-2000,2021-06-09
5500,085127,旺宏統一0A購01,0,0,0,0,0,0,0,0,0,-2000,0,0,0,0,2000,-2000,-2000,2021-06-09
5501,085155,台積電凱基09購11,0,0,0,0,0,0,0,0,0,-2000,0,0,0,0,2000,-2000,-2000,2021-06-09
5502,085576,聯發科兆豐08購04,0,0,0,0,0,0,0,0,0,-2000,0,0,0,133000,135000,-2000,-2000,2021-06-09
5503,085454,台積電元富0B購10,0,0,0,0,0,0,0,0,0,-2000,0,0,0,0,2000,-2000,-2000,2021-06-09
5504,085401,恆大元大08購03,0,0,0,0,0,0,0,0,0,-2000,0,0,0,0,2000,-2000,-2000,2021-06-09
5505,084229,南電元大07購10,0,0,0,0,0,0,0,0,0,-2000,0,0,0,8000,10000,-2000,-2000,2021-06-09
5506,083749,台郡國票08購01,0,0,0,0,0,0,0,0,0,-2000,0,0,0,0,2000,-2000,-2000,2021-06-09
5507,083651,滬深2X群益07購05,0,0,0,0,0,0,0,0,0,-2000,0,0,0,0,2000,-2000,-2000,2021-06-09
5508,084357,大立光元大07購12,0,0,0,0,0,0,0,0,0,-2000,0,0,0,16000,18000,-2000,-2000,2021-06-09
5509,084509,台積電元大08購09,0,0,0,0,0,0,0,0,0,-2000,0,0,0,8000,10000,-2000,-2000,2021-06-09
5510,084740,奇鋐元大08購01,0,0,0,0,0,0,0,0,0,-2000,0,0,0,20000,22000,-2000,-2000,2021-06-09
5511,084735,台積電元大0B購02,0,0,0,0,0,0,0,0,0,-2000,0,0,0,30000,32000,-2000,-2000,2021-06-09
5512,084669,聯發科國票09購05,0,0,0,0,0,0,0,0,0,-2000,0,0,0,4000,6000,-2000,-2000,2021-06-09
5513,084932,聯發科元大08購07,0,0,0,0,0,0,0,0,0,-2000,0,0,0,0,2000,-2000,-2000,2021-06-09
5514,086445,群創永豐09購02,0,0,0,0,0,0,0,0,0,-2000,0,0,0,0,2000,-2000,-2000,2021-06-09
5515,086658,大成鋼國票0A購01,0,0,0,0,0,0,0,0,0,-2000,0,0,0,0,2000,-2000,-2000,2021-06-09
5516,086696,聯詠元富0B購01,0,0,0,0,0,0,0,0,0,-2000,0,0,0,297000,299000,-2000,-2000,2021-06-09
5517,086632,宏碁凱基11購01,0,0,0,0,0,0,0,0,0,-2000,0,0,0,15000,17000,-2000,-2000,2021-06-09
5518,086873,緯創國票0A購01,0,0,0,0,0,0,0,0,0,-2000,0,0,0,0,2000,-2000,-2000,2021-06-09
5519,086923,華擎兆豐0A購01,0,0,0,0,0,0,0,0,0,-2000,0,0,0,0,2000,-2000,-2000,2021-06-09
5520,087349,申豐凱基0A購01,0,0,0,0,0,0,0,0,0,-2000,0,0,0,0,2000,-2000,-2000,2021-06-09
5521,087657,臺股指群益09購02,0,0,0,0,0,0,0,0,0,-2000,0,0,0,0,2000,-2000,-2000,2021-06-09
5522,087667,台表科兆豐0A購01,0,0,0,0,0,0,0,0,0,-2000,0,0,0,0,2000,-2000,-2000,2021-06-09
5523,088660,鴻海元大0C購04,0,0,0,0,0,0,0,0,0,-2000,0,0,0,0,2000,-2000,-2000,2021-06-09
5524,088380,臺股指國票0A購10,0,0,0,0,0,0,0,0,0,-2000,0,0,0,0,2000,-2000,-2000,2021-06-09
5525,088345,上緯控元大0C購01,0,0,0,0,0,0,0,0,0,-2000,0,0,0,0,2000,-2000,-2000,2021-06-09
5526,088019,台積電永豐09購05,0,0,0,0,0,0,0,0,0,-2000,0,0,0,0,2000,-2000,-2000,2021-06-09
5527,088105,科嘉國票0A購01,0,0,0,0,0,0,0,0,0,-2000,0,0,0,0,2000,-2000,-2000,2021-06-09
5528,089036,群創兆豐09購03,0,0,0,0,0,0,0,0,0,-2000,0,0,0,8000,10000,-2000,-2000,2021-06-09
5529,036217,大立光國泰12購02,0,0,0,0,0,0,0,0,0,-2000,0,0,0,0,2000,-2000,-2000,2021-06-09
5530,036329,矽創麥證0C購01,0,0,0,0,2000,-2000,0,0,0,-2000,0,0,0,0,2000,-2000,-2000,2021-06-09
5531,032493,健策兆豐0A購02,0,0,0,0,0,0,0,0,0,-2000,0,0,0,0,2000,-2000,-2000,2021-06-09
5532,032461,華邦電國泰0C購02,0,0,0,0,0,0,0,0,0,-2000,0,0,0,3000,5000,-2000,-2000,2021-06-09
5533,032348,祥碩群益0A購01,0,0,0,0,0,0,0,0,0,-2000,0,0,0,1000,3000,-2000,-2000,2021-06-09
5534,033066,華邦電凱基0B購04,0,0,0,0,0,0,0,0,0,-2000,0,0,0,0,2000,-2000,-2000,2021-06-09
5535,032864,乙盛群益0A購02,0,0,0,0,0,0,0,0,0,-2000,0,0,0,0,2000,-2000,-2000,2021-06-09
5536,033531,新光金國票0C購01,0,0,0,0,0,0,0,0,0,-2000,0,0,0,0,2000,-2000,-2000,2021-06-09
5537,032428,華邦電元大0A購11,0,0,0,0,0,0,0,0,0,-2000,0,0,0,0,2000,-2000,-2000,2021-06-09
5538,031058,聯發科元大0A購10,0,0,0,0,0,0,0,0,0,-2000,0,0,0,0,2000,-2000,-2000,2021-06-09
5539,030764,聯電康和0A購01,0,0,0,0,0,0,0,0,0,-2000,0,0,0,8000,10000,-2000,-2000,2021-06-09
5540,032639,裕民統一0C購03,0,0,0,0,0,0,0,0,0,-2000,0,0,0,0,2000,-2000,-2000,2021-06-09
5541,033183,高股息凱基11購01,0,0,0,0,0,0,0,0,0,-2000,0,0,0,0,2000,-2000,-2000,2021-06-09
5542,031324,台達電元大11購01,0,0,0,0,0,0,0,0,0,-2000,0,0,0,0,2000,-2000,-2000,2021-06-09
5543,031318,中石化元大0C購01,0,0,0,0,0,0,0,0,0,-2000,0,0,0,0,2000,-2000,-2000,2021-06-09
5544,031624,瑞昱統一0A購04,0,0,0,0,0,0,0,0,0,-2000,0,0,0,0,2000,-2000,-2000,2021-06-09
5545,031636,中鋼日盛0C購01,0,0,0,0,0,0,0,0,0,-2000,0,0,0,18000,20000,-2000,-2000,2021-06-09
5546,031513,志聖元大0A購01,0,0,0,0,0,0,0,0,0,-2000,0,0,0,0,2000,-2000,-2000,2021-06-09
5547,030130,聯發科凱基14購02,0,0,0,0,0,0,0,0,0,-2000,0,0,0,15000,17000,-2000,-2000,2021-06-09
5548,030174,康普國泰0C購01,0,0,0,0,0,0,0,0,0,-2000,0,0,0,0,2000,-2000,-2000,2021-06-09
5549,030402,威盛元大0B購01,0,0,0,0,0,0,0,0,0,-2000,0,0,0,0,2000,-2000,-2000,2021-06-09
5550,030452,威盛富邦0A購01,0,0,0,0,0,0,0,0,0,-2000,0,0,0,0,2000,-2000,-2000,2021-06-09
5551,00742,新光內需收益,0,1000,-1000,0,0,0,0,0,0,-1000,0,0,0,50000,51000,-1000,-2000,2021-06-09
5552,00700,富邦恒生國企,0,0,0,0,0,0,0,0,0,-2000,0,0,0,100000,102000,-2000,-2000,2021-06-09
5553,00660,元大歐洲50,0,0,0,0,0,0,0,0,0,-2000,0,0,0,0,2000,-2000,-2000,2021-06-09
5554,0057,富邦摩台,0,0,0,0,0,0,0,0,0,-2000,0,0,0,20000,22000,-2000,-2000,2021-06-09
5555,036467,中鋼元大0C購10,0,0,0,0,0,0,0,0,0,-2000,0,0,0,0,2000,-2000,-2000,2021-06-09
5556,04743P,大立光國票06售02,0,0,0,0,0,0,0,0,0,-2000,0,0,0,0,2000,-2000,-2000,2021-06-09
5557,03743C,國泰金富邦13牛01,0,0,0,0,0,0,0,0,0,-2000,0,0,0,8000,10000,-2000,-2000,2021-06-09
5558,035442,臺股指元大0C購29,0,0,0,0,0,0,0,0,0,-2000,0,0,0,0,2000,-2000,-2000,2021-06-09
5559,035106,國泰金元大0B購04,0,0,0,0,0,0,0,0,0,-2000,0,0,0,0,2000,-2000,-2000,2021-06-09
5560,035179,南紡元富0B購04,0,0,0,0,0,0,0,0,0,-2000,0,0,0,0,2000,-2000,-2000,2021-06-09
5561,035294,聯詠國票0C購01,0,0,0,0,0,0,0,0,0,-2000,0,0,0,33000,35000,-2000,-2000,2021-06-09
5562,035354,萬海中信13購01,0,0,0,0,0,0,0,0,0,-2000,0,0,0,0,2000,-2000,-2000,2021-06-09
5563,05822P,台積電群益07售09,0,0,0,0,0,0,0,0,0,-2000,0,0,0,0,2000,-2000,-2000,2021-06-09
5564,034314,上証2X群益0B購02,0,0,0,0,0,0,0,0,0,-2000,0,0,0,6000,8000,-2000,-2000,2021-06-09
5565,034326,燁輝群益0C購02,0,0,0,0,0,0,0,0,0,-2000,0,0,0,0,2000,-2000,-2000,2021-06-09
5566,035506,王品凱基0B購01,0,0,0,0,0,0,0,0,0,-2000,0,0,0,102000,104000,-2000,-2000,2021-06-09
5567,035862,中石化元富13購01,0,0,0,0,0,0,0,0,0,-2000,0,0,0,0,2000,-2000,-2000,2021-06-09
5568,033972,台積電凱基0B購11,0,0,0,0,0,0,0,0,0,-2000,0,0,0,0,2000,-2000,-2000,2021-06-09
5569,034546,國泰金統一0C購02,0,0,0,0,0,0,0,0,0,-2000,0,0,0,0,2000,-2000,-2000,2021-06-09
5570,034402,大亞國票0C購01,0,0,0,0,0,0,0,0,0,-2000,0,0,0,0,2000,-2000,-2000,2021-06-09
5571,034473,聚陽元大11購01,0,0,0,0,0,0,0,0,0,-2000,0,0,0,0,2000,-2000,-2000,2021-06-09
5572,034681,臺股指凱基0B購20,0,0,0,0,0,0,0,0,0,-2000,0,0,0,0,2000,-2000,-2000,2021-06-09
5573,05871P,台灣50國票08售04,0,0,0,0,0,0,0,0,0,-2000,0,0,0,0,2000,-2000,-2000,2021-06-09
5574,034060,台玻國票0C購03,0,0,0,0,0,0,0,0,0,-2000,0,0,0,0,2000,-2000,-2000,2021-06-09
5575,06140P,台積電中信0A售05,0,0,0,0,0,0,0,0,0,-2000,0,0,0,0,2000,-2000,-2000,2021-06-09
5576,06091P,合勤控元大07售07,0,0,0,0,0,0,0,0,0,-2000,0,0,0,10000,12000,-2000,-2000,2021-06-09
5577,06185P,臺股指國票08售06,0,0,0,0,0,0,0,0,0,-2000,0,0,0,65000,67000,-2000,-2000,2021-06-09
5578,05962P,元金2X凱基09售02,0,0,0,0,0,0,0,0,0,-2000,0,0,0,0,2000,-2000,-2000,2021-06-09
5579,033710,允強國票0C購01,0,0,0,0,0,0,0,0,0,-2000,0,0,0,5000,7000,-2000,-2000,2021-06-09
5580,036134,群創凱基14購01,0,0,0,0,0,0,0,0,0,-2000,0,0,0,0,2000,-2000,-2000,2021-06-09
5581,070378,為升元富08購02,0,0,0,0,0,0,0,0,0,-2000,0,0,0,13000,15000,-2000,-2000,2021-06-09
5582,07181P,臺股指凱基0C售29,0,0,0,0,0,0,0,0,0,-2000,0,0,0,0,2000,-2000,-2000,2021-06-09
5583,06912P,群創凱基0A售08,0,0,0,0,0,0,0,0,0,-2000,0,0,0,18000,20000,-2000,-2000,2021-06-09
5584,06927P,臺股指元大0C售08,0,0,0,0,0,0,0,0,0,-2000,0,0,0,0,2000,-2000,-2000,2021-06-09
5585,06929P,臺股指元大0C售12,0,0,0,0,0,0,0,0,0,-2000,0,0,0,6000,8000,-2000,-2000,2021-06-09
5586,06972P,長榮凱基0A售22,0,0,0,0,0,0,0,0,0,-2000,0,0,0,0,2000,-2000,-2000,2021-06-09
5587,06411P,滬深2X凱基0B售02,0,0,0,0,0,0,0,0,0,-2000,0,0,0,0,2000,-2000,-2000,2021-06-09
5588,06391P,上証2X凱基09售02,0,0,0,0,0,0,0,0,0,-2000,0,0,0,0,2000,-2000,-2000,2021-06-09
5589,06529P,元石油群益09售02,0,0,0,0,0,0,0,0,0,-2000,0,0,0,0,2000,-2000,-2000,2021-06-09
5590,06757P,台積電凱基11售01,0,0,0,0,0,0,0,0,0,-2000,0,0,0,0,2000,-2000,-2000,2021-06-09
5591,06619P,國巨元富0C售08,0,0,0,0,0,0,0,0,0,-2000,0,0,0,0,2000,-2000,-2000,2021-06-09
5592,07302P,友達康和11售02,0,0,0,0,0,0,0,0,0,-2000,0,0,0,0,2000,-2000,-2000,2021-06-09
5593,07257P,裕民元富13售07,0,0,0,0,0,0,0,0,0,-2000,0,0,0,1000,3000,-2000,-2000,2021-06-09
5594,075402,華新科統一08購01,0,0,0,0,0,0,0,0,0,-2000,0,0,0,0,2000,-2000,-2000,2021-06-09
5595,075133,道瓊銀國泰07購01,0,0,0,0,0,0,0,0,0,-2000,0,0,0,0,2000,-2000,-2000,2021-06-09
5596,076612,台光電國票08購01,0,0,0,0,0,0,0,0,0,-2000,0,0,0,0,2000,-2000,-2000,2021-06-09
5597,075938,炎洲國票07購01,0,0,0,0,0,0,0,0,0,-2000,0,0,0,0,2000,-2000,-2000,2021-06-09
5598,075926,台表科元大07購01,0,0,0,0,0,0,0,0,0,-2000,0,0,0,6000,8000,-2000,-2000,2021-06-09
5599,077291,南亞科元富08購01,0,0,0,0,0,0,0,0,0,-2000,0,0,0,0,2000,-2000,-2000,2021-06-09
5600,078025,華邦電凱基08購01,0,0,0,0,0,0,0,0,0,-2000,0,0,0,0,2000,-2000,-2000,2021-06-09
5601,078802,全新凱基08購03,0,0,0,0,0,0,0,0,0,-2000,0,0,0,0,2000,-2000,-2000,2021-06-09
5602,078236,景碩元富0C購01,0,0,0,0,0,0,0,0,0,-2000,0,0,0,2000,4000,-2000,-2000,2021-06-09
5603,078736,華邦電元富0C購01,0,0,0,0,0,0,0,0,0,-2000,0,0,0,0,2000,-2000,-2000,2021-06-09
5604,080262,聯成富邦08購01,0,0,0,0,0,0,0,0,0,-2000,0,0,0,32000,34000,-2000,-2000,2021-06-09
5605,079952,台積電凱基07購11,0,0,0,0,0,0,0,0,0,-2000,0,0,0,0,2000,-2000,-2000,2021-06-09
5606,080021,玉晶光國票0A購02,0,0,0,0,0,0,0,0,0,-2000,0,0,0,0,2000,-2000,-2000,2021-06-09
5607,079992,台積電元富09購04,0,0,0,0,0,0,0,0,0,-2000,0,0,0,0,2000,-2000,-2000,2021-06-09
5608,081362,科嘉凱基0A購01,0,0,0,0,0,0,0,0,0,-2000,0,0,0,0,2000,-2000,-2000,2021-06-09
5609,081357,億光凱基08購01,0,0,0,0,0,0,0,0,0,-2000,0,0,0,0,2000,-2000,-2000,2021-06-09
5610,081121,大聯大群益09購01,0,0,0,0,0,0,0,0,0,-2000,0,0,0,1000,3000,-2000,-2000,2021-06-09
5611,080788,永光凱基09購01,0,0,0,0,0,0,0,0,0,-2000,0,0,0,0,2000,-2000,-2000,2021-06-09
5612,080793,川湖凱基09購01,0,0,0,0,0,0,0,0,0,-2000,0,0,0,0,2000,-2000,-2000,2021-06-09
5613,080995,順德永豐07購01,0,0,0,0,0,0,0,0,0,-2000,0,0,0,31000,33000,-2000,-2000,2021-06-09
5614,080933,T50反1群益09購03,0,0,0,0,0,0,0,0,0,-2000,0,0,0,0,2000,-2000,-2000,2021-06-09
5615,082449,遠東新元大07購01,0,0,0,0,0,0,0,0,0,-2000,0,0,0,0,2000,-2000,-2000,2021-06-09
5616,082595,台積電元大07購17,0,0,0,0,0,0,0,0,0,-2000,0,0,0,0,2000,-2000,-2000,2021-06-09
5617,083265,大立光凱基07購07,0,0,0,0,0,0,0,0,0,-2000,0,0,0,8000,10000,-2000,-2000,2021-06-09
5618,083060,凱美永豐07購01,0,0,0,0,0,0,0,0,0,-2000,0,0,0,0,2000,-2000,-2000,2021-06-09
5619,082131,光磊統一08購01,0,0,0,0,0,0,0,0,0,-2000,0,0,0,0,2000,-2000,-2000,2021-06-09
5620,082040,廣宇凱基07購02,0,0,0,0,0,0,0,0,0,-2000,0,0,0,3000,5000,-2000,-2000,2021-06-09
5621,082231,台郡麥證09購01,0,0,0,0,2000,-2000,0,0,0,-2000,0,0,0,0,2000,-2000,-2000,2021-06-09
5622,082432,和潤永豐07購01,0,0,0,0,0,0,0,0,0,-2000,0,0,0,0,2000,-2000,-2000,2021-06-09
5623,2227,裕日車,3000,5000,-2000,0,0,0,0,0,0,0,0,0,0,0,0,0,-2000,2021-06-09
5624,4581,光隆精密-KY,0,2000,-2000,0,0,0,0,0,0,0,0,0,0,0,0,0,-2000,2021-06-09
5625,4994,傳奇,5000,7000,-2000,0,0,0,0,0,0,0,0,0,0,0,0,0,-2000,2021-06-09
5626,3054,立萬利,1000,3000,-2000,0,0,0,0,0,0,0,0,0,0,0,0,0,-2000,2021-06-09
5627,2748,雲品,3000,5000,-2000,0,0,0,0,0,0,0,0,0,0,0,0,0,-2000,2021-06-09
5628,2888A,新光金甲特,0,0,0,0,0,0,0,2000,-2000,0,0,0,0,0,0,0,-2000,2021-06-09
5629,2901,欣欣,2000,4000,-2000,0,0,0,0,0,0,0,0,0,0,0,0,0,-2000,2021-06-09
5630,089741,巨大永豐09購01,0,0,0,0,0,0,0,0,0,-2000,0,0,0,0,2000,-2000,-2000,2021-06-09
5631,089498,新興元富09購03,0,0,0,0,0,0,0,0,0,-2000,0,0,0,0,2000,-2000,-2000,2021-06-09
5632,089293,緯創麥證09購01,0,0,0,0,2000,-2000,0,0,0,-2000,0,0,0,0,2000,-2000,-2000,2021-06-09
5633,089391,松翰兆豐0A購01,0,0,0,0,0,0,0,0,0,-2000,0,0,0,0,2000,-2000,-2000,2021-06-09
5634,089878,巨大群益0B購01,0,0,0,0,0,0,0,0,0,-2000,0,0,0,3000,5000,-2000,-2000,2021-06-09
5635,089811,強茂群益0B購01,0,0,0,0,0,0,0,0,0,-2000,0,0,0,5000,7000,-2000,-2000,2021-06-09
5636,089846,南亞科元大09購05,0,0,0,0,0,0,0,0,0,-2000,0,0,0,0,2000,-2000,-2000,2021-06-09
5637,089763,國喬凱基09購02,0,0,0,0,0,0,0,0,0,-2000,0,0,0,0,2000,-2000,-2000,2021-06-09
5638,089940,玉晶光永豐0A購01,0,0,0,0,0,0,0,0,0,-2000,0,0,0,0,2000,-2000,-2000,2021-06-09
5639,1235,興泰,0,2000,-2000,0,0,0,0,0,0,0,0,0,0,0,0,0,-2000,2021-06-09
5640,1233,天仁,0,2000,-2000,0,0,0,0,0,0,0,0,0,0,0,0,0,-2000,2021-06-09
5641,1626,艾美特-KY,4000,6000,-2000,0,0,0,0,0,0,0,0,0,0,0,0,0,-2000,2021-06-09
5642,6666,羅麗芬-KY,7000,9000,-2000,0,0,0,0,0,0,0,0,0,0,0,0,0,-2000,2021-06-09
5643,6491,晶碩,171000,171000,0,0,0,0,0,0,0,-2000,6000,0,6000,9000,17000,-8000,-2000,2021-06-09
5644,6184,大豐電,1000,3000,-2000,0,0,0,0,0,0,0,0,0,0,0,0,0,-2000,2021-06-09
5645,6172,互億,4000,6000,-2000,0,0,0,0,0,0,0,0,0,0,0,0,0,-2000,2021-06-09
5646,5546,永固-KY,4000,6000,-2000,0,0,0,0,0,0,0,0,0,0,0,0,0,-2000,2021-06-09
5647,9918,欣天然,0,2000,-2000,0,0,0,0,0,0,0,0,0,0,0,0,0,-2000,2021-06-09
5648,1319,東陽,311000,416000,-105000,0,0,0,0,0,0,102523,39000,477,38523,65000,1000,64000,-2477,2021-06-09
5649,088038,道瓊反元大0C購01,0,0,0,0,0,0,0,0,0,-3000,0,0,0,0,3000,-3000,-3000,2021-06-09
5650,087738,百和元富0B購01,0,0,0,0,0,0,0,0,0,-3000,0,0,0,0,3000,-3000,-3000,2021-06-09
5651,087700,晶碩元大09購03,0,0,0,0,0,0,0,0,0,-3000,0,0,0,0,3000,-3000,-3000,2021-06-09
5652,088353,微星統一0B購04,0,0,0,0,0,0,0,0,0,-3000,0,0,0,0,3000,-3000,-3000,2021-06-09
5653,088838,聯發科中信0B購02,0,0,0,0,0,0,0,0,0,-3000,0,0,0,0,3000,-3000,-3000,2021-06-09
5654,088705,緯創國泰0B購01,0,0,0,0,0,0,0,0,0,-3000,0,0,0,0,3000,-3000,-3000,2021-06-09
5655,087423,T50反1元富0C購03,0,0,0,0,0,0,0,0,0,-3000,0,0,0,0,3000,-3000,-3000,2021-06-09
5656,087341,瑞昱凱基0B購01,0,0,0,0,0,0,0,0,0,-3000,0,0,0,12000,15000,-3000,-3000,2021-06-09
5657,087304,臺股指元大0A購24,0,0,0,0,0,0,0,0,0,-3000,0,0,0,0,3000,-3000,-3000,2021-06-09
5658,087166,晶碩永豐09購02,0,0,0,0,0,0,0,0,0,-3000,0,0,0,0,3000,-3000,-3000,2021-06-09
5659,087146,聯詠國票0B購01,0,0,0,0,0,0,0,0,0,-3000,0,0,0,24000,27000,-3000,-3000,2021-06-09
5660,086899,道瓊銀凱基0A購03,0,0,0,0,0,0,0,0,0,-3000,0,0,0,0,3000,-3000,-3000,2021-06-09
5661,086639,大立光凱基0C購01,0,0,0,0,0,0,0,0,0,-3000,0,0,0,0,3000,-3000,-3000,2021-06-09
5662,084694,台積電統一0B購06,0,0,0,0,0,0,0,0,0,-3000,0,0,0,0,3000,-3000,-3000,2021-06-09
5663,084573,玉晶光國票08購09,0,0,0,0,0,0,0,0,0,-3000,0,0,0,0,3000,-3000,-3000,2021-06-09
5664,084368,台郡元大07購04,0,0,0,0,0,0,0,0,0,-3000,0,0,0,0,3000,-3000,-3000,2021-06-09
5665,084432,聯發科群益08購14,0,0,0,0,0,0,0,0,0,-3000,0,0,0,0,3000,-3000,-3000,2021-06-09
5666,083440,大立光凱基0B購01,0,0,0,0,0,0,0,0,0,-3000,0,0,0,7000,10000,-3000,-3000,2021-06-09
5667,084249,祥碩統一09購04,0,0,0,0,0,0,0,0,0,-3000,0,0,0,0,3000,-3000,-3000,2021-06-09
5668,083817,臺股指麥證07購07,0,0,0,0,3000,-3000,0,0,0,-3000,0,0,0,0,3000,-3000,-3000,2021-06-09
5669,085487,聯電凱基0B購02,0,0,0,0,0,0,0,0,0,-3000,0,0,0,0,3000,-3000,-3000,2021-06-09
5670,085483,台塑凱基08購01,0,0,0,0,0,0,0,0,0,-3000,0,0,0,0,3000,-3000,-3000,2021-06-09
5671,085610,大立光元大08購06,0,0,0,0,0,0,0,0,0,-3000,0,0,0,0,3000,-3000,-3000,2021-06-09
5672,085571,宏碁兆豐08購02,0,0,0,0,0,0,0,0,0,-3000,0,0,0,2000,5000,-3000,-3000,2021-06-09
5673,085701,元黃金富邦0A購01,0,0,0,0,0,0,0,0,0,-3000,0,0,0,0,3000,-3000,-3000,2021-06-09
5674,085294,群創凱基0C購02,0,0,0,0,0,0,0,0,0,-3000,0,0,0,0,3000,-3000,-3000,2021-06-09
5675,085804,日月光元大08購04,0,0,0,0,0,0,0,0,0,-3000,0,0,0,44000,47000,-3000,-3000,2021-06-09
5676,086166,聯詠元大08購08,0,0,0,0,0,0,0,0,0,-3000,0,0,0,300000,303000,-3000,-3000,2021-06-09
5677,086136,申豐群益08購02,0,0,0,0,0,0,0,0,0,-3000,0,0,0,0,3000,-3000,-3000,2021-06-09
5678,086369,T50反1國票0A購05,0,0,0,0,0,0,0,0,0,-3000,0,0,0,5000,8000,-3000,-3000,2021-06-09
5679,020011,統一微波高息20N,0,0,0,0,0,0,0,0,0,-3000,0,0,0,4000,7000,-3000,-3000,2021-06-09
5680,030455,慧洋富邦0B購01,0,0,0,0,0,0,0,0,0,-3000,0,0,0,0,3000,-3000,-3000,2021-06-09
5681,030441,申豐元大0A購02,0,0,0,0,0,0,0,0,0,-3000,0,0,0,9000,12000,-3000,-3000,2021-06-09
5682,03006X,元展06,0,0,0,0,0,0,0,0,0,-3000,0,0,0,0,3000,-3000,-3000,2021-06-09
5683,030041,仁寶元大0B購01,0,0,0,0,0,0,0,0,0,-3000,0,0,0,0,3000,-3000,-3000,2021-06-09
5684,030126,台積電凱基0B購06,0,0,0,0,0,0,0,0,0,-3000,0,0,0,2000,5000,-3000,-3000,2021-06-09
5685,030337,聯電群益0B購04,0,0,0,0,0,0,0,0,0,-3000,0,0,0,0,3000,-3000,-3000,2021-06-09
5686,031428,聯發科凱基0B購06,0,0,0,0,0,0,0,0,0,-3000,0,0,0,0,3000,-3000,-3000,2021-06-09
5687,030660,長榮永豐0A購03,0,0,0,0,0,0,0,0,0,-3000,0,0,0,0,3000,-3000,-3000,2021-06-09
5688,030610,聯發科元大0A購07,0,0,0,0,0,0,0,0,0,-3000,0,0,0,0,3000,-3000,-3000,2021-06-09
5689,030945,矽創群益0B購02,0,0,0,0,0,0,0,0,0,-3000,0,0,0,0,3000,-3000,-3000,2021-06-09
5690,030846,嘉晶兆豐0A購01,0,0,0,0,0,0,0,0,0,-3000,0,0,0,0,3000,-3000,-3000,2021-06-09
5691,031278,彩晶統一0C購02,0,3000,-3000,0,0,0,0,0,0,0,0,0,0,0,0,0,-3000,2021-06-09
5692,031275,貿聯統一0C購01,0,0,0,0,0,0,0,0,0,-3000,0,0,0,0,3000,-3000,-3000,2021-06-09
5693,033369,中鋼富邦0B購02,0,3000,-3000,0,0,0,0,0,0,0,0,0,0,0,0,0,-3000,2021-06-09
5694,033091,瑞昱元富0C購01,0,0,0,0,0,0,0,0,0,-3000,0,0,0,0,3000,-3000,-3000,2021-06-09
5695,032093,華新永豐0A購02,0,0,0,0,0,0,0,0,0,-3000,0,0,0,0,3000,-3000,-3000,2021-06-09
5696,05526P,台積電元富09售06,0,0,0,0,0,0,0,0,0,-3000,0,0,0,0,3000,-3000,-3000,2021-06-09
5697,05564P,玉晶光元富09售05,0,0,0,0,0,0,0,0,0,-3000,0,0,0,0,3000,-3000,-3000,2021-06-09
5698,031660,南亞科元大0A購04,0,0,0,0,0,0,0,0,0,-3000,0,0,0,0,3000,-3000,-3000,2021-06-09
5699,032608,玉晶光元大11購03,0,0,0,0,0,0,0,0,0,-3000,0,0,0,1000,4000,-3000,-3000,2021-06-09
5700,032632,國巨統一0B購05,0,0,0,0,0,0,0,0,0,-3000,0,0,0,7000,10000,-3000,-3000,2021-06-09
5701,036358,台積電國票11購03,0,0,0,0,0,0,0,0,0,-3000,0,0,0,0,3000,-3000,-3000,2021-06-09
5702,033650,燁輝統一15購01,0,0,0,0,0,0,0,0,0,-3000,0,0,0,0,3000,-3000,-3000,2021-06-09
5703,034757,長榮統一0B購10,0,0,0,0,0,0,0,0,0,-3000,0,0,0,128000,131000,-3000,-3000,2021-06-09
5704,034949,聯電凱基13購02,0,0,0,0,0,0,0,0,0,-3000,0,0,0,8000,11000,-3000,-3000,2021-06-09
5705,033862,中磊凱基0B購01,0,0,0,0,0,0,0,0,0,-3000,0,0,0,0,3000,-3000,-3000,2021-06-09
5706,033809,群創麥證0B購01,0,0,0,0,3000,-3000,0,0,0,-3000,0,0,0,0,3000,-3000,-3000,2021-06-09
5707,034691,國巨群益0B購04,0,0,0,0,0,0,0,0,0,-3000,0,0,0,0,3000,-3000,-3000,2021-06-09
5708,035914,華邦電永豐0C購01,0,0,0,0,0,0,0,0,0,-3000,0,0,0,0,3000,-3000,-3000,2021-06-09
5709,034300,台玻永豐0B購03,0,0,0,0,0,0,0,0,0,-3000,0,0,0,69000,72000,-3000,-3000,2021-06-09
5710,05761P,台積電凱基08售07,0,0,0,0,0,0,0,0,0,-3000,0,0,0,0,3000,-3000,-3000,2021-06-09
5711,035293,聯詠國票0B購06,0,0,0,0,0,0,0,0,0,-3000,0,0,0,32000,35000,-3000,-3000,2021-06-09
5712,035308,中鋼元大12購04,0,0,0,0,0,0,0,0,0,-3000,0,0,0,0,3000,-3000,-3000,2021-06-09
5713,035246,群創群益0C購07,0,0,0,0,0,0,0,0,0,-3000,0,0,0,0,3000,-3000,-3000,2021-06-09
5714,03503B,臺股指凱基0A熊20,0,0,0,0,0,0,0,0,0,-3000,0,0,0,7000,10000,-3000,-3000,2021-06-09
5715,035042,友達國票0B購04,0,0,0,0,0,0,0,0,0,-3000,0,0,0,0,3000,-3000,-3000,2021-06-09
5716,035403,宏碁元富13購01,0,0,0,0,0,0,0,0,0,-3000,0,0,0,0,3000,-3000,-3000,2021-06-09
5717,03742C,臺股指元大11牛02,0,0,0,0,0,0,0,0,0,-3000,0,0,0,1000,4000,-3000,-3000,2021-06-09
5718,04997P,世芯國票07售02,0,0,0,0,0,0,0,0,0,-3000,0,0,0,47000,50000,-3000,-3000,2021-06-09
5719,06304P,臺股指凱基09售14,0,0,0,0,0,0,0,0,0,-3000,0,0,0,16000,19000,-3000,-3000,2021-06-09
5720,06317P,臺股指中信0A售07,0,0,0,0,0,0,0,0,0,-3000,0,0,0,0,3000,-3000,-3000,2021-06-09
5721,082393,金寶凱基09購01,0,0,0,0,0,0,0,0,0,-3000,0,0,0,0,3000,-3000,-3000,2021-06-09
5722,083133,興勤凱基08購01,0,0,0,0,0,0,0,0,0,-3000,0,0,0,0,3000,-3000,-3000,2021-06-09
5723,082515,台灣50群益07購10,0,0,0,0,0,0,0,0,0,-3000,0,0,0,0,3000,-3000,-3000,2021-06-09
5724,080936,長興群益08購01,0,0,0,0,0,0,0,0,0,-3000,0,0,0,0,3000,-3000,-3000,2021-06-09
5725,080647,強茂元大06購04,0,0,0,0,0,0,0,0,0,-3000,0,0,0,0,3000,-3000,-3000,2021-06-09
5726,079962,T50反1群益09購01,0,0,0,0,0,0,0,0,0,-3000,0,0,0,0,3000,-3000,-3000,2021-06-09
5727,080192,大成鋼元富06購03,0,0,0,0,0,0,0,0,0,-3000,0,0,0,0,3000,-3000,-3000,2021-06-09
5728,080282,長興永豐06購01,0,0,0,0,0,0,0,0,0,-3000,0,0,0,0,3000,-3000,-3000,2021-06-09
5729,079036,瑞昱元大07購01,0,0,0,0,0,0,0,0,0,-3000,0,0,0,0,3000,-3000,-3000,2021-06-09
5730,077907,日月光凱基08購01,0,0,0,0,0,0,0,0,0,-3000,0,0,0,0,3000,-3000,-3000,2021-06-09
5731,077477,玉晶光國票08購03,0,0,0,0,0,0,0,0,0,-3000,0,0,0,0,3000,-3000,-3000,2021-06-09
5732,076990,義隆國票07購01,0,0,0,0,0,0,0,0,0,-3000,0,0,0,0,3000,-3000,-3000,2021-06-09
5733,075534,台積電國票0B購01,0,0,0,0,0,0,0,0,0,-3000,0,0,0,31000,34000,-3000,-3000,2021-06-09
5734,075941,緯穎國票07購01,0,0,0,0,0,0,0,0,0,-3000,0,0,0,0,3000,-3000,-3000,2021-06-09
5735,07288P,臺股指麥證11售03,0,0,0,0,3000,-3000,0,0,0,-3000,0,0,0,0,3000,-3000,-3000,2021-06-09
5736,073569,聯發科元大07購01,0,0,0,0,0,0,0,0,0,-3000,0,0,0,0,3000,-3000,-3000,2021-06-09
5737,06524P,台積電元大09售19,0,0,0,0,0,0,0,0,0,-3000,0,0,0,0,3000,-3000,-3000,2021-06-09
5738,06466P,臺股指中信0C售06,0,0,0,0,0,0,0,0,0,-3000,0,0,0,0,3000,-3000,-3000,2021-06-09
5739,06963P,長榮元富0A售17,0,0,0,0,0,0,0,0,0,-3000,0,0,0,297000,300000,-3000,-3000,2021-06-09
5740,07041P,中鋼台新0B售02,0,0,0,0,0,0,0,0,0,-3000,0,0,0,8000,11000,-3000,-3000,2021-06-09
5741,1436,華友聯,0,3000,-3000,0,0,0,0,0,0,0,0,0,0,0,0,0,-3000,2021-06-09
5742,1468,昶和,4000,7000,-3000,0,0,0,0,0,0,0,0,0,0,0,0,0,-3000,2021-06-09
5743,1104,環泥,124000,127000,-3000,0,0,0,0,0,0,0,0,0,0,0,0,0,-3000,2021-06-09
5744,089137,華碩元大09購05,0,0,0,0,0,0,0,0,0,-3000,0,0,0,48000,51000,-3000,-3000,2021-06-09
5745,089460,群創統一0B購07,0,0,0,0,0,0,0,0,0,-3000,0,0,0,7000,10000,-3000,-3000,2021-06-09
5746,2887F,台新戊特二,0,3000,-3000,0,0,0,0,0,0,0,0,0,0,0,0,0,-3000,2021-06-09
5747,2706,第一店,4000,7000,-3000,0,0,0,0,0,0,0,0,0,0,0,0,0,-3000,2021-06-09
5748,4552,力達-KY,2000,5000,-3000,0,0,0,0,0,0,0,0,0,0,0,0,0,-3000,2021-06-09
5749,4438,廣越,13000,17000,-4000,0,0,0,0,0,0,1000,1000,0,1000,0,0,0,-3000,2021-06-09
5750,1724,台硝,1000,4000,-3000,0,0,0,0,0,0,0,0,0,0,0,0,0,-3000,2021-06-09
5751,8114,振樺電,4000,7000,-3000,0,0,0,0,0,0,0,0,0,0,0,0,0,-3000,2021-06-09
5752,8072,陞泰,3000,6000,-3000,0,0,0,0,0,0,0,0,0,0,0,0,0,-3000,2021-06-09
5753,8462,柏文,3000,6000,-3000,0,0,0,0,0,0,0,0,0,0,0,0,0,-3000,2021-06-09
5754,6230,尼得科超眾,15000,16000,-1000,0,0,0,0,0,0,-2000,0,0,0,0,2000,-2000,-3000,2021-06-09
5755,6442,光聖,0,3000,-3000,0,0,0,0,0,0,0,0,0,0,0,0,0,-3000,2021-06-09
5756,6431,光麗-KY,1000,4000,-3000,0,0,0,0,0,0,0,0,0,0,0,0,0,-3000,2021-06-09
5757,6579,研揚,0,3000,-3000,0,0,0,0,0,0,0,0,0,0,0,0,0,-3000,2021-06-09
5758,4104,佳醫,5000,8486,-3486,0,0,0,0,0,0,0,0,0,0,0,0,0,-3486,2021-06-09
5759,086393,FANG+統一0B購01,0,0,0,0,0,0,0,0,0,-4000,0,0,0,1000,5000,-4000,-4000,2021-06-09
5760,086389,臺股指國票09購16,0,0,0,0,0,0,0,0,0,-4000,0,0,0,5000,9000,-4000,-4000,2021-06-09
5761,086307,華邦電凱基0C購01,0,0,0,0,0,0,0,0,0,-4000,0,0,0,0,4000,-4000,-4000,2021-06-09
5762,086139,元石油元大0B購01,0,0,0,0,0,0,0,0,0,-4000,0,0,0,36000,40000,-4000,-4000,2021-06-09
5763,085263,致新國泰0A購01,0,0,0,0,0,0,0,0,0,-4000,0,0,0,5000,9000,-4000,-4000,2021-06-09
5764,085477,大立光麥證0B購01,0,0,0,0,4000,-4000,0,0,0,-4000,0,0,0,0,4000,-4000,-4000,2021-06-09
5765,084134,長興永豐07購01,0,0,0,0,0,0,0,0,0,-4000,0,0,0,1000,5000,-4000,-4000,2021-06-09
5766,083613,日月光日盛07購02,0,0,0,0,0,0,0,0,0,-4000,0,0,0,1000,5000,-4000,-4000,2021-06-09
5767,084263,聯電國票09購02,0,0,0,0,0,0,0,0,0,-4000,0,0,0,0,4000,-4000,-4000,2021-06-09
5768,084896,華邦電統一09購09,0,0,0,0,0,0,0,0,0,-4000,0,0,0,0,4000,-4000,-4000,2021-06-09
5769,085014,宏碁元大08購05,0,0,0,0,0,0,0,0,0,-4000,0,0,0,20000,24000,-4000,-4000,2021-06-09
5770,087203,台灣50凱基09購08,0,0,0,0,0,0,0,0,0,-4000,0,0,0,0,4000,-4000,-4000,2021-06-09
5771,088543,鴻海群益0B購04,0,0,0,0,0,0,0,0,0,-4000,0,0,0,2000,6000,-4000,-4000,2021-06-09
5772,087710,台積電統一13購01,0,0,0,0,0,0,0,0,0,-4000,0,0,0,0,4000,-4000,-4000,2021-06-09
5773,087943,台灣50元富0B購06,0,0,0,0,0,0,0,0,0,-4000,0,0,0,0,4000,-4000,-4000,2021-06-09
5774,087881,華邦電元大11購01,0,0,0,0,0,0,0,0,0,-4000,0,0,0,0,4000,-4000,-4000,2021-06-09
5775,032560,長榮群益14購01,0,0,0,0,0,0,0,0,0,-4000,0,0,0,15000,19000,-4000,-4000,2021-06-09
5776,032537,長榮凱基14購05,0,4000,-4000,0,0,0,0,0,0,0,0,0,0,0,0,0,-4000,2021-06-09
5777,033313,智原元富0C購01,0,0,0,0,0,0,0,0,0,-4000,0,0,0,77000,81000,-4000,-4000,2021-06-09
5778,033245,聯發科元大0B購03,0,0,0,0,0,0,0,0,0,-4000,0,0,0,5000,9000,-4000,-4000,2021-06-09
5779,030609,南亞科元大0C購01,0,0,0,0,0,0,0,0,0,-4000,0,0,0,50000,54000,-4000,-4000,2021-06-09
5780,030577,日月光富邦0B購01,0,0,0,0,0,0,0,0,0,-4000,0,0,0,0,4000,-4000,-4000,2021-06-09
5781,030623,景碩元大0C購01,0,0,0,0,0,0,0,0,0,-4000,0,0,0,1000,5000,-4000,-4000,2021-06-09
5782,031103,南亞科群益0B購04,0,0,0,0,0,0,0,0,0,-4000,0,0,0,0,4000,-4000,-4000,2021-06-09
5783,031408,遠東新凱基0A購01,0,0,0,0,0,0,0,0,0,-4000,0,0,0,0,4000,-4000,-4000,2021-06-09
5784,031352,臺股指元大0A購29,0,0,0,0,0,0,0,0,0,-4000,0,0,0,160000,164000,-4000,-4000,2021-06-09
5785,031480,台灣50元大11購03,0,0,0,0,0,0,0,0,0,-4000,0,0,0,0,4000,-4000,-4000,2021-06-09
5786,03029X,元展26,0,0,0,0,0,0,0,0,0,-4000,0,0,0,0,4000,-4000,-4000,2021-06-09
5787,0053,元大電子,1000,1000,0,0,0,0,0,0,0,-4000,0,0,0,0,4000,-4000,-4000,2021-06-09
5788,06327P,A50正2元富08售04,0,0,0,0,0,0,0,0,0,-4000,0,0,0,0,4000,-4000,-4000,2021-06-09
5789,036398,欣興中信0C購01,3000,0,3000,0,0,0,0,0,0,-7000,0,0,0,6000,13000,-7000,-4000,2021-06-09
5790,035134,大成鋼統一0C購06,0,0,0,0,0,0,0,0,0,-4000,0,0,0,0,4000,-4000,-4000,2021-06-09
5791,035115,旺宏兆豐0B購02,0,0,0,0,0,0,0,0,0,-4000,0,0,0,0,4000,-4000,-4000,2021-06-09
5792,034277,台達電富邦0C購01,0,0,0,0,0,0,0,0,0,-4000,0,0,0,1000,5000,-4000,-4000,2021-06-09
5793,034318,新纖群益0B購02,0,0,0,0,0,0,0,0,0,-4000,0,0,0,344000,348000,-4000,-4000,2021-06-09
5794,036099,新唐元大13購01,0,0,0,0,0,0,0,0,0,-4000,0,0,0,1000,5000,-4000,-4000,2021-06-09
5795,034680,臺股指凱基0B購19,0,0,0,0,0,0,0,0,0,-4000,0,0,0,0,4000,-4000,-4000,2021-06-09
5796,034353,國泰金元富0B購04,0,0,0,0,0,0,0,0,0,-4000,0,0,0,0,4000,-4000,-4000,2021-06-09
5797,05837P,台達電元大07售05,0,0,0,0,0,0,0,0,0,-4000,0,0,0,0,4000,-4000,-4000,2021-06-09
5798,034211,東聯元富0C購01,0,0,0,0,0,0,0,0,0,-4000,0,0,0,42000,46000,-4000,-4000,2021-06-09
5799,034098,祥碩元大0B購03,0,0,0,0,0,0,0,0,0,-4000,0,0,0,9000,13000,-4000,-4000,2021-06-09
5800,034099,同欣電元大11購01,0,0,0,0,0,0,0,0,0,-4000,0,0,0,20000,24000,-4000,-4000,2021-06-09
5801,06268P,鴻海凱基0A售11,0,0,0,0,0,0,0,0,0,-4000,0,0,0,0,4000,-4000,-4000,2021-06-09
5802,033642,亞德客統一0C購01,0,0,0,0,0,0,0,0,0,-4000,0,0,0,16000,20000,-4000,-4000,2021-06-09
5803,033696,神達元大0B購01,0,0,0,0,0,0,0,0,0,-4000,0,0,0,2000,6000,-4000,-4000,2021-06-09
5804,07080P,富邦金凱基0B售04,0,0,0,0,0,0,0,0,0,-4000,0,0,0,0,4000,-4000,-4000,2021-06-09
5805,06939P,臺股指凱基0A售22,0,0,0,0,0,0,0,0,0,-4000,0,0,0,1000,5000,-4000,-4000,2021-06-09
5806,06503P,日月光元大09售04,0,0,0,0,0,0,0,0,0,-4000,0,0,0,0,4000,-4000,-4000,2021-06-09
5807,067706,台積電元富07購07,0,0,0,0,0,0,0,0,0,-4000,0,0,0,1000,5000,-4000,-4000,2021-06-09
5808,077424,嘉澤國泰07購01,0,0,0,0,0,0,0,0,0,-4000,0,0,0,0,4000,-4000,-4000,2021-06-09
5809,077780,榮成凱基07購01,0,0,0,0,0,0,0,0,0,-4000,0,0,0,16000,20000,-4000,-4000,2021-06-09
5810,078999,光罩凱基08購01,0,0,0,0,0,0,0,0,0,-4000,0,0,0,20000,24000,-4000,-4000,2021-06-09
5811,080046,漢翔永豐06購01,0,0,0,0,0,0,0,0,0,-4000,0,0,0,0,4000,-4000,-4000,2021-06-09
5812,079933,寶成富邦08購01,0,0,0,0,0,0,0,0,0,-4000,0,0,0,0,4000,-4000,-4000,2021-06-09
5813,079524,華邦電元大08購02,0,0,0,0,0,0,0,0,0,-4000,0,0,0,0,4000,-4000,-4000,2021-06-09
5814,080738,華邦電國票07購05,0,0,0,0,0,0,0,0,0,-4000,0,0,0,0,4000,-4000,-4000,2021-06-09
5815,080955,同欣電群益08購01,0,0,0,0,0,0,0,0,0,-4000,0,0,0,0,4000,-4000,-4000,2021-06-09
5816,081389,群創麥證09購01,0,0,0,1000,4000,-3000,0,0,0,-4000,0,0,0,1000,5000,-4000,-4000,2021-06-09
5817,082799,愛普元富08購01,0,0,0,0,0,0,0,0,0,-4000,0,0,0,0,4000,-4000,-4000,2021-06-09
5818,081489,立隆電凱基08購01,0,0,0,0,0,0,0,0,0,-4000,0,0,0,6000,10000,-4000,-4000,2021-06-09
5819,3321,同泰,12000,16000,-4000,0,0,0,0,0,0,0,0,0,0,0,0,0,-4000,2021-06-09
5820,4148,全宇生技-KY,1000,5000,-4000,0,0,0,0,0,0,0,0,0,0,0,0,0,-4000,2021-06-09
5821,4737,華廣,1000,5000,-4000,0,0,0,0,0,0,0,0,0,0,0,0,0,-4000,2021-06-09
5822,4557,永新-KY,1000,5000,-4000,0,0,0,0,0,0,0,0,0,0,0,0,0,-4000,2021-06-09
5823,3036A,文曄甲特,0,0,0,0,0,0,0,0,0,-4000,0,4000,-4000,0,0,0,-4000,2021-06-09
5824,3018,同開,2000,6000,-4000,0,0,0,0,0,0,0,0,0,0,0,0,0,-4000,2021-06-09
5825,2433,互盛電,6000,10000,-4000,0,0,0,0,0,0,0,0,0,0,0,0,0,-4000,2021-06-09
5826,2420,新巨,16000,20000,-4000,0,0,0,0,0,0,0,0,0,0,0,0,0,-4000,2021-06-09
5827,2543,皇昌,8000,12000,-4000,0,0,0,0,0,0,0,0,0,0,0,0,0,-4000,2021-06-09
5828,089630,國巨凱基13購01,0,0,0,0,0,0,0,0,0,-4000,0,0,0,18000,22000,-4000,-4000,2021-06-09
5829,089776,友達凱基0B購04,0,0,0,0,0,0,0,0,0,-4000,0,0,0,8000,12000,-4000,-4000,2021-06-09
5830,089891,立積統一0C購02,0,0,0,0,0,0,0,0,0,-4000,0,0,0,9000,13000,-4000,-4000,2021-06-09
5831,1465,偉全,1000,5000,-4000,0,0,0,0,0,0,0,0,0,0,0,0,0,-4000,2021-06-09
5832,1535,中宇,3000,7000,-4000,0,0,0,0,0,0,0,0,0,0,0,0,0,-4000,2021-06-09
5833,1530,亞崴,0,4000,-4000,0,0,0,0,0,0,0,0,0,0,0,0,0,-4000,2021-06-09
5834,6655,科定,2000,6000,-4000,0,0,0,0,0,0,0,0,0,0,0,0,0,-4000,2021-06-09
5835,6605,帝寶,26000,27000,-1000,0,0,0,0,0,0,-3000,0,0,0,0,3000,-3000,-4000,2021-06-09
5836,9136,巨騰-DR,3000,7000,-4000,0,0,0,0,0,0,0,0,0,0,0,0,0,-4000,2021-06-09
5837,9926,新海,0,4000,-4000,0,0,0,0,0,0,0,0,0,0,0,0,0,-4000,2021-06-09
5838,01002T,土銀國泰R1,3546,8000,-4454,0,0,0,0,0,0,0,0,0,0,0,0,0,-4454,2021-06-09
5839,087815,台塑凱基0B購01,0,0,0,0,0,0,0,0,0,-5000,0,0,0,0,5000,-5000,-5000,2021-06-09
5840,088061,晶技元大0A購01,0,0,0,0,0,0,0,0,0,-5000,0,0,0,0,5000,-5000,-5000,2021-06-09
5841,088281,瑞昱群益0A購01,0,0,0,0,0,0,0,0,0,-5000,0,0,0,0,5000,-5000,-5000,2021-06-09
5842,088239,聯發科國票11購03,0,0,0,0,0,0,0,0,0,-5000,0,0,0,0,5000,-5000,-5000,2021-06-09
5843,088271,聚鼎永豐09購01,0,0,0,0,0,0,0,0,0,-5000,0,0,0,0,5000,-5000,-5000,2021-06-09
5844,088613,偉詮電永豐09購01,0,1000,-1000,0,0,0,0,0,0,-4000,0,0,0,0,4000,-4000,-5000,2021-06-09
5845,088419,瑞昱群益09購01,0,0,0,0,0,0,0,0,0,-5000,0,0,0,6000,11000,-5000,-5000,2021-06-09
5846,088446,為升統一0B購02,0,0,0,0,0,0,0,0,0,-5000,0,0,0,0,5000,-5000,-5000,2021-06-09
5847,088790,台達電群益09購02,0,0,0,0,0,0,0,0,0,-5000,0,0,0,0,5000,-5000,-5000,2021-06-09
5848,088902,台泥群益0B購01,0,0,0,0,0,0,0,0,0,-5000,0,0,0,1530000,1535000,-5000,-5000,2021-06-09
5849,087202,臺股指麥證0C購01,0,0,0,761000,57000,704000,0,0,0,-5000,0,0,0,761000,766000,-5000,-5000,2021-06-09
5850,087276,台塑元大09購01,0,0,0,0,0,0,0,0,0,-5000,0,0,0,20000,25000,-5000,-5000,2021-06-09
5851,087249,南紡國票0A購01,0,0,0,0,0,0,0,0,0,-5000,0,0,0,0,5000,-5000,-5000,2021-06-09
5852,087414,台積電統一0B購11,0,0,0,0,0,0,0,0,0,-5000,0,0,0,0,5000,-5000,-5000,2021-06-09
5853,087421,晶碩統一09購01,0,0,0,0,0,0,0,0,0,-5000,0,0,0,0,5000,-5000,-5000,2021-06-09
5854,087655,潤泰新群益0B購01,0,0,0,0,0,0,0,0,0,-5000,0,0,0,23000,28000,-5000,-5000,2021-06-09
5855,087671,滬深2X元大0A購04,0,0,0,0,0,0,0,0,0,-5000,0,0,0,0,5000,-5000,-5000,2021-06-09
5856,087549,台積電元富13購01,0,0,0,0,0,0,0,0,0,-5000,0,0,0,15000,20000,-5000,-5000,2021-06-09
5857,086648,臺股指凱基0A購07,0,0,0,0,0,0,0,0,0,-5000,0,0,0,10000,15000,-5000,-5000,2021-06-09
5858,086663,TPK國票0A購01,0,0,0,0,0,0,0,0,0,-5000,0,0,0,0,5000,-5000,-5000,2021-06-09
5859,086680,奇力新統一0B購02,0,0,0,0,0,0,0,0,0,-5000,0,0,0,0,5000,-5000,-5000,2021-06-09
5860,086536,台灣50元大0A購08,0,0,0,0,0,0,0,0,0,-5000,0,0,0,0,5000,-5000,-5000,2021-06-09
5861,086539,台灣50元大0A購11,0,0,0,0,0,0,0,0,0,-5000,0,0,0,0,5000,-5000,-5000,2021-06-09
5862,086842,欣興元大09購03,0,0,0,0,0,0,0,0,0,-5000,0,0,0,0,5000,-5000,-5000,2021-06-09
5863,086734,為升群益09購01,0,0,0,0,0,0,0,0,0,-5000,0,0,0,0,5000,-5000,-5000,2021-06-09
5864,086911,大立光凱基13購01,0,0,0,0,0,0,0,0,0,-5000,0,0,0,0,5000,-5000,-5000,2021-06-09
5865,086937,奇力新元大09購03,0,0,0,0,0,0,0,0,0,-5000,0,0,0,0,5000,-5000,-5000,2021-06-09
5866,086987,晶技元富0C購02,0,0,0,0,0,0,0,0,0,-5000,0,0,0,5000,10000,-5000,-5000,2021-06-09
5867,086983,宏碁元富0C購03,0,0,0,0,0,0,0,0,0,-5000,0,0,0,0,5000,-5000,-5000,2021-06-09
5868,085006,南電永豐08購01,0,0,0,0,0,0,0,0,0,-5000,0,0,0,0,5000,-5000,-5000,2021-06-09
5869,085002,仲琦永豐08購01,0,0,0,0,0,0,0,0,0,-5000,0,0,0,0,5000,-5000,-5000,2021-06-09
5870,084938,上緯控元大09購03,0,0,0,0,0,0,0,0,0,-5000,0,0,0,0,5000,-5000,-5000,2021-06-09
5871,084641,安集凱基08購01,0,0,0,0,0,0,0,0,0,-5000,0,0,0,0,5000,-5000,-5000,2021-06-09
5872,084707,貿聯統一0A購01,0,0,0,0,0,0,0,0,0,-5000,0,0,0,0,5000,-5000,-5000,2021-06-09
5873,084828,台積電統一11購02,0,0,0,0,0,0,0,0,0,-5000,0,0,0,0,5000,-5000,-5000,2021-06-09
5874,084345,旺宏元大07購08,0,0,0,0,0,0,0,0,0,-5000,0,0,0,0,5000,-5000,-5000,2021-06-09
5875,084395,南電元富07購12,0,0,0,0,0,0,0,0,0,-5000,0,0,0,0,5000,-5000,-5000,2021-06-09
5876,083445,日月光凱基0B購01,0,0,0,0,0,0,0,0,0,-5000,0,0,0,0,5000,-5000,-5000,2021-06-09
5877,083515,台積電元大07購27,0,0,0,0,0,0,0,0,0,-5000,0,0,0,0,5000,-5000,-5000,2021-06-09
5878,084083,順德元大07購07,0,0,0,0,0,0,0,0,0,-5000,0,0,0,5000,10000,-5000,-5000,2021-06-09
5879,084215,欣興元大07購16,0,0,0,0,0,0,0,0,0,-5000,0,0,0,10000,15000,-5000,-5000,2021-06-09
5880,085515,佳世達國泰0A購01,0,0,0,0,0,0,0,0,0,-5000,0,0,0,73000,78000,-5000,-5000,2021-06-09
5881,085299,聯詠康和08購01,0,0,0,0,0,0,0,0,0,-5000,0,0,0,10000,15000,-5000,-5000,2021-06-09
5882,085194,宏碁群益0A購01,0,0,0,0,0,0,0,0,0,-5000,0,0,0,14000,19000,-5000,-5000,2021-06-09
5883,085212,臺股指群益08購05,0,0,0,0,0,0,0,0,0,-5000,0,0,0,1000,6000,-5000,-5000,2021-06-09
5884,085113,台積電元大0A購01,0,0,0,0,0,0,0,0,0,-5000,0,0,0,0,5000,-5000,-5000,2021-06-09
5885,086154,友達元大0C購02,0,0,0,0,0,0,0,0,0,-5000,0,0,0,0,5000,-5000,-5000,2021-06-09
5886,086185,A50正2凱基0B購01,0,0,0,0,0,0,0,0,0,-5000,0,0,0,0,5000,-5000,-5000,2021-06-09
5887,086340,義隆元大09購01,0,0,0,0,0,0,0,0,0,-5000,0,0,0,35000,40000,-5000,-5000,2021-06-09
5888,086387,祥碩國票0A購01,0,0,0,0,0,0,0,0,0,-5000,0,0,0,0,5000,-5000,-5000,2021-06-09
5889,085818,華邦電群益08購06,0,0,0,0,0,0,0,0,0,-5000,0,0,0,0,5000,-5000,-5000,2021-06-09
5890,085789,友達元大0A購01,0,0,0,0,0,0,0,0,0,-5000,0,0,0,0,5000,-5000,-5000,2021-06-09
5891,085884,台積電國票09購12,0,0,0,0,0,0,0,0,0,-5000,0,0,0,0,5000,-5000,-5000,2021-06-09
5892,085885,台積電國票09購13,0,0,0,0,0,0,0,0,0,-5000,0,0,0,0,5000,-5000,-5000,2021-06-09
5893,00706L,期元大S&P日圓正2,0,0,0,0,0,0,0,0,0,-5000,0,0,0,1000,6000,-5000,-5000,2021-06-09
5894,030009,長興元富11購01,0,0,0,0,0,0,0,0,0,-5000,0,0,0,0,5000,-5000,-5000,2021-06-09
5895,030273,華晶科統一0C購02,0,0,0,0,0,0,0,0,0,-5000,0,0,0,0,5000,-5000,-5000,2021-06-09
5896,030224,康普凱基12購01,0,0,0,0,0,0,0,0,0,-5000,0,0,0,0,5000,-5000,-5000,2021-06-09
5897,03022X,富展01,0,0,0,0,0,0,0,0,0,-5000,0,0,0,0,5000,-5000,-5000,2021-06-09
5898,030427,益登元大0A購02,0,0,0,0,0,0,0,0,0,-5000,0,0,0,5000,10000,-5000,-5000,2021-06-09
5899,031267,華邦電統一0C購02,0,0,0,0,0,0,0,0,0,-5000,0,0,0,4000,9000,-5000,-5000,2021-06-09
5900,031387,友達統一0C購03,0,0,0,0,0,0,0,0,0,-5000,0,0,0,0,5000,-5000,-5000,2021-06-09
5901,030563,華晶科統一0C購03,0,0,0,0,0,0,0,0,0,-5000,0,0,0,0,5000,-5000,-5000,2021-06-09
5902,030158,精英中信0B購01,0,0,0,0,0,0,0,0,0,-5000,0,0,0,0,5000,-5000,-5000,2021-06-09
5903,031069,京鼎元大0A購02,0,0,0,0,0,0,0,0,0,-5000,0,0,0,0,5000,-5000,-5000,2021-06-09
5904,030756,力成元大0B購01,0,0,0,0,0,0,0,0,0,-5000,0,0,0,0,5000,-5000,-5000,2021-06-09
5905,031176,榮成永豐0A購01,0,0,0,0,0,0,0,0,0,-5000,0,0,0,0,5000,-5000,-5000,2021-06-09
5906,030686,聯發科兆豐0A購02,0,0,0,0,0,0,0,0,0,-5000,0,0,0,0,5000,-5000,-5000,2021-06-09
5907,030675,聯電國泰0C購01,0,0,0,0,0,0,0,0,0,-5000,0,0,0,0,5000,-5000,-5000,2021-06-09
5908,030572,聯發科台新0A購01,0,0,0,0,0,0,0,0,0,-5000,0,0,0,0,5000,-5000,-5000,2021-06-09
5909,032347,和碩群益0B購01,0,0,0,0,0,0,0,0,0,-5000,0,0,0,0,5000,-5000,-5000,2021-06-09
5910,033078,聯茂凱基0A購01,0,0,0,0,0,0,0,0,0,-5000,0,0,0,0,5000,-5000,-5000,2021-06-09
5911,032925,矽統國票0B購02,0,0,0,0,0,0,0,0,0,-5000,0,0,0,18000,23000,-5000,-5000,2021-06-09
5912,033035,欣興群益0B購01,0,0,0,0,0,0,0,0,0,-5000,0,0,0,0,5000,-5000,-5000,2021-06-09
5913,033502,智原統一13購01,0,0,0,0,0,0,0,0,0,-5000,0,0,0,0,5000,-5000,-5000,2021-06-09
5914,033466,元金2X凱基12購01,0,0,0,0,0,0,0,0,0,-5000,0,0,0,0,5000,-5000,-5000,2021-06-09
5915,032363,冠德凱基0A購01,0,0,0,0,0,0,0,0,0,-5000,0,0,0,0,5000,-5000,-5000,2021-06-09
5916,032234,台灣50元大0A購21,0,0,0,0,0,0,0,0,0,-5000,0,0,0,0,5000,-5000,-5000,2021-06-09
5917,032480,長榮第一14購01,0,0,0,0,0,0,0,0,0,-5000,0,0,0,0,5000,-5000,-5000,2021-06-09
5918,031897,台聚永豐0A購03,0,0,0,0,0,0,0,0,0,-5000,0,0,0,5000,10000,-5000,-5000,2021-06-09
5919,031790,大成鋼國票0B購02,0,0,0,0,0,0,0,0,0,-5000,0,0,0,0,5000,-5000,-5000,2021-06-09
5920,036215,大成鋼國泰14購01,0,0,0,0,0,0,0,0,0,-5000,0,0,0,0,5000,-5000,-5000,2021-06-09
5921,05668P,台積電中信0B售04,0,0,0,0,0,0,0,0,0,-5000,0,0,0,0,5000,-5000,-5000,2021-06-09
5922,05527P,台灣50台新07售01,0,0,0,0,0,0,0,0,0,-5000,0,0,0,0,5000,-5000,-5000,2021-06-09
5923,05501P,上証2X元富06售04,0,0,0,0,0,0,0,0,0,-5000,0,0,0,0,5000,-5000,-5000,2021-06-09
5924,036273,台玻元大0C購04,0,0,0,0,0,0,0,0,0,-5000,0,0,0,0,5000,-5000,-5000,2021-06-09
5925,033630,富邦金元富12購03,0,0,0,0,0,0,0,0,0,-5000,0,0,0,0,5000,-5000,-5000,2021-06-09
5926,033661,奇力新統一13購01,0,0,0,0,0,0,0,0,0,-5000,0,0,0,0,5000,-5000,-5000,2021-06-09
5927,033765,GIS凱基0B購02,0,0,0,0,0,0,0,0,0,-5000,0,0,0,0,5000,-5000,-5000,2021-06-09
5928,036141,台積電富邦14購02,0,0,0,0,0,0,0,0,0,-5000,0,0,0,6000,11000,-5000,-5000,2021-06-09
5929,034777,台積電富邦0C購04,0,0,0,0,0,0,0,0,0,-5000,0,0,0,0,5000,-5000,-5000,2021-06-09
5930,06093P,鴻海中信09售06,0,0,0,0,0,0,0,0,0,-5000,0,0,0,5000,10000,-5000,-5000,2021-06-09
5931,06034P,聯電元富07售14,0,0,0,0,0,0,0,0,0,-5000,0,0,0,0,5000,-5000,-5000,2021-06-09
5932,034254,華新科統一11購03,0,0,0,0,0,0,0,0,0,-5000,0,0,0,61000,66000,-5000,-5000,2021-06-09
5933,034271,臺股指國票0B購13,0,0,0,0,0,0,0,0,0,-5000,0,0,0,0,5000,-5000,-5000,2021-06-09
5934,034358,富邦金康和11購01,0,0,0,0,0,0,0,0,0,-5000,0,0,0,68000,73000,-5000,-5000,2021-06-09
5935,033813,台泥統一11購01,0,0,0,0,0,0,0,0,0,-5000,0,0,0,0,5000,-5000,-5000,2021-06-09
5936,033793,界霖元大0B購01,0,0,0,0,0,0,0,0,0,-5000,0,0,0,0,5000,-5000,-5000,2021-06-09
5937,033800,中石化國票0C購02,0,0,0,0,0,0,0,0,0,-5000,0,0,0,0,5000,-5000,-5000,2021-06-09
5938,034702,愛普群益12購02,0,0,0,0,0,0,0,0,0,-5000,0,0,0,0,5000,-5000,-5000,2021-06-09
5939,034541,萬海統一0C購05,0,0,0,0,0,0,0,0,0,-5000,0,0,0,0,5000,-5000,-5000,2021-06-09
5940,036105,臺股指元大0C購35,0,0,0,0,0,0,0,0,0,-5000,0,0,0,0,5000,-5000,-5000,2021-06-09
5941,036106,臺股指元大0C購36,0,0,0,0,0,0,0,0,0,-5000,0,0,0,0,5000,-5000,-5000,2021-06-09
5942,035992,聯電國泰12購01,0,0,0,0,0,0,0,0,0,-5000,0,0,0,120000,125000,-5000,-5000,2021-06-09
5943,034011,玉晶光群益0C購04,0,0,0,0,0,0,0,0,0,-5000,0,0,0,9000,14000,-5000,-5000,2021-06-09
5944,035936,旺宏凱基0C購02,0,0,0,0,0,0,0,0,0,-5000,0,0,0,0,5000,-5000,-5000,2021-06-09
5945,035868,裕民元富13購06,0,0,0,0,0,0,0,0,0,-5000,0,0,0,0,5000,-5000,-5000,2021-06-09
5946,035802,威致凱基0B購01,0,0,0,0,0,0,0,0,0,-5000,0,0,0,0,5000,-5000,-5000,2021-06-09
5947,035815,同欣電凱基0B購01,0,0,0,0,0,0,0,0,0,-5000,0,0,0,0,5000,-5000,-5000,2021-06-09
5948,035474,儒鴻富邦0C購01,0,0,0,0,0,0,0,0,0,-5000,0,0,0,0,5000,-5000,-5000,2021-06-09
5949,034821,台積電富邦13購03,0,0,0,0,0,0,0,0,0,-5000,0,0,0,1000,6000,-5000,-5000,2021-06-09
5950,035623,佳世達國票0C購01,0,0,0,0,0,0,0,0,0,-5000,0,0,0,0,5000,-5000,-5000,2021-06-09
5951,035641,高股息中信12購01,0,0,0,0,0,0,0,0,0,-5000,0,0,0,0,5000,-5000,-5000,2021-06-09
5952,035743,愛普國票0B購01,0,0,0,0,0,0,0,0,0,-5000,0,0,0,0,5000,-5000,-5000,2021-06-09
5953,035727,祥碩元大0B購04,0,0,0,0,0,0,0,0,0,-5000,0,0,0,0,5000,-5000,-5000,2021-06-09
5954,035111,中石化兆豐0C購03,0,0,0,0,0,0,0,0,0,-5000,0,0,0,38000,43000,-5000,-5000,2021-06-09
5955,035033,遠東新麥證0C購01,0,0,0,20000,44000,-24000,0,0,0,-5000,0,0,0,39000,44000,-5000,-5000,2021-06-09
5956,035264,中鋼統一0B購06,0,0,0,0,0,0,0,0,0,-5000,0,0,0,0,5000,-5000,-5000,2021-06-09
5957,035381,國泰金凱基0B購06,0,0,0,0,0,0,0,0,0,-5000,0,0,0,0,5000,-5000,-5000,2021-06-09
5958,036415,台玻第一16購01,0,0,0,0,0,0,0,0,0,-5000,0,0,0,0,5000,-5000,-5000,2021-06-09
5959,04605P,華城元富08售02,0,0,0,0,0,0,0,0,0,-5000,0,0,0,0,5000,-5000,-5000,2021-06-09
5960,036561,長榮航元大13購03,0,0,0,0,0,0,0,0,0,-5000,0,0,0,20000,25000,-5000,-5000,2021-06-09
5961,05195P,圓剛元富0C售02,0,0,0,0,0,0,0,0,0,-5000,0,0,0,0,5000,-5000,-5000,2021-06-09
5962,082312,臺股指元大0A購09,0,0,0,0,0,0,0,0,0,-5000,0,0,0,0,5000,-5000,-5000,2021-06-09
5963,082210,聯電群益07購04,0,0,0,0,0,0,0,0,0,-5000,0,0,0,0,5000,-5000,-5000,2021-06-09
5964,082206,台積電日盛09購02,0,0,0,0,0,0,0,0,0,-5000,0,0,0,15000,20000,-5000,-5000,2021-06-09
5965,082139,嘉澤統一09購01,0,0,0,0,0,0,0,0,0,-5000,0,0,0,116000,121000,-5000,-5000,2021-06-09
5966,082804,道瓊銀元大08購01,0,0,0,0,0,0,0,0,0,-5000,0,0,0,10000,15000,-5000,-5000,2021-06-09
5967,082766,群創統一09購02,0,0,0,0,0,0,0,0,0,-5000,0,0,0,0,5000,-5000,-5000,2021-06-09
5968,082689,SGBR2X凱基0A購01,0,0,0,0,0,0,0,0,0,-5000,0,0,0,0,5000,-5000,-5000,2021-06-09
5969,081392,臺股指麥證08購01,0,0,0,0,5000,-5000,0,0,0,-5000,0,0,0,0,5000,-5000,-5000,2021-06-09
5970,081430,台玻統一09購01,0,0,0,0,0,0,0,0,0,-5000,0,0,0,0,5000,-5000,-5000,2021-06-09
5971,081295,長興元大07購01,0,0,0,0,0,0,0,0,0,-5000,0,0,0,0,5000,-5000,-5000,2021-06-09
5972,081087,亞光中信0B購01,0,0,0,0,0,0,0,0,0,-5000,0,0,0,0,5000,-5000,-5000,2021-06-09
5973,080709,潤泰全凱基09購01,0,0,0,0,0,0,0,0,0,-5000,0,0,0,0,5000,-5000,-5000,2021-06-09
5974,080742,達運國票07購02,0,0,0,0,0,0,0,0,0,-5000,0,0,0,0,5000,-5000,-5000,2021-06-09
5975,080574,A50正2元富06購01,0,0,0,0,0,0,0,0,0,-5000,0,0,0,5000,10000,-5000,-5000,2021-06-09
5976,079884,台積電元富08購32,0,0,0,0,0,0,0,0,0,-5000,0,0,0,0,5000,-5000,-5000,2021-06-09
5977,079981,台積電統一08購01,0,0,0,0,0,0,0,0,0,-5000,0,0,0,0,5000,-5000,-5000,2021-06-09
5978,080216,亞聚元大06購02,0,0,0,0,0,0,0,0,0,-5000,0,0,0,0,5000,-5000,-5000,2021-06-09
5979,078746,T50反1國票0A購03,0,0,0,0,0,0,0,0,0,-5000,0,0,0,0,5000,-5000,-5000,2021-06-09
5980,078692,台積電國泰09購01,0,0,0,0,0,0,0,0,0,-5000,0,0,0,0,5000,-5000,-5000,2021-06-09
5981,078491,友達國票08購04,0,0,0,0,0,0,0,0,0,-5000,0,0,0,0,5000,-5000,-5000,2021-06-09
5982,076929,京鼎元富0B購01,0,0,0,0,0,0,0,0,0,-5000,0,0,0,0,5000,-5000,-5000,2021-06-09
5983,076801,聯發科國票08購04,0,0,0,0,0,0,0,0,0,-5000,0,0,0,0,5000,-5000,-5000,2021-06-09
5984,072763,大立光國泰07購02,0,0,0,0,0,0,0,0,0,-5000,0,0,0,0,5000,-5000,-5000,2021-06-09
5985,07194P,國巨元富12售11,0,0,0,0,0,0,0,0,0,-5000,0,0,0,0,5000,-5000,-5000,2021-06-09
5986,076447,大立光麥證09購01,0,0,0,0,5000,-5000,0,0,0,-5000,0,0,0,0,5000,-5000,-5000,2021-06-09
5987,06795P,臺股指中信12售01,0,0,0,0,0,0,0,0,0,-5000,0,0,0,0,5000,-5000,-5000,2021-06-09
5988,06733P,鴻海元大09售24,0,0,0,0,0,0,0,0,0,-5000,0,0,0,0,5000,-5000,-5000,2021-06-09
5989,06521P,聯電國泰0B售02,0,0,0,0,0,0,0,0,0,-5000,0,0,0,0,5000,-5000,-5000,2021-06-09
5990,06494P,聯發科凱基09售08,0,0,0,0,0,0,0,0,0,-5000,0,0,0,35000,40000,-5000,-5000,2021-06-09
5991,06425P,台積電富邦0A售03,0,0,0,0,0,0,0,0,0,-5000,0,0,0,51000,56000,-5000,-5000,2021-06-09
5992,06956P,台灣50元大0B售02,0,0,0,0,0,0,0,0,0,-5000,0,0,0,15000,20000,-5000,-5000,2021-06-09
5993,06989P,日月光元富0B售01,0,0,0,0,0,0,0,0,0,-5000,0,0,0,0,5000,-5000,-5000,2021-06-09
5994,06853P,上証2X元大11售01,0,0,0,0,0,0,0,0,0,-5000,0,0,0,2000,7000,-5000,-5000,2021-06-09
5995,07037P,中鋼群益0B售12,0,0,0,0,0,0,0,0,0,-5000,0,0,0,5000,10000,-5000,-5000,2021-06-09
5996,07105P,鴻海群益0B售11,0,0,0,0,0,0,0,0,0,-5000,0,0,0,40000,45000,-5000,-5000,2021-06-09
5997,8442,威宏-KY,0,3000,-3000,0,0,0,0,0,0,-2000,0,2000,-2000,0,0,0,-5000,2021-06-09
5998,8443,阿瘦,0,5000,-5000,0,0,0,0,0,0,0,0,0,0,0,0,0,-5000,2021-06-09
5999,6464,台數科,2000,7000,-5000,0,0,0,0,0,0,0,0,0,0,0,0,0,-5000,2021-06-09
6000,6183,關貿,14000,19000,-5000,0,0,0,0,0,0,0,0,0,0,0,0,0,-5000,2021-06-09
6001,1503,士電,21000,24000,-3000,0,0,0,0,0,0,-2000,0,2000,-2000,0,0,0,-5000,2021-06-09
6002,1340,勝悅-KY,44000,49000,-5000,0,0,0,0,0,0,0,0,0,0,0,0,0,-5000,2021-06-09
6003,089692,緯創元大09購06,0,0,0,0,0,0,0,0,0,-5000,0,0,0,0,5000,-5000,-5000,2021-06-09
6004,089743,新纖統一0B購01,0,0,0,0,0,0,0,0,0,-5000,0,0,0,0,5000,-5000,-5000,2021-06-09
6005,089719,友達國泰0B購04,0,0,0,0,0,0,0,0,0,-5000,0,0,0,11000,16000,-5000,-5000,2021-06-09
6006,089490,台積電元富0C購20,0,0,0,0,0,0,0,0,0,-5000,0,0,0,0,5000,-5000,-5000,2021-06-09
6007,089551,滬深2X兆豐0B購02,0,0,0,0,0,0,0,0,0,-5000,0,0,0,0,5000,-5000,-5000,2021-06-09
6008,089557,聯電統一0B購09,0,0,0,0,0,0,0,0,0,-5000,0,0,0,10000,15000,-5000,-5000,2021-06-09
6009,089559,台積電統一0B購14,0,0,0,0,0,0,0,0,0,-5000,0,0,0,0,5000,-5000,-5000,2021-06-09
6010,089561,聯發科統一0B購05,0,0,0,0,0,0,0,0,0,-5000,0,0,0,0,5000,-5000,-5000,2021-06-09
6011,089416,統一永豐09購02,0,0,0,0,0,0,0,0,0,-5000,0,0,0,5000,10000,-5000,-5000,2021-06-09
6012,089301,台積電國票0A購07,0,0,0,0,0,0,0,0,0,-5000,0,0,0,12000,17000,-5000,-5000,2021-06-09
6013,089330,高股息元大09購01,0,0,0,0,0,0,0,0,0,-5000,0,0,0,1000,6000,-5000,-5000,2021-06-09
6014,2546,根基,1000,6000,-5000,0,0,0,0,0,0,0,0,0,0,0,0,0,-5000,2021-06-09
6015,2597,潤弘,31000,36000,-5000,0,0,0,0,0,0,0,0,0,0,0,0,0,-5000,2021-06-09
6016,2524,京城,7000,12000,-5000,0,0,0,0,0,0,0,0,0,0,0,0,0,-5000,2021-06-09
6017,2438,翔耀,1000,6000,-5000,0,0,0,0,0,0,0,0,0,0,0,0,0,-5000,2021-06-09
6018,1776,展宇,1000,6000,-5000,0,0,0,0,0,0,0,0,0,0,0,0,0,-5000,2021-06-09
6019,3002,歐格,1000,6000,-5000,0,0,0,0,0,0,0,0,0,0,0,0,0,-5000,2021-06-09
6020,4190,佐登-KY,5000,10000,-5000,0,0,0,0,0,0,0,0,0,0,0,0,0,-5000,2021-06-09
6021,4439,冠星-KY,7000,12000,-5000,0,0,0,0,0,0,0,0,0,0,0,0,0,-5000,2021-06-09
6022,3607,谷崧,39000,44000,-5000,0,0,0,0,0,0,0,0,0,0,0,0,0,-5000,2021-06-09
6023,6133,金橋,14000,19000,-5000,0,0,0,0,0,0,-8,0,8,-8,0,0,0,-5008,2021-06-09
6024,0051,元大中型100,40,0,40,0,0,0,0,0,0,-5537,0,0,0,8009,13546,-5537,-5497,2021-06-09
6025,085871,華邦電元富0A購08,0,0,0,0,0,0,0,0,0,-6000,0,0,0,0,6000,-6000,-6000,2021-06-09
6026,086306,台積電凱基09購12,0,0,0,0,0,0,0,0,0,-6000,0,0,0,15000,21000,-6000,-6000,2021-06-09
6027,085718,美指2X中信0B購01,0,0,0,0,0,0,0,0,0,-6000,0,0,0,0,6000,-6000,-6000,2021-06-09
6028,084099,日月光元大07購12,0,0,0,0,0,0,0,0,0,-6000,0,0,0,0,6000,-6000,-6000,2021-06-09
6029,083606,大立光中信08購02,0,0,0,0,0,0,0,0,0,-6000,0,0,0,72000,78000,-6000,-6000,2021-06-09
6030,083425,崇越永豐07購01,0,0,0,0,0,0,0,0,0,-6000,0,0,0,76000,82000,-6000,-6000,2021-06-09
6031,084824,台積電統一0A購08,0,0,0,0,0,0,0,0,0,-6000,0,0,0,0,6000,-6000,-6000,2021-06-09
6032,086996,聯發科國票0C購02,0,0,0,0,0,0,0,0,0,-6000,0,0,0,0,6000,-6000,-6000,2021-06-09
6033,086737,台積電群益0B購02,0,0,0,0,0,0,0,0,0,-6000,0,0,0,3000,9000,-6000,-6000,2021-06-09
6034,086830,友達元大09購10,0,0,0,0,0,0,0,0,0,-6000,0,0,0,28000,34000,-6000,-6000,2021-06-09
6035,086462,矽創群益0A購01,0,0,0,0,0,0,0,0,0,-6000,0,0,0,2000,8000,-6000,-6000,2021-06-09
6036,086620,中石化凱基0A購01,0,0,0,0,0,0,0,0,0,-6000,0,0,0,0,6000,-6000,-6000,2021-06-09
6037,086631,佳世達凱基09購02,0,0,0,0,0,0,0,0,0,-6000,0,0,0,0,6000,-6000,-6000,2021-06-09
6038,087609,聯電永豐09購02,0,0,0,0,0,0,0,0,0,-6000,0,0,0,0,6000,-6000,-6000,2021-06-09
6039,087362,台積電兆豐0A購05,0,0,0,0,0,0,0,0,0,-6000,0,0,0,0,6000,-6000,-6000,2021-06-09
6040,087264,GIS國票0A購01,0,0,0,0,0,0,0,0,0,-6000,0,0,0,4000,10000,-6000,-6000,2021-06-09
6041,087262,樺漢國票0A購01,0,0,0,0,0,0,0,0,0,-6000,0,0,0,0,6000,-6000,-6000,2021-06-09
6042,087286,美律元大0B購01,0,0,0,0,0,0,0,0,0,-6000,0,0,0,0,6000,-6000,-6000,2021-06-09
6043,087153,牧德國泰0B購01,0,0,0,0,0,0,0,0,0,-6000,0,0,0,4000,10000,-6000,-6000,2021-06-09
6044,087141,瑞昱國票0A購02,0,0,0,0,0,0,0,0,0,-6000,0,0,0,16000,22000,-6000,-6000,2021-06-09
6045,088847,A50正2永豐09購02,0,0,0,0,0,0,0,0,0,-6000,0,0,0,0,6000,-6000,-6000,2021-06-09
6046,088603,A50正2永豐09購01,0,0,0,0,0,0,0,0,0,-6000,0,0,0,0,6000,-6000,-6000,2021-06-09
6047,088106,界霖國票0A購01,0,0,0,0,0,0,0,0,0,-6000,0,0,0,0,6000,-6000,-6000,2021-06-09
6048,030835,群創中信11購01,0,0,0,0,0,0,0,0,0,-6000,0,0,0,0,6000,-6000,-6000,2021-06-09
6049,031591,矽格凱基0A購02,0,0,0,0,0,0,0,0,0,-6000,0,0,0,4000,10000,-6000,-6000,2021-06-09
6050,032800,百和元大0A購02,0,0,0,0,0,0,0,0,0,-6000,0,0,0,0,6000,-6000,-6000,2021-06-09
6051,05599P,南亞科元富07售06,0,0,0,0,0,0,0,0,0,-6000,0,0,0,1000,7000,-6000,-6000,2021-06-09
6052,032063,復盛國票0B購01,0,0,0,0,0,0,0,0,0,-6000,0,0,0,0,6000,-6000,-6000,2021-06-09
6053,032471,萬海中信0B購02,0,0,0,0,0,0,0,0,0,-6000,0,0,0,0,6000,-6000,-6000,2021-06-09
6054,032211,大亞統一0C購03,0,0,0,0,0,0,0,0,0,-6000,0,0,0,1000,7000,-6000,-6000,2021-06-09
6055,032376,華新統一0C購01,0,0,0,0,0,0,0,0,0,-6000,0,0,0,0,6000,-6000,-6000,2021-06-09
6056,033129,華邦電元大0A購14,0,0,0,0,0,0,0,0,0,-6000,0,0,0,0,6000,-6000,-6000,2021-06-09
6057,036394,華新科國泰12購01,0,0,0,0,0,0,0,0,0,-6000,0,0,0,5000,11000,-6000,-6000,2021-06-09
6058,036391,榮成國泰12購01,0,0,0,0,0,0,0,0,0,-6000,0,0,0,0,6000,-6000,-6000,2021-06-09
6059,035341,台積電元富12購21,0,0,0,0,0,0,0,0,0,-6000,0,0,0,0,6000,-6000,-6000,2021-06-09
6060,034876,晶技國泰11購02,0,0,0,0,0,0,0,0,0,-6000,0,0,0,12000,18000,-6000,-6000,2021-06-09
6061,034001,台積電群益0B購06,0,0,0,0,0,0,0,0,0,-6000,0,0,0,0,6000,-6000,-6000,2021-06-09
6062,034692,台積電群益0B購08,0,0,0,0,0,0,0,0,0,-6000,0,0,0,7000,13000,-6000,-6000,2021-06-09
6063,034674,長榮凱基12購03,0,0,0,0,0,0,0,0,0,-6000,0,0,0,1000,7000,-6000,-6000,2021-06-09
6064,033830,鴻海國泰11購01,0,0,0,0,0,0,0,0,0,-6000,0,0,0,771000,777000,-6000,-6000,2021-06-09
6065,06302P,臺股指凱基08售13,0,0,0,0,0,0,0,0,0,-6000,0,0,0,4000,10000,-6000,-6000,2021-06-09
6066,034750,愛普元大0C購01,0,0,0,0,0,0,0,0,0,-6000,0,0,0,0,6000,-6000,-6000,2021-06-09
6067,035527,聯電群益0C購03,0,0,0,0,0,0,0,0,0,-6000,0,0,0,0,6000,-6000,-6000,2021-06-09
6068,071141,啟碁元富09購01,0,0,0,0,0,0,0,0,0,-6000,0,0,0,0,6000,-6000,-6000,2021-06-09
6069,07025P,儒鴻凱基0B售02,0,0,0,0,0,0,0,0,0,-6000,0,0,0,127000,133000,-6000,-6000,2021-06-09
6070,068401,瑞昱元富07購03,0,0,0,0,0,0,0,0,0,-6000,0,0,0,0,6000,-6000,-6000,2021-06-09
6071,06631P,鴻海兆豐0A售02,0,0,0,0,0,0,0,0,0,-6000,0,0,0,0,6000,-6000,-6000,2021-06-09
6072,06798P,群創康和0B售01,0,0,0,0,0,0,0,0,0,-6000,0,0,0,0,6000,-6000,-6000,2021-06-09
6073,074471,華新科富邦07購01,0,0,0,0,0,0,0,0,0,-6000,0,0,0,40000,46000,-6000,-6000,2021-06-09
6074,073829,滬深2X元大07購03,0,0,0,0,0,0,0,0,0,-6000,0,0,0,14000,20000,-6000,-6000,2021-06-09
6075,079299,祥碩元富08購03,0,0,0,0,0,0,0,0,0,-6000,0,0,0,0,6000,-6000,-6000,2021-06-09
6076,080700,致茂凱基09購01,0,0,0,0,0,0,0,0,0,-6000,0,0,0,12000,18000,-6000,-6000,2021-06-09
6077,082491,南亞科統一09購03,0,0,0,0,0,0,0,0,0,-6000,0,0,0,5000,11000,-6000,-6000,2021-06-09
6078,081688,台積電群益09購01,0,0,0,0,0,0,0,0,0,-6000,0,0,0,0,6000,-6000,-6000,2021-06-09
6079,5907,大洋-KY,15000,21000,-6000,0,0,0,0,0,0,0,0,0,0,0,0,0,-6000,2021-06-09
6080,6671,三能-KY,0,6000,-6000,0,0,0,0,0,0,0,0,0,0,0,0,0,-6000,2021-06-09
6081,8478,東哥遊艇,2000,8000,-6000,0,0,0,0,0,0,0,0,0,0,0,0,0,-6000,2021-06-09
6082,8463,潤泰材,9000,15000,-6000,0,0,0,0,0,0,0,0,0,0,0,0,0,-6000,2021-06-09
6083,910861,神州-DR,0,6000,-6000,0,0,0,0,0,0,0,0,0,0,0,0,0,-6000,2021-06-09
6084,3617,碩天,3000,9000,-6000,0,0,0,0,0,0,0,0,0,0,0,0,0,-6000,2021-06-09
6085,3432,台端,1000,7000,-6000,0,0,0,0,0,0,0,0,0,0,0,0,0,-6000,2021-06-09
6086,3535,晶彩科,102000,109000,-7000,0,0,0,0,0,0,1000,1000,0,1000,0,0,0,-6000,2021-06-09
6087,4763,材料-KY,1000,7000,-6000,0,0,0,0,0,0,0,0,0,0,0,0,0,-6000,2021-06-09
6088,4766,南寶,3000,9000,-6000,0,0,0,0,0,0,0,0,0,0,0,0,0,-6000,2021-06-09
6089,5284,jpp-KY,0,7000,-7000,0,0,0,0,0,0,1000,1000,0,1000,0,0,0,-6000,2021-06-09
6090,2739,寒舍,1000,7000,-6000,0,0,0,0,0,0,0,0,0,0,0,0,0,-6000,2021-06-09
6091,089345,台積電元大09購31,0,0,0,0,0,0,0,0,0,-6000,0,0,0,0,6000,-6000,-6000,2021-06-09
6092,1614,三洋電,21000,27000,-6000,0,0,0,0,0,0,0,0,0,0,0,0,0,-6000,2021-06-09
6093,088215,同欣電統一0B購01,0,0,0,0,0,0,0,0,0,-7000,0,0,0,3000,10000,-7000,-7000,2021-06-09
6094,088197,欣興群益0A購01,0,0,0,0,0,0,0,0,0,-7000,0,0,0,13000,20000,-7000,-7000,2021-06-09
6095,088308,達欣工凱基0A購01,0,0,0,0,0,0,0,0,0,-7000,0,0,0,0,7000,-7000,-7000,2021-06-09
6096,087808,富邦金兆豐09購04,0,0,0,0,0,0,0,0,0,-7000,0,0,0,3000,10000,-7000,-7000,2021-06-09
6097,087345,晶豪科凱基0C購02,0,0,0,0,0,0,0,0,0,-7000,0,0,0,42000,49000,-7000,-7000,2021-06-09
6098,087402,聯詠元大11購01,0,0,0,0,0,0,0,0,0,-7000,0,0,0,13000,20000,-7000,-7000,2021-06-09
6099,086614,群創群益0B購02,0,0,0,0,0,0,0,0,0,-7000,0,0,0,21000,28000,-7000,-7000,2021-06-09
6100,083747,界霖國票08購01,0,0,0,0,0,0,0,0,0,-7000,0,0,0,0,7000,-7000,-7000,2021-06-09
6101,085083,盛群永豐08購01,0,0,0,0,0,0,0,0,0,-7000,0,0,0,60000,67000,-7000,-7000,2021-06-09
6102,085321,臺股指元大08購22,0,0,0,0,0,0,0,0,0,-7000,0,0,0,0,7000,-7000,-7000,2021-06-09
6103,086161,聯陽元大08購02,0,0,0,0,0,0,0,0,0,-7000,0,0,0,19000,26000,-7000,-7000,2021-06-09
6104,033081,台積電統一14購01,0,0,0,0,0,0,0,0,0,-7000,0,0,0,0,7000,-7000,-7000,2021-06-09
6105,032344,群創群益11購02,0,0,0,0,0,0,0,0,0,-7000,0,0,0,0,7000,-7000,-7000,2021-06-09
6106,033276,聯電統一11購01,0,0,0,0,0,0,0,0,0,-7000,0,0,0,0,7000,-7000,-7000,2021-06-09
6107,032132,中鋼構凱基12購01,0,0,0,0,0,0,0,0,0,-7000,0,0,0,0,7000,-7000,-7000,2021-06-09
6108,032497,泰山永豐0A購01,0,0,0,0,0,0,0,0,0,-7000,0,0,0,0,7000,-7000,-7000,2021-06-09
6109,032045,旺宏國票0A購03,0,0,0,0,0,0,0,0,0,-7000,0,0,0,0,7000,-7000,-7000,2021-06-09
6110,05514P,聯電凱基09售02,0,0,0,0,0,0,0,0,0,-7000,0,0,0,40000,47000,-7000,-7000,2021-06-09
6111,030590,A50正2元大0A購03,0,0,0,0,0,0,0,0,0,-7000,0,0,0,2000,9000,-7000,-7000,2021-06-09
6112,030284,威盛元富11購01,0,0,0,0,0,0,0,0,0,-7000,0,0,0,3000,10000,-7000,-7000,2021-06-09
6113,030323,聯發科麥證12購02,0,0,0,208000,215000,-7000,0,0,0,-7000,0,0,0,208000,215000,-7000,-7000,2021-06-09
6114,030527,元黃金凱基0C購01,0,0,0,0,0,0,0,0,0,-7000,0,0,0,0,7000,-7000,-7000,2021-06-09
6115,031427,瑞昱凱基0A購02,0,0,0,0,0,0,0,0,0,-7000,0,0,0,4000,11000,-7000,-7000,2021-06-09
6116,031457,裕隆群益0A購01,0,0,0,0,0,0,0,0,0,-7000,0,0,0,5000,12000,-7000,-7000,2021-06-09
6117,034942,聯詠群益11購02,0,0,0,0,0,0,0,0,0,-7000,0,0,0,18000,25000,-7000,-7000,2021-06-09
6118,06067P,聯發科凱基0C售04,0,0,0,0,0,0,0,0,0,-7000,0,0,0,694000,701000,-7000,-7000,2021-06-09
6119,035991,台聚國泰12購01,0,0,0,0,0,0,0,0,0,-7000,0,0,0,3000,10000,-7000,-7000,2021-06-09
6120,035785,裕民國泰13購01,0,0,0,0,0,0,0,0,0,-7000,0,0,0,18000,25000,-7000,-7000,2021-06-09
6121,035330,欣興元大0B購03,0,0,0,0,0,0,0,0,0,-7000,0,0,0,103000,110000,-7000,-7000,2021-06-09
6122,035315,佳世達元大0C購03,0,0,0,0,0,0,0,0,0,-7000,0,0,0,1000,8000,-7000,-7000,2021-06-09
6123,081795,儒鴻凱基0B購01,0,0,0,0,0,0,0,0,0,-7000,0,0,0,0,7000,-7000,-7000,2021-06-09
6124,082428,盛群永豐07購01,0,0,0,0,0,0,0,0,0,-7000,0,0,0,0,7000,-7000,-7000,2021-06-09
6125,082824,台勝科元大07購05,0,0,0,0,0,0,0,0,0,-7000,0,0,0,1000,8000,-7000,-7000,2021-06-09
6126,080566,儒鴻永豐06購01,0,0,0,0,0,0,0,0,0,-7000,0,0,0,0,7000,-7000,-7000,2021-06-09
6127,081384,聯發科麥證0C購01,0,0,0,108000,115000,-7000,0,0,0,-7000,0,0,0,108000,115000,-7000,-7000,2021-06-09
6128,079064,日月光國票07購02,0,0,0,0,0,0,0,0,0,-7000,0,0,0,0,7000,-7000,-7000,2021-06-09
6129,079824,精英元大06購01,0,0,0,0,0,0,0,0,0,-7000,0,0,0,0,7000,-7000,-7000,2021-06-09
6130,073505,瑞昱元富0A購01,0,0,0,0,0,0,0,0,0,-7000,0,0,0,11000,18000,-7000,-7000,2021-06-09
6131,07294P,臺股指群益0C售04,0,0,0,0,0,0,0,0,0,-7000,0,0,0,0,7000,-7000,-7000,2021-06-09
6132,076529,聯發科元大06購06,0,0,0,0,0,0,0,0,0,-7000,0,0,0,0,7000,-7000,-7000,2021-06-09
6133,076053,愛普國票08購01,0,0,0,0,0,0,0,0,0,-7000,0,0,0,0,7000,-7000,-7000,2021-06-09
6134,06430P,友達凱基09售07,0,0,0,0,0,0,0,0,0,-7000,0,0,0,56000,63000,-7000,-7000,2021-06-09
6135,06499P,元石油元大09售01,0,0,0,0,0,0,0,0,0,-7000,0,0,0,0,7000,-7000,-7000,2021-06-09
6136,07103P,臺股指凱基0B售17,0,0,0,0,0,0,0,0,0,-7000,0,0,0,0,7000,-7000,-7000,2021-06-09
6137,07136P,宏碁凱基0B售01,0,0,0,0,0,0,0,0,0,-7000,0,0,0,0,7000,-7000,-7000,2021-06-09
6138,1470,大統新創,1000,8000,-7000,0,0,0,0,0,0,0,0,0,0,0,0,0,-7000,2021-06-09
6139,1410,南染,0,7000,-7000,0,0,0,0,0,0,0,0,0,0,0,0,0,-7000,2021-06-09
6140,089903,益航凱基11購01,0,0,0,0,0,0,0,0,0,-7000,0,0,0,2000,9000,-7000,-7000,2021-06-09
6141,089303,旺宏國票0A購02,0,0,0,0,0,0,0,0,0,-7000,0,0,0,27000,34000,-7000,-7000,2021-06-09
6142,089123,上証2X元大0C購03,0,0,0,0,0,0,0,0,0,-7000,0,0,0,13000,20000,-7000,-7000,2021-06-09
6143,089680,矽統元大09購01,0,0,0,0,0,0,0,0,0,-7000,0,0,0,1000,8000,-7000,-7000,2021-06-09
6144,2903,遠百,164000,202000,-38000,0,0,0,0,0,0,31000,35000,4000,31000,0,0,0,-7000,2021-06-09
6145,5225,東科-KY,0,7000,-7000,0,0,0,0,0,0,0,0,0,0,0,0,0,-7000,2021-06-09
6146,4566,時碩工業,3000,10000,-7000,0,0,0,0,0,0,0,0,0,0,0,0,0,-7000,2021-06-09
6147,3593,力銘,1000,8000,-7000,0,0,0,0,0,0,0,0,0,0,0,0,0,-7000,2021-06-09
6148,2115,六暉-KY,7000,14000,-7000,0,0,0,0,0,0,0,0,0,0,0,0,0,-7000,2021-06-09
6149,2373,震旦行,1000,8000,-7000,0,0,0,0,0,0,0,0,0,0,0,0,0,-7000,2021-06-09
6150,2539,櫻花建,14000,21000,-7000,0,0,0,0,0,0,0,0,0,0,0,0,0,-7000,2021-06-09
6151,9912,偉聯,0,7000,-7000,0,0,0,0,0,0,0,0,0,0,0,0,0,-7000,2021-06-09
6152,8411,福貞-KY,0,7000,-7000,0,0,0,0,0,0,0,0,0,0,0,0,0,-7000,2021-06-09
6153,6115,鎰勝,20000,27000,-7000,0,0,0,0,0,0,0,0,0,0,0,0,0,-7000,2021-06-09
6154,9938,百和,748000,704918,43082,0,0,0,0,0,0,-51000,4000,22000,-18000,0,33000,-33000,-7918,2021-06-09
6155,00675L,富邦臺灣加權正2,61000,51000,10000,0,0,0,0,0,0,-17960,0,0,0,82063,100023,-17960,-7960,2021-06-09
6156,086361,臺股指元大0B購12,0,0,0,0,0,0,0,0,0,-8000,0,0,0,8000,16000,-8000,-8000,2021-06-09
6157,083572,致伸群益08購02,0,0,0,0,0,0,0,0,0,-8000,0,0,0,0,8000,-8000,-8000,2021-06-09
6158,083974,南電凱基0C購01,0,0,0,0,0,0,0,0,0,-8000,0,0,0,197000,205000,-8000,-8000,2021-06-09
6159,084241,京元電統一09購03,0,0,0,0,0,0,0,0,0,-8000,0,0,0,271000,279000,-8000,-8000,2021-06-09
6160,083998,大立光永豐07購04,0,0,0,0,0,0,0,0,0,-8000,0,0,0,52000,60000,-8000,-8000,2021-06-09
6161,086761,台灣50凱基09購07,0,0,0,0,0,0,0,0,0,-8000,0,0,0,0,8000,-8000,-8000,2021-06-09
6162,086769,佳世達凱基11購01,0,0,0,0,0,0,0,0,0,-8000,0,0,0,0,8000,-8000,-8000,2021-06-09
6163,087606,台達化永豐09購02,0,0,0,0,0,0,0,0,0,-8000,0,0,0,0,8000,-8000,-8000,2021-06-09
6164,087130,榮成國票0A購01,0,0,0,0,0,0,0,0,0,-8000,0,0,0,12000,20000,-8000,-8000,2021-06-09
6165,087868,上証2X元大09購04,0,0,0,0,0,0,0,0,0,-8000,0,0,0,103000,111000,-8000,-8000,2021-06-09
6166,030094,台積電永豐0A購01,0,0,0,0,0,0,0,0,0,-8000,0,0,0,2000,10000,-8000,-8000,2021-06-09
6167,030656,南帝永豐0A購02,0,0,0,0,0,0,0,0,0,-8000,0,0,0,2000,10000,-8000,-8000,2021-06-09
6168,030820,大成鋼日盛0C購01,0,0,0,0,0,0,0,0,0,-8000,0,0,0,12000,20000,-8000,-8000,2021-06-09
6169,03075X,元展70,0,0,0,0,0,0,0,0,0,-8000,0,0,0,0,8000,-8000,-8000,2021-06-09
6170,031149,奇鋐兆豐0A購01,0,0,0,0,0,0,0,0,0,-8000,0,0,0,0,8000,-8000,-8000,2021-06-09
6171,05543P,鴻海元富09售06,0,0,0,0,0,0,0,0,0,-8000,0,0,0,0,8000,-8000,-8000,2021-06-09
6172,032534,益航凱基14購01,0,0,0,0,0,0,0,0,0,-8000,0,0,0,0,8000,-8000,-8000,2021-06-09
6173,032020,致新統一0C購01,0,0,0,0,0,0,0,0,0,-8000,0,0,0,3000,11000,-8000,-8000,2021-06-09
6174,032895,聯陽統一0C購02,0,0,0,0,0,0,0,0,0,-8000,0,0,0,2179000,2187000,-8000,-8000,2021-06-09
6175,035352,臻鼎國泰11購01,0,0,0,0,0,0,0,0,0,-8000,0,0,0,0,8000,-8000,-8000,2021-06-09
6176,035214,臺股指中信13購03,0,0,0,0,0,0,0,0,0,-8000,0,0,0,0,8000,-8000,-8000,2021-06-09
6177,035182,裕隆元富0B購01,0,0,0,0,0,0,0,0,0,-8000,0,0,0,0,8000,-8000,-8000,2021-06-09
6178,036494,國巨國泰12購03,0,0,0,0,0,0,0,0,0,-8000,0,0,0,0,8000,-8000,-8000,2021-06-09
6179,036037,長榮航統一0C購06,0,0,0,0,0,0,0,0,0,-8000,0,0,0,189000,197000,-8000,-8000,2021-06-09
6180,036092,大立光元大11購02,0,0,0,0,0,0,0,0,0,-8000,0,0,0,0,8000,-8000,-8000,2021-06-09
6181,036081,亞德客元大0C購01,0,0,0,0,0,0,0,0,0,-8000,0,0,0,2000,10000,-8000,-8000,2021-06-09
6182,035900,新唐國泰12購01,0,0,0,0,0,0,0,0,0,-8000,0,0,0,80000,88000,-8000,-8000,2021-06-09
6183,034013,新纖統一0B購04,0,0,0,0,0,0,0,0,0,-8000,0,0,0,25000,33000,-8000,-8000,2021-06-09
6184,033975,友達凱基11購02,0,0,0,0,0,0,0,0,0,-8000,0,0,0,0,8000,-8000,-8000,2021-06-09
6185,034823,友達富邦11購03,0,0,0,0,0,0,0,0,0,-8000,0,0,0,68000,76000,-8000,-8000,2021-06-09
6186,035706,大成鋼元大0B購15,0,0,0,0,0,0,0,0,0,-8000,0,0,0,0,8000,-8000,-8000,2021-06-09
6187,033699,華夏國票0C購01,0,0,0,0,0,0,0,0,0,-8000,0,0,0,0,8000,-8000,-8000,2021-06-09
6188,034258,萬海統一17購01,0,0,0,0,0,0,0,0,0,-8000,0,0,0,12000,20000,-8000,-8000,2021-06-09
6189,034573,T50正2凱基0C購01,0,0,0,0,0,0,0,0,0,-8000,0,0,0,66000,74000,-8000,-8000,2021-06-09
6190,034400,新纖國票0C購02,0,0,0,0,0,0,0,0,0,-8000,0,0,0,0,8000,-8000,-8000,2021-06-09
6191,06510P,鴻海國票0A售04,0,0,0,0,0,0,0,0,0,-8000,0,0,0,0,8000,-8000,-8000,2021-06-09
6192,078278,京鼎國票08購01,0,0,0,0,0,0,0,0,0,-8000,0,0,0,4000,12000,-8000,-8000,2021-06-09
6193,081312,亞光元大07購01,0,0,0,0,0,0,0,0,0,-8000,0,0,0,0,8000,-8000,-8000,2021-06-09
6194,080594,和大統一08購01,0,0,0,0,0,0,0,0,0,-8000,0,0,0,14000,22000,-8000,-8000,2021-06-09
6195,082513,智原兆豐08購01,0,0,0,0,0,0,0,0,0,-8000,0,0,0,0,8000,-8000,-8000,2021-06-09
6196,083008,國巨凱基0B購01,0,0,0,0,0,0,0,0,0,-8000,0,0,0,0,8000,-8000,-8000,2021-06-09
6197,081865,聯發科日盛08購01,0,0,0,0,0,0,0,0,0,-8000,0,0,0,432000,440000,-8000,-8000,2021-06-09
6198,911622,泰聚亨-DR,0,8000,-8000,0,0,0,0,0,0,0,0,0,0,0,0,0,-8000,2021-06-09
6199,5484,慧友,0,12000,-12000,0,0,0,0,0,0,4000,4000,0,4000,0,0,0,-8000,2021-06-09
6200,6192,巨路,2000,9000,-7000,0,0,0,0,0,0,-1000,0,1000,-1000,0,0,0,-8000,2021-06-09
6201,2243,宏旭-KY,2000,7000,-5000,0,0,0,0,0,0,-3000,0,3000,-3000,0,0,0,-8000,2021-06-09
6202,3528,安馳,2000,10000,-8000,0,0,0,0,0,0,0,0,0,0,0,0,0,-8000,2021-06-09
6203,2722,夏都,1000,9000,-8000,0,0,0,0,0,0,0,0,0,0,0,0,0,-8000,2021-06-09
6204,089639,大立光凱基0B購03,0,0,0,0,0,0,0,0,0,-8000,0,0,0,0,8000,-8000,-8000,2021-06-09
6205,089413,立積凱基09購03,0,0,0,0,0,0,0,0,0,-8000,0,0,0,92000,100000,-8000,-8000,2021-06-09
6206,089972,聯發科元大0A購04,0,0,0,0,0,0,0,0,0,-8000,0,0,0,5000,13000,-8000,-8000,2021-06-09
6207,1435,中福,0,8000,-8000,0,0,0,0,0,0,0,0,0,0,0,0,0,-8000,2021-06-09
6208,1540,喬福,3000,11000,-8000,0,0,0,0,0,0,0,0,0,0,0,0,0,-8000,2021-06-09
6209,087860,臺股指國票09購24,0,0,0,0,0,0,0,0,0,-9000,0,0,0,0,9000,-9000,-9000,2021-06-09
6210,087139,瑞昱國票09購01,0,0,0,0,0,0,0,0,0,-9000,0,0,0,13000,22000,-9000,-9000,2021-06-09
6211,087227,緯穎凱基0A購02,0,0,0,0,0,0,0,0,0,-9000,0,0,0,21000,30000,-9000,-9000,2021-06-09
6212,086523,聯陽凱基09購02,0,0,0,0,0,0,0,0,0,-9000,0,0,0,11000,20000,-9000,-9000,2021-06-09
6213,084832,聯發科統一0A購03,0,0,0,0,0,0,0,0,0,-9000,0,0,0,1000,10000,-9000,-9000,2021-06-09
6214,084855,鴻海元大08購11,0,0,0,0,0,0,0,0,0,-9000,0,0,0,0,9000,-9000,-9000,2021-06-09
6215,085055,友達國票09購04,0,0,0,0,0,0,0,0,0,-9000,0,0,0,9000,18000,-9000,-9000,2021-06-09
6216,085158,友達凱基08購09,0,0,0,0,0,0,0,0,0,-9000,0,0,0,18000,27000,-9000,-9000,2021-06-09
6217,032464,群創國泰0C購03,0,0,0,0,0,0,0,0,0,-9000,0,0,0,110000,119000,-9000,-9000,2021-06-09
6218,032191,群光群益0B購01,0,0,0,0,0,0,0,0,0,-9000,0,0,0,1000,10000,-9000,-9000,2021-06-09
6219,05609P,台積電國泰08售05,0,0,0,0,0,0,0,0,0,-9000,0,0,0,0,9000,-9000,-9000,2021-06-09
6220,030690,聯陽兆豐0B購01,0,0,0,0,0,0,0,0,0,-9000,0,0,0,0,9000,-9000,-9000,2021-06-09
6221,030691,彩晶兆豐0A購02,0,0,0,0,0,0,0,0,0,-9000,0,0,0,1000,10000,-9000,-9000,2021-06-09
6222,032699,台泥兆豐0B購01,0,0,0,0,0,0,0,0,0,-9000,0,0,0,0,9000,-9000,-9000,2021-06-09
6223,033208,旺宏群益11購01,0,0,0,0,0,0,0,0,0,-9000,0,0,0,7000,16000,-9000,-9000,2021-06-09
6224,030029,新唐統一0C購01,0,0,0,0,0,0,0,0,0,-9000,0,0,0,331000,340000,-9000,-9000,2021-06-09
6225,031494,聯電元大0A購09,0,0,0,0,0,0,0,0,0,-9000,0,0,0,0,9000,-9000,-9000,2021-06-09
6226,030477,台玻永豐0A購01,0,0,0,0,0,0,0,0,0,-9000,0,0,0,1000,10000,-9000,-9000,2021-06-09
6227,034496,大立光元大0C購08,0,0,0,0,0,0,0,0,0,-9000,0,0,0,0,9000,-9000,-9000,2021-06-09
6228,034518,中鋼元富0B購05,0,0,0,0,0,0,0,0,0,-9000,0,0,0,73000,82000,-9000,-9000,2021-06-09
6229,034190,新光鋼元大13購01,0,0,0,0,0,0,0,0,0,-9000,0,0,0,16000,25000,-9000,-9000,2021-06-09
6230,035615,台聚國票0C購02,0,0,0,0,0,0,0,0,0,-9000,0,0,0,26000,35000,-9000,-9000,2021-06-09
6231,035654,大成鋼國泰12購01,0,0,0,0,0,0,0,0,0,-9000,0,0,0,0,9000,-9000,-9000,2021-06-09
6232,035507,富邦金凱基0C購01,0,0,0,0,0,0,0,0,0,-9000,0,0,0,1000,10000,-9000,-9000,2021-06-09
6233,035874,滬深2X群益0B購03,0,0,0,0,0,0,0,0,0,-9000,0,0,0,0,9000,-9000,-9000,2021-06-09
6234,035959,新光鋼元大0C購04,0,0,0,0,0,0,0,0,0,-9000,0,0,0,2000,11000,-9000,-9000,2021-06-09
6235,036432,圓剛凱基0C購01,0,0,0,0,0,0,0,0,0,-9000,0,0,0,66000,75000,-9000,-9000,2021-06-09
6236,035189,旺宏元富0B購03,0,0,0,0,0,0,0,0,0,-9000,0,0,0,0,9000,-9000,-9000,2021-06-09
6237,035078,中鋼第一15購02,0,0,0,0,0,0,0,0,0,-9000,0,0,0,20000,29000,-9000,-9000,2021-06-09
6238,081898,道瓊銅凱基08購01,0,0,0,0,0,0,0,0,0,-9000,0,0,0,0,9000,-9000,-9000,2021-06-09
6239,081600,廣宇元大07購02,0,0,0,0,0,0,0,0,0,-9000,0,0,0,0,9000,-9000,-9000,2021-06-09
6240,082125,中鋼統一09購02,0,0,0,0,0,0,0,0,0,-9000,0,0,0,10000,19000,-9000,-9000,2021-06-09
6241,082999,臺股指元大08購12,0,0,0,0,0,0,0,0,0,-9000,0,0,0,3000,12000,-9000,-9000,2021-06-09
6242,083050,鴻海兆豐09購05,0,0,0,0,0,0,0,0,0,-9000,0,0,0,1000,10000,-9000,-9000,2021-06-09
6243,083138,美食凱基08購01,0,0,0,0,0,0,0,0,0,-9000,0,0,0,1000,10000,-9000,-9000,2021-06-09
6244,083266,大立光凱基09購03,0,0,0,0,0,0,0,0,0,-9000,0,0,0,7000,16000,-9000,-9000,2021-06-09
6245,082790,聯發科元富0A購05,0,0,0,0,0,0,0,0,0,-9000,0,0,0,0,9000,-9000,-9000,2021-06-09
6246,081383,台積電麥證0A購01,0,0,0,1000,10000,-9000,0,0,0,-9000,0,0,0,1000,10000,-9000,-9000,2021-06-09
6247,06531P,臺股指群益09售06,0,0,0,0,0,0,0,0,0,-9000,0,0,0,14000,23000,-9000,-9000,2021-06-09
6248,06372P,華新科元大08售04,0,0,0,0,0,0,0,0,0,-9000,0,0,0,1000,10000,-9000,-9000,2021-06-09
6249,06712P,立積統一0B售07,0,0,0,0,0,0,0,0,0,-9000,0,0,0,1000,10000,-9000,-9000,2021-06-09
6250,06861P,大成鋼元富0A售03,0,0,0,0,0,0,0,0,0,-9000,0,0,0,1000,10000,-9000,-9000,2021-06-09
6251,1438,三地開發,0,9000,-9000,0,0,0,0,0,0,0,0,0,0,0,0,0,-9000,2021-06-09
6252,1342,八貫,0,9000,-9000,0,0,0,0,0,0,0,0,0,0,0,0,0,-9000,2021-06-09
6253,1256,鮮活果汁-KY,6000,15000,-9000,0,0,0,0,0,0,0,0,0,0,0,0,0,-9000,2021-06-09
6254,2850,新產,4000,13000,-9000,0,0,0,0,0,0,0,0,0,0,0,0,0,-9000,2021-06-09
6255,1733,五鼎,17000,26000,-9000,0,0,0,0,0,0,0,0,0,0,0,0,0,-9000,2021-06-09
6256,9937,全國,0,9000,-9000,0,0,0,0,0,0,0,0,0,0,0,0,0,-9000,2021-06-09
6257,9921,巨大,258000,264020,-6020,0,0,0,0,1000,-1000,-2928,1000,2928,-1928,0,1000,-1000,-9948,2021-06-09
6258,085161,可成凱基08購03,0,0,0,0,0,0,0,0,0,-10000,0,0,0,0,10000,-10000,-10000,2021-06-09
6259,085215,裕隆國票09購01,0,0,0,0,0,0,0,0,0,-10000,0,0,0,9000,19000,-10000,-10000,2021-06-09
6260,085172,南電凱基09購03,0,0,0,0,0,0,0,0,0,-10000,0,0,0,0,10000,-10000,-10000,2021-06-09
6261,085090,遠東新凱基08購01,0,0,0,0,0,0,0,0,0,-10000,0,0,0,0,10000,-10000,-10000,2021-06-09
6262,085116,聯發科元大08購09,0,0,0,0,0,0,0,0,0,-10000,0,0,0,0,10000,-10000,-10000,2021-06-09
6263,085308,京元電元大08購02,0,0,0,0,0,0,0,0,0,-10000,0,0,0,0,10000,-10000,-10000,2021-06-09
6264,085210,巨大群益09購01,0,0,0,0,0,0,0,0,0,-10000,0,0,0,0,10000,-10000,-10000,2021-06-09
6265,085707,大立光富邦09購03,0,0,0,0,0,0,0,0,0,-10000,0,0,0,0,10000,-10000,-10000,2021-06-09
6266,085678,旺宏元富09購07,0,0,0,0,0,0,0,0,0,-10000,0,0,0,0,10000,-10000,-10000,2021-06-09
6267,085637,聯詠凱基0C購01,0,0,0,0,0,0,0,0,0,-10000,0,0,0,0,10000,-10000,-10000,2021-06-09
6268,085595,T50反1元大0C購01,0,0,0,0,0,0,0,0,0,-10000,0,0,0,0,10000,-10000,-10000,2021-06-09
6269,085567,A50正2兆豐09購02,0,0,0,0,0,0,0,0,0,-10000,0,0,0,0,10000,-10000,-10000,2021-06-09
6270,085435,聯詠統一0A購01,0,0,0,0,0,0,0,0,0,-10000,0,0,0,0,10000,-10000,-10000,2021-06-09
6271,086359,力成元大09購01,0,0,0,0,0,0,0,0,0,-10000,0,0,0,10000,20000,-10000,-10000,2021-06-09
6272,086373,國喬國票0A購01,0,0,0,0,0,0,0,0,0,-10000,0,0,0,0,10000,-10000,-10000,2021-06-09
6273,086301,聯發科麥證0C購03,0,0,0,0,1000,-1000,0,0,0,-10000,0,0,0,0,10000,-10000,-10000,2021-06-09
6274,086104,聚鼎永豐08購02,0,0,0,0,0,0,0,0,0,-10000,0,0,0,0,10000,-10000,-10000,2021-06-09
6275,086144,聯電元大08購10,0,0,0,0,0,0,0,0,0,-10000,0,0,0,10000,20000,-10000,-10000,2021-06-09
6276,085886,台積電國票09購14,0,0,0,0,0,0,0,0,0,-10000,0,0,0,60000,70000,-10000,-10000,2021-06-09
6277,085887,台積電國票09購15,0,0,0,0,0,0,0,0,0,-10000,0,0,0,0,10000,-10000,-10000,2021-06-09
6278,085904,燿華富邦0A購01,0,0,0,0,0,0,0,0,0,-10000,0,0,0,0,10000,-10000,-10000,2021-06-09
6279,085793,大立光元大0C購04,0,0,0,0,0,0,0,0,0,-10000,0,0,0,0,10000,-10000,-10000,2021-06-09
6280,085992,技嘉元大08購03,0,0,0,0,0,0,0,0,0,-10000,0,0,0,0,10000,-10000,-10000,2021-06-09
6281,086089,群創中信0A購03,0,0,0,0,0,0,0,0,0,-10000,0,0,0,0,10000,-10000,-10000,2021-06-09
6282,085944,聯詠群益08購03,0,0,0,0,0,0,0,0,0,-10000,0,0,0,0,10000,-10000,-10000,2021-06-09
6283,085942,大立光群益0C購01,0,0,0,0,0,0,0,0,0,-10000,0,0,0,0,10000,-10000,-10000,2021-06-09
6284,085003,聯發科永豐08購03,0,0,0,0,0,0,0,0,0,-10000,0,0,0,0,10000,-10000,-10000,2021-06-09
6285,084953,友達凱基08購07,0,0,0,0,0,0,0,0,0,-10000,0,0,0,0,10000,-10000,-10000,2021-06-09
6286,084966,T50反1中信0B購02,0,0,0,0,0,0,0,0,0,-10000,0,0,0,0,10000,-10000,-10000,2021-06-09
6287,084972,友達凱基09購06,0,0,0,0,0,0,0,0,0,-10000,0,0,0,0,10000,-10000,-10000,2021-06-09
6288,084886,全新群益09購01,0,0,0,0,0,0,0,0,0,-10000,0,0,0,0,10000,-10000,-10000,2021-06-09
6289,084918,T50反1元大0B購06,0,0,0,0,0,0,0,0,0,-10000,0,0,0,0,10000,-10000,-10000,2021-06-09
6290,084803,南亞科群益09購01,0,0,0,0,0,0,0,0,0,-10000,0,0,0,0,10000,-10000,-10000,2021-06-09
6291,084326,南電凱基07購03,0,0,0,0,0,0,0,0,0,-10000,0,0,0,0,10000,-10000,-10000,2021-06-09
6292,084302,台積電日盛14購01,0,0,0,0,0,0,0,0,0,-10000,0,0,0,0,10000,-10000,-10000,2021-06-09
6293,083829,南亞科凱基08購02,0,0,0,0,0,0,0,0,0,-10000,0,0,0,0,10000,-10000,-10000,2021-06-09
6294,083859,鈺齊群益08購01,0,0,0,0,0,0,0,0,0,-10000,0,0,0,0,10000,-10000,-10000,2021-06-09
6295,083865,台積電國票07購09,0,0,0,0,0,0,0,0,0,-10000,0,0,0,0,10000,-10000,-10000,2021-06-09
6296,084238,凱美統一09購01,0,0,0,0,0,0,0,0,0,-10000,0,0,0,0,10000,-10000,-10000,2021-06-09
6297,084137,鴻海永豐07購03,0,0,0,0,0,0,0,0,0,-10000,0,0,0,0,10000,-10000,-10000,2021-06-09
6298,083565,國巨群益08購11,0,0,0,0,0,0,0,0,0,-10000,0,0,0,0,10000,-10000,-10000,2021-06-09
6299,083533,健和興元大07購02,0,0,0,0,0,0,0,0,0,-10000,0,0,0,0,10000,-10000,-10000,2021-06-09
6300,083525,京元電元大07購02,0,0,0,0,0,0,0,0,0,-10000,0,0,0,0,10000,-10000,-10000,2021-06-09
6301,083536,晶技元大07購03,0,0,0,0,0,0,0,0,0,-10000,0,0,0,250000,260000,-10000,-10000,2021-06-09
6302,083795,聯發科統一09購12,0,0,0,0,0,0,0,0,0,-10000,0,0,0,0,10000,-10000,-10000,2021-06-09
6303,083733,中興電國票08購02,0,0,0,0,0,0,0,0,0,-10000,0,0,0,2000,12000,-10000,-10000,2021-06-09
6304,083628,宏碁凱基08購01,0,0,0,0,0,0,0,0,0,-10000,0,0,0,0,10000,-10000,-10000,2021-06-09
6305,083666,聯電統一08購08,0,0,0,0,0,0,0,0,0,-10000,0,0,0,0,10000,-10000,-10000,2021-06-09
6306,083676,台積電統一09購11,0,0,0,0,0,0,0,0,0,-10000,0,0,0,0,10000,-10000,-10000,2021-06-09
6307,083688,矽格統一09購01,0,0,0,0,0,0,0,0,0,-10000,0,0,0,0,10000,-10000,-10000,2021-06-09
6308,086538,台灣50元大0A購10,0,0,0,0,0,0,0,0,0,-10000,0,0,0,0,10000,-10000,-10000,2021-06-09
6309,086532,崇越凱基09購01,0,0,0,0,0,0,0,0,0,-10000,0,0,0,0,10000,-10000,-10000,2021-06-09
6310,086637,義隆凱基0A購01,0,0,0,0,0,0,0,0,0,-10000,0,0,0,0,10000,-10000,-10000,2021-06-09
6311,086693,台積電元富0C購02,0,0,0,0,0,0,0,0,0,-10000,0,0,0,0,10000,-10000,-10000,2021-06-09
6312,086712,聯發科元大0B購01,0,0,0,0,0,0,0,0,0,-10000,0,0,0,0,10000,-10000,-10000,2021-06-09
6313,086862,台積電國票0B購02,0,0,0,0,0,0,0,0,0,-10000,0,0,0,0,10000,-10000,-10000,2021-06-09
6314,087001,晶碩國票0A購01,0,0,0,0,0,0,0,0,0,-10000,0,0,0,0,10000,-10000,-10000,2021-06-09
6315,086932,華碩元大09購02,0,0,0,0,0,0,0,0,0,-10000,0,0,0,0,10000,-10000,-10000,2021-06-09
6316,086908,瑞軒凱基09購01,0,0,0,0,0,0,0,0,0,-10000,0,0,0,0,10000,-10000,-10000,2021-06-09
6317,087225,瑞儀凱基09購01,0,0,0,0,0,0,0,0,0,-10000,0,0,0,0,10000,-10000,-10000,2021-06-09
6318,087210,鴻海凱基13購01,0,0,0,0,0,0,0,0,0,-10000,0,0,0,0,10000,-10000,-10000,2021-06-09
6319,087302,臺股指元大0A購22,0,0,0,0,0,0,0,0,0,-10000,0,0,0,5000,15000,-10000,-10000,2021-06-09
6320,087140,瑞昱國票0A購01,0,0,0,0,0,0,0,0,0,-10000,0,0,0,3000,13000,-10000,-10000,2021-06-09
6321,087142,瑞昱國票0B購01,0,0,0,0,0,0,0,0,0,-10000,0,0,0,46000,56000,-10000,-10000,2021-06-09
6322,087152,美律國泰0B購01,0,0,0,0,0,0,0,0,0,-10000,0,0,0,10000,20000,-10000,-10000,2021-06-09
6323,087191,鴻海麥證0C購04,0,0,0,0,10000,-10000,0,0,0,-10000,0,0,0,0,10000,-10000,-10000,2021-06-09
6324,087125,T50反1國票11購01,0,0,0,0,0,0,0,0,0,-10000,0,0,0,0,10000,-10000,-10000,2021-06-09
6325,087574,台灣50元大09購01,0,0,0,0,0,0,0,0,0,-10000,0,0,0,0,10000,-10000,-10000,2021-06-09
6326,087589,日電貿元大0A購01,0,0,0,0,0,0,0,0,0,-10000,0,0,0,0,10000,-10000,-10000,2021-06-09
6327,087343,晶豪科凱基09購03,0,0,0,0,0,0,0,0,0,-10000,0,0,0,0,10000,-10000,-10000,2021-06-09
6328,087477,恆大永豐09購01,0,0,0,0,0,0,0,0,0,-10000,0,0,0,0,10000,-10000,-10000,2021-06-09
6329,087511,SGBR2X凱基0A購02,0,0,0,0,0,0,0,0,0,-10000,0,0,0,0,10000,-10000,-10000,2021-06-09
6330,087512,SGBR2X凱基0B購01,0,0,0,0,0,0,0,0,0,-10000,0,0,0,0,10000,-10000,-10000,2021-06-09
6331,087903,臺股指元大0C購01,0,0,0,0,0,0,0,0,0,-10000,0,0,0,0,10000,-10000,-10000,2021-06-09
6332,087763,台達電第一13購01,0,0,0,0,0,0,0,0,0,-10000,0,0,0,0,10000,-10000,-10000,2021-06-09
6333,087698,台表科元大0A購01,0,0,0,0,0,0,0,0,0,-10000,0,0,0,0,10000,-10000,-10000,2021-06-09
6334,088344,智易元大09購03,0,0,0,0,0,0,0,0,0,-10000,0,0,0,0,10000,-10000,-10000,2021-06-09
6335,088331,聯發科元大09購10,0,0,0,0,0,0,0,0,0,-10000,0,0,0,102000,112000,-10000,-10000,2021-06-09
6336,088315,惠特凱基09購02,0,0,0,0,0,0,0,0,0,-10000,0,0,0,0,10000,-10000,-10000,2021-06-09
6337,088317,鼎炫凱基0A購01,0,0,0,0,0,0,0,0,0,-10000,0,0,0,0,10000,-10000,-10000,2021-06-09
6338,088256,南茂富邦0A購01,0,0,0,0,0,0,0,0,0,-10000,0,0,0,0,10000,-10000,-10000,2021-06-09
6339,088247,惠特國票0A購02,0,0,0,0,0,0,0,0,0,-10000,0,0,0,210000,220000,-10000,-10000,2021-06-09
6340,088097,光寶科國票0A購01,0,0,0,0,0,0,0,0,0,-10000,0,0,0,0,10000,-10000,-10000,2021-06-09
6341,088186,聯電群益0B購02,0,0,0,0,0,0,0,0,0,-10000,0,0,0,0,10000,-10000,-10000,2021-06-09
6342,088191,華邦電群益09購04,0,0,0,0,0,0,0,0,0,-10000,0,0,0,20000,30000,-10000,-10000,2021-06-09
6343,088189,旺宏群益0B購05,0,0,0,0,0,0,0,0,0,-10000,0,0,0,0,10000,-10000,-10000,2021-06-09
6344,088039,台化元大09購02,0,0,0,0,0,0,0,0,0,-10000,0,0,0,0,10000,-10000,-10000,2021-06-09
6345,088008,聯發科兆豐09購03,0,0,0,0,0,0,0,0,0,-10000,0,0,0,535000,545000,-10000,-10000,2021-06-09
6346,088604,SGBR2X永豐09購01,0,0,0,0,0,0,0,0,0,-10000,0,0,0,0,10000,-10000,-10000,2021-06-09
6347,088606,鴻海永豐09購08,0,0,0,0,0,0,0,0,0,-10000,0,0,0,0,10000,-10000,-10000,2021-06-09
6348,088654,台塑元大09購02,0,0,0,0,0,0,0,0,0,-10000,0,0,0,0,10000,-10000,-10000,2021-06-09
6349,088508,華立元大09購01,0,0,0,0,0,0,0,0,0,-10000,0,0,0,0,10000,-10000,-10000,2021-06-09
6350,088474,長華元富09購02,0,0,0,0,0,0,0,0,0,-10000,0,0,0,0,10000,-10000,-10000,2021-06-09
6351,088431,群創日盛0A購02,0,0,0,0,0,0,0,0,0,-10000,0,0,0,0,10000,-10000,-10000,2021-06-09
6352,088416,台積電群益0C購02,0,0,0,0,0,0,0,0,0,-10000,0,0,0,1000,11000,-10000,-10000,2021-06-09
6353,088361,達方統一0B購01,0,0,0,0,0,0,0,0,0,-10000,0,0,0,0,10000,-10000,-10000,2021-06-09
6354,088836,友達中信09購04,0,0,0,0,0,0,0,0,0,-10000,0,0,0,18000,28000,-10000,-10000,2021-06-09
6355,088822,科嘉元大09購01,0,0,0,0,0,0,0,0,0,-10000,0,0,0,0,10000,-10000,-10000,2021-06-09
6356,088706,臻鼎國泰0B購01,0,0,0,0,0,0,0,0,0,-10000,0,0,0,0,10000,-10000,-10000,2021-06-09
6357,088882,台積電凱基13購03,0,0,0,0,0,0,0,0,0,-10000,0,0,0,0,10000,-10000,-10000,2021-06-09
6358,088991,滬深2X元大0C購05,0,0,0,0,0,0,0,0,0,-10000,0,0,0,0,10000,-10000,-10000,2021-06-09
6359,089043,凌陽群益0A購01,0,0,0,0,0,0,0,0,0,-10000,0,0,0,0,10000,-10000,-10000,2021-06-09
6360,030479,燁輝永豐0A購01,0,0,0,0,0,0,0,0,0,-10000,0,0,0,0,10000,-10000,-10000,2021-06-09
6361,030340,旺宏群益0C購01,0,0,0,0,0,0,0,0,0,-10000,0,0,0,0,10000,-10000,-10000,2021-06-09
6362,030464,超豐中信0A購01,0,0,0,0,0,0,0,0,0,-10000,0,0,0,0,10000,-10000,-10000,2021-06-09
6363,030510,強茂群益0A購01,0,0,0,0,0,0,0,0,0,-10000,0,0,0,0,10000,-10000,-10000,2021-06-09
6364,030504,矽格兆豐0B購01,0,0,0,0,0,0,0,0,0,-10000,0,0,0,0,10000,-10000,-10000,2021-06-09
6365,030505,T50反1群益0C購01,0,0,0,0,0,0,0,0,0,-10000,0,0,0,1399000,1409000,-10000,-10000,2021-06-09
6366,030191,佳格凱基0A購01,0,0,0,0,0,0,0,0,0,-10000,0,0,0,0,10000,-10000,-10000,2021-06-09
6367,030114,松翰永豐0A購01,0,0,0,0,0,0,0,0,0,-10000,0,0,0,0,10000,-10000,-10000,2021-06-09
6368,031477,南亞科國票0B購01,0,0,0,0,0,0,0,0,0,-10000,0,0,0,0,10000,-10000,-10000,2021-06-09
6369,031193,旺宏兆豐0A購01,0,0,0,0,0,0,0,0,0,-10000,0,0,0,0,10000,-10000,-10000,2021-06-09
6370,031203,華城凱基0A購01,0,0,0,0,0,0,0,0,0,-10000,0,0,0,0,10000,-10000,-10000,2021-06-09
6371,031444,宏達電麥證0C購01,0,0,0,0,10000,-10000,0,0,0,-10000,0,0,0,0,10000,-10000,-10000,2021-06-09
6372,031419,聯電凱基0C購03,0,0,0,0,0,0,0,0,0,-10000,0,0,0,0,10000,-10000,-10000,2021-06-09
6373,031439,大亞麥證0B購01,0,0,0,28000,10000,18000,0,0,0,-10000,0,0,0,28000,38000,-10000,-10000,2021-06-09
6374,031388,友達統一0C購04,0,0,0,0,0,0,0,0,0,-10000,0,0,0,0,10000,-10000,-10000,2021-06-09
6375,031349,瑞祺元大0A購02,0,0,0,0,0,0,0,0,0,-10000,0,0,0,0,10000,-10000,-10000,2021-06-09
6376,030022,華邦電日盛0B購01,0,0,0,0,0,0,0,0,0,-10000,0,0,0,0,10000,-10000,-10000,2021-06-09
6377,030312,威鋒電康和0A購01,0,0,0,0,0,0,0,0,0,-10000,0,0,0,0,10000,-10000,-10000,2021-06-09
6378,030276,復盛統一0B購01,0,0,0,0,0,0,0,0,0,-10000,0,0,0,0,10000,-10000,-10000,2021-06-09
6379,030278,聯電日盛0A購01,0,0,0,0,0,0,0,0,0,-10000,0,0,0,0,10000,-10000,-10000,2021-06-09
6380,030092,南帝永豐0A購01,0,0,0,0,0,0,0,0,0,-10000,0,0,0,0,10000,-10000,-10000,2021-06-09
6381,030068,長興群益11購01,0,0,0,0,0,0,0,0,0,-10000,0,0,0,0,10000,-10000,-10000,2021-06-09
6382,030382,元金2X元大11購01,0,0,0,0,0,0,0,0,0,-10000,0,0,0,0,10000,-10000,-10000,2021-06-09
6383,030228,復盛凱基0B購01,0,0,0,0,0,0,0,0,0,-10000,0,0,0,0,10000,-10000,-10000,2021-06-09
6384,033186,T50反1凱基13購02,0,0,0,0,0,0,0,0,0,-10000,0,0,0,0,10000,-10000,-10000,2021-06-09
6385,032685,南紡永豐0A購04,0,0,0,0,0,0,0,0,0,-10000,0,0,0,11000,21000,-10000,-10000,2021-06-09
6386,030687,聯發科兆豐0A購03,0,0,0,0,0,0,0,0,0,-10000,0,0,0,517000,527000,-10000,-10000,2021-06-09
6387,030707,華晶科群益11購01,0,0,0,0,0,0,0,0,0,-10000,0,0,0,0,10000,-10000,-10000,2021-06-09
6388,031186,群創永豐0A購07,0,0,0,0,0,0,0,0,0,-10000,0,0,0,100000,110000,-10000,-10000,2021-06-09
6389,03074X,元展69,0,0,0,0,0,0,0,0,0,-10000,0,0,0,0,10000,-10000,-10000,2021-06-09
6390,030724,燁輝元大0A購01,0,0,0,0,0,0,0,0,0,-10000,0,0,0,0,10000,-10000,-10000,2021-06-09
6391,031131,群創統一0C購04,0,0,0,0,0,0,0,0,0,-10000,0,0,0,0,10000,-10000,-10000,2021-06-09
6392,031105,聯發科群益0A購02,0,0,0,0,0,0,0,0,0,-10000,0,0,0,0,10000,-10000,-10000,2021-06-09
6393,031098,旺宏群益0C購03,0,0,0,0,0,0,0,0,0,-10000,0,0,0,0,10000,-10000,-10000,2021-06-09
6394,031071,群創元大12購03,0,0,0,0,0,0,0,0,0,-10000,0,0,0,0,10000,-10000,-10000,2021-06-09
6395,030812,嘉晶富邦0A購01,0,0,0,0,0,0,0,0,0,-10000,0,0,0,0,10000,-10000,-10000,2021-06-09
6396,031627,長榮統一0C購06,0,0,0,0,0,0,0,0,0,-10000,0,0,0,0,10000,-10000,-10000,2021-06-09
6397,030538,聯發科凱基0A購04,0,0,0,0,0,0,0,0,0,-10000,0,0,0,0,10000,-10000,-10000,2021-06-09
6398,031544,大立光永豐0A購02,0,0,0,0,0,0,0,0,0,-10000,0,0,0,0,10000,-10000,-10000,2021-06-09
6399,031562,T50反1凱基11購04,0,0,0,0,0,0,0,0,0,-10000,0,0,0,5000,15000,-10000,-10000,2021-06-09
6400,030668,彩晶永豐0A購01,0,0,0,0,0,0,0,0,0,-10000,0,0,0,0,10000,-10000,-10000,2021-06-09
6401,030634,致新元大0A購01,0,0,0,0,0,0,0,0,0,-10000,0,0,0,10000,20000,-10000,-10000,2021-06-09
6402,030594,元金2X元大0B購01,0,0,0,0,0,0,0,0,0,-10000,0,0,0,0,10000,-10000,-10000,2021-06-09
6403,030580,聯發科元富0A購10,0,0,0,0,0,0,0,0,0,-10000,0,0,0,0,10000,-10000,-10000,2021-06-09
6404,030857,大成鋼永豐0A購02,0,0,0,0,0,0,0,0,0,-10000,0,0,0,0,10000,-10000,-10000,2021-06-09
6405,030896,中鋼凱基0A購02,0,0,0,0,0,0,0,0,0,-10000,0,0,0,0,10000,-10000,-10000,2021-06-09
6406,030967,華通元大0B購01,0,0,0,0,0,0,0,0,0,-10000,0,0,0,0,10000,-10000,-10000,2021-06-09
6407,05649P,華邦電群益07售02,0,0,0,0,0,0,0,0,0,-10000,0,0,0,0,10000,-10000,-10000,2021-06-09
6408,05500P,南亞科統一06售04,0,0,0,0,0,0,0,0,0,-10000,0,0,0,0,10000,-10000,-10000,2021-06-09
6409,036267,康控群益0C購02,0,0,0,0,0,0,0,0,0,-10000,0,0,0,0,10000,-10000,-10000,2021-06-09
6410,036221,大成鋼中信0C購01,0,0,0,0,0,0,0,0,0,-10000,0,0,0,0,10000,-10000,-10000,2021-06-09
6411,036225,晶碩中信11購01,0,0,0,0,0,0,0,0,0,-10000,0,0,0,5000,15000,-10000,-10000,2021-06-09
6412,036320,長榮航統一12購03,0,0,0,0,0,0,0,0,0,-10000,0,0,0,0,10000,-10000,-10000,2021-06-09
6413,036287,台積電元大0C購20,0,0,0,0,0,0,0,0,0,-10000,0,0,0,0,10000,-10000,-10000,2021-06-09
6414,032532,奇力新凱基0A購02,0,0,0,0,0,0,0,0,0,-10000,0,0,0,0,10000,-10000,-10000,2021-06-09
6415,031786,中石化國票0B購02,0,0,0,0,0,0,0,0,0,-10000,0,0,0,20000,30000,-10000,-10000,2021-06-09
6416,032223,萬海統一0C購03,0,0,0,0,0,0,0,0,0,-10000,0,0,0,0,10000,-10000,-10000,2021-06-09
6417,033340,華通永豐0B購01,0,0,0,0,0,0,0,0,0,-10000,0,0,0,0,10000,-10000,-10000,2021-06-09
6418,033322,瑞昱凱基0C購01,0,0,0,0,0,0,0,0,0,-10000,0,0,0,0,10000,-10000,-10000,2021-06-09
6419,032013,台玻統一0C購01,0,0,0,0,0,0,0,0,0,-10000,0,0,0,0,10000,-10000,-10000,2021-06-09
6420,032027,台塑富邦0C購01,0,0,0,0,0,0,0,0,0,-10000,0,0,0,0,10000,-10000,-10000,2021-06-09
6421,032036,台達化國票0B購01,0,0,0,0,0,0,0,0,0,-10000,0,0,0,0,10000,-10000,-10000,2021-06-09
6422,032090,遠東新永豐0A購02,0,0,0,0,0,0,0,0,0,-10000,0,0,0,0,10000,-10000,-10000,2021-06-09
6423,032101,旺宏永豐0A購02,0,0,0,0,0,0,0,0,0,-10000,0,0,0,0,10000,-10000,-10000,2021-06-09
6424,031902,中鋼永豐0A購04,0,0,0,0,0,0,0,0,0,-10000,0,0,0,0,10000,-10000,-10000,2021-06-09
6425,031941,台聚元大0A購06,0,0,0,0,0,0,0,0,0,-10000,0,0,0,0,10000,-10000,-10000,2021-06-09
6426,032876,宏碁凱基0A購03,0,0,0,0,0,0,0,0,0,-10000,0,0,0,0,10000,-10000,-10000,2021-06-09
6427,032872,力麗凱基0A購01,0,0,0,0,0,0,0,0,0,-10000,0,0,0,0,10000,-10000,-10000,2021-06-09
6428,033281,京元電統一15購01,0,0,0,0,0,0,0,0,0,-10000,0,0,0,5000,15000,-10000,-10000,2021-06-09
6429,032340,新光金群益0A購02,0,0,0,0,0,0,0,0,0,-10000,0,0,0,0,10000,-10000,-10000,2021-06-09
6430,032338,華新科群益0B購01,0,0,0,0,0,0,0,0,0,-10000,0,0,0,5000,15000,-10000,-10000,2021-06-09
6431,033121,喬山元大0B購01,0,0,0,0,0,0,0,0,0,-10000,0,0,0,51000,61000,-10000,-10000,2021-06-09
6432,032398,群創統一14購01,0,0,0,0,0,0,0,0,0,-10000,0,0,0,0,10000,-10000,-10000,2021-06-09
6433,032426,台達電元大0B購01,0,0,0,0,0,0,0,0,0,-10000,0,0,0,0,10000,-10000,-10000,2021-06-09
6434,031851,中鋼中信0A購03,0,0,0,0,0,0,0,0,0,-10000,0,0,0,0,10000,-10000,-10000,2021-06-09
6435,032364,高鐵凱基0A購01,0,0,0,0,0,0,0,0,0,-10000,0,0,0,0,10000,-10000,-10000,2021-06-09
6436,032374,聯成統一0C購01,0,0,0,0,0,0,0,0,0,-10000,0,0,0,0,10000,-10000,-10000,2021-06-09
6437,033467,力麗凱基0C購01,0,0,0,0,0,0,0,0,0,-10000,0,0,0,0,10000,-10000,-10000,2021-06-09
6438,033352,矽創永豐0B購02,0,0,0,0,0,0,0,0,0,-10000,0,0,0,0,10000,-10000,-10000,2021-06-09
6439,033342,京元電永豐0B購01,0,0,0,0,0,0,0,0,0,-10000,0,0,0,0,10000,-10000,-10000,2021-06-09
6440,035045,富邦金國票0B購03,0,0,0,0,0,0,0,0,0,-10000,0,0,0,20000,30000,-10000,-10000,2021-06-09
6441,035197,奇力新元富0B購03,0,0,0,0,0,0,0,0,0,-10000,0,0,0,0,10000,-10000,-10000,2021-06-09
6442,035198,長榮元富0C購03,0,0,0,0,0,0,0,0,0,-10000,0,0,0,0,10000,-10000,-10000,2021-06-09
6443,035210,台灣5G富邦11購01,0,0,0,0,0,0,0,0,0,-10000,0,0,0,0,10000,-10000,-10000,2021-06-09
6444,035153,群創統一0C購12,0,0,0,0,0,0,0,0,0,-10000,0,0,0,0,10000,-10000,-10000,2021-06-09
6445,035251,力鵬凱基0B購01,0,0,0,0,0,0,0,0,0,-10000,0,0,0,0,10000,-10000,-10000,2021-06-09
6446,05701P,金像電元富07售01,0,0,0,0,0,0,0,0,0,-10000,0,0,0,0,10000,-10000,-10000,2021-06-09
6447,036408,國巨群益12購01,0,0,0,0,0,0,0,0,0,-10000,0,0,0,0,10000,-10000,-10000,2021-06-09
6448,036502,台玻凱基12購01,0,0,0,0,0,0,0,0,0,-10000,0,0,0,0,10000,-10000,-10000,2021-06-09
6449,036505,國巨凱基0C購06,0,0,0,0,0,0,0,0,0,-10000,0,0,0,0,10000,-10000,-10000,2021-06-09
6450,03738C,元石油富邦0B牛01,0,0,0,0,0,0,0,0,0,-10000,0,0,0,0,10000,-10000,-10000,2021-06-09
6451,036039,元大金統一11購01,0,0,0,0,0,0,0,0,0,-10000,0,0,0,0,10000,-10000,-10000,2021-06-09
6452,05194P,圓剛元富09售02,0,0,0,0,0,0,0,0,0,-10000,0,0,0,0,10000,-10000,-10000,2021-06-09
6453,035427,聯發科元大0C購12,0,0,0,0,0,0,0,0,0,-10000,0,0,0,0,10000,-10000,-10000,2021-06-09
6454,035432,富邦金元大11購04,0,0,0,0,0,0,0,0,0,-10000,0,0,0,1000,11000,-10000,-10000,2021-06-09
6455,033973,台積電凱基0C購12,0,0,0,0,0,0,0,0,0,-10000,0,0,0,0,10000,-10000,-10000,2021-06-09
6456,036110,友達國泰12購03,0,0,0,0,0,0,0,0,0,-10000,0,0,0,0,10000,-10000,-10000,2021-06-09
6457,035493,旺宏國泰13購01,0,0,0,0,0,0,0,0,0,-10000,0,0,0,8000,18000,-10000,-10000,2021-06-09
6458,035650,國泰金兆豐12購01,0,0,0,0,0,0,0,0,0,-10000,0,0,0,0,10000,-10000,-10000,2021-06-09
6459,035683,鴻海凱基0C購05,0,0,0,0,0,0,0,0,0,-10000,0,0,0,0,10000,-10000,-10000,2021-06-09
6460,035688,玉晶光凱基12購02,0,0,0,0,0,0,0,0,0,-10000,0,0,0,8000,18000,-10000,-10000,2021-06-09
6461,035744,愛普國票0B購02,0,0,0,0,0,0,0,0,0,-10000,0,0,0,0,10000,-10000,-10000,2021-06-09
6462,035737,華邦電國票0C購02,0,0,0,0,0,0,0,0,0,-10000,0,0,0,0,10000,-10000,-10000,2021-06-09
6463,035765,祥碩元富0B購01,0,0,0,0,0,0,0,0,0,-10000,0,0,0,0,10000,-10000,-10000,2021-06-09
6464,035448,聯電國票11購02,0,0,0,0,0,0,0,0,0,-10000,0,0,0,1000,11000,-10000,-10000,2021-06-09
6465,05829P,台灣50凱基07售12,0,0,0,0,0,0,0,0,0,-10000,0,0,0,0,10000,-10000,-10000,2021-06-09
6466,034298,大亞永豐0B購01,0,0,0,0,0,0,0,0,0,-10000,0,0,0,0,10000,-10000,-10000,2021-06-09
6467,034972,祥碩元大11購03,0,0,0,0,0,0,0,0,0,-10000,0,0,0,1000,11000,-10000,-10000,2021-06-09
6468,03498B,臺股指凱基09熊32,0,0,0,0,0,0,0,0,0,-10000,0,0,0,86000,96000,-10000,-10000,2021-06-09
6469,033888,華新統一11購02,0,0,0,0,0,0,0,0,0,-10000,0,0,0,90000,100000,-10000,-10000,2021-06-09
6470,034424,國泰金統一12購01,0,0,0,0,0,0,0,0,0,-10000,0,0,0,0,10000,-10000,-10000,2021-06-09
6471,06094P,鴻海中信09售07,0,0,0,0,0,0,0,0,0,-10000,0,0,0,0,10000,-10000,-10000,2021-06-09
6472,06080P,台積電國票08售11,0,0,0,0,0,0,0,0,0,-10000,0,0,0,0,10000,-10000,-10000,2021-06-09
6473,06141P,欣興中信07售04,0,0,0,0,0,0,0,0,0,-10000,0,0,0,0,10000,-10000,-10000,2021-06-09
6474,06287P,聯發科元大08售12,0,0,0,0,0,0,0,0,0,-10000,0,0,0,0,10000,-10000,-10000,2021-06-09
6475,06191P,台積電凱基08售20,0,0,0,0,0,0,0,0,0,-10000,0,0,0,0,10000,-10000,-10000,2021-06-09
6476,06208P,宏碁凱基08售03,0,0,0,0,0,0,0,0,0,-10000,0,0,0,0,10000,-10000,-10000,2021-06-09
6477,06203P,臺股指群益08售03,0,0,0,0,0,0,0,0,0,-10000,0,0,0,0,10000,-10000,-10000,2021-06-09
6478,033724,國泰金國票0C購01,0,0,0,0,0,0,0,0,0,-10000,0,0,0,19000,29000,-10000,-10000,2021-06-09
6479,033763,奇力新凱基0C購01,0,0,0,0,0,0,0,0,0,-10000,0,0,0,10000,20000,-10000,-10000,2021-06-09
6480,035552,裕民統一0C購04,0,0,0,0,0,0,0,0,0,-10000,0,0,0,0,10000,-10000,-10000,2021-06-09
6481,035573,長榮航元富12購01,0,0,0,0,0,0,0,0,0,-10000,0,0,0,0,10000,-10000,-10000,2021-06-09
6482,034928,鴻海國泰11購06,0,0,0,0,0,0,0,0,0,-10000,0,0,0,110000,120000,-10000,-10000,2021-06-09
6483,034206,台表科元大11購01,0,0,0,0,0,0,0,0,0,-10000,0,0,0,0,10000,-10000,-10000,2021-06-09
6484,034148,友達凱基11購03,0,0,0,0,0,0,0,0,0,-10000,0,0,0,0,10000,-10000,-10000,2021-06-09
6485,034150,富邦金凱基0B購03,0,0,0,0,0,0,0,0,0,-10000,0,0,0,1000,11000,-10000,-10000,2021-06-09
6486,034113,聯發科群益0B購09,0,0,0,0,0,0,0,0,0,-10000,0,0,0,0,10000,-10000,-10000,2021-06-09
6487,034105,聯電群益11購01,0,0,0,0,0,0,0,0,0,-10000,0,0,0,24000,34000,-10000,-10000,2021-06-09
6488,034048,玉晶光元富12購02,0,0,0,0,0,0,0,0,0,-10000,0,0,0,15000,25000,-10000,-10000,2021-06-09
6489,034227,中石化康和11購01,0,0,0,0,0,0,0,0,0,-10000,0,0,0,298000,308000,-10000,-10000,2021-06-09
6490,034350,華新科元富0C購01,0,0,0,0,0,0,0,0,0,-10000,0,0,0,0,10000,-10000,-10000,2021-06-09
6491,033799,國喬國票0C購02,0,0,0,0,0,0,0,0,0,-10000,0,0,0,10000,20000,-10000,-10000,2021-06-09
6492,034531,大立光麥證0B購02,0,0,0,20000,30000,-10000,0,0,0,-10000,0,0,0,20000,30000,-10000,-10000,2021-06-09
6493,034614,台積電台新0B購03,0,0,0,0,0,0,0,0,0,-10000,0,0,0,0,10000,-10000,-10000,2021-06-09
6494,034625,牧德元富12購02,0,0,0,0,0,0,0,0,0,-10000,0,0,0,0,10000,-10000,-10000,2021-06-09
6495,034707,長榮元富0B購05,0,0,0,0,0,0,0,0,0,-10000,0,0,0,0,10000,-10000,-10000,2021-06-09
6496,068777,台積電元富08購02,0,0,0,0,0,0,0,0,0,-10000,0,0,0,0,10000,-10000,-10000,2021-06-09
6497,06992P,長榮台新0B售03,0,0,0,0,0,0,0,0,0,-10000,0,0,0,0,10000,-10000,-10000,2021-06-09
6498,07014P,臻鼎群益0B售02,0,0,0,0,0,0,0,0,0,-10000,0,0,0,0,10000,-10000,-10000,2021-06-09
6499,069449,玉晶光統一08購01,0,0,0,0,0,0,0,0,0,-10000,0,0,0,0,10000,-10000,-10000,2021-06-09
6500,069300,滬深2X凱基08購01,0,0,0,0,0,0,0,0,0,-10000,0,0,0,0,10000,-10000,-10000,2021-06-09
6501,07117P,臺股指麥證0B售07,0,0,0,0,10000,-10000,0,0,0,-10000,0,0,0,0,10000,-10000,-10000,2021-06-09
6502,07180P,臺股指凱基0B售26,0,0,0,0,0,0,0,0,0,-10000,0,0,0,0,10000,-10000,-10000,2021-06-09
6503,070166,瑞昱中信06購04,0,0,0,0,0,0,0,0,0,-10000,0,0,0,0,10000,-10000,-10000,2021-06-09
6504,070377,為升元富08購01,0,0,0,0,0,0,0,0,0,-10000,0,0,0,0,10000,-10000,-10000,2021-06-09
6505,06667P,上銀凱基09售03,0,0,0,0,0,0,0,0,0,-10000,0,0,0,0,10000,-10000,-10000,2021-06-09
6506,06700P,立積統一0A售01,0,0,0,0,0,0,0,0,0,-10000,0,0,0,0,10000,-10000,-10000,2021-06-09
6507,06726P,臺股指中信09售08,0,0,0,0,0,0,0,0,0,-10000,0,0,0,0,10000,-10000,-10000,2021-06-09
6508,06657P,華新科元大09售16,0,0,0,0,0,0,0,0,0,-10000,0,0,0,40000,50000,-10000,-10000,2021-06-09
6509,06658P,亞光元大09售05,0,0,0,0,0,0,0,0,0,-10000,0,0,0,0,10000,-10000,-10000,2021-06-09
6510,06763P,威鋒電元富11售04,0,0,0,0,0,0,0,0,0,-10000,0,0,0,0,10000,-10000,-10000,2021-06-09
6511,06371P,華新科元大08售03,0,0,0,0,0,0,0,0,0,-10000,0,0,0,0,10000,-10000,-10000,2021-06-09
6512,06388P,臺股指中信0B售12,0,0,0,0,0,0,0,0,0,-10000,0,0,0,2000,12000,-10000,-10000,2021-06-09
6513,06598P,台積電群益0A售10,0,0,0,0,0,0,0,0,0,-10000,0,0,0,0,10000,-10000,-10000,2021-06-09
6514,078283,台表科國票07購01,0,0,0,0,0,0,0,0,0,-10000,0,0,0,0,10000,-10000,-10000,2021-06-09
6515,078272,技嘉國票08購01,0,0,0,0,0,0,0,0,0,-10000,0,0,0,0,10000,-10000,-10000,2021-06-09
6516,078231,智邦元富09購03,0,0,0,0,0,0,0,0,0,-10000,0,0,0,104000,114000,-10000,-10000,2021-06-09
6517,078209,聯電國泰08購01,0,0,0,0,0,0,0,0,0,-10000,0,0,0,0,10000,-10000,-10000,2021-06-09
6518,078765,聯發科中信0A購01,0,0,0,0,0,0,0,0,0,-10000,0,0,0,0,10000,-10000,-10000,2021-06-09
6519,078815,立積凱基08購01,0,0,0,0,0,0,0,0,0,-10000,0,0,0,0,10000,-10000,-10000,2021-06-09
6520,078880,微星元大06購02,0,0,0,0,0,0,0,0,0,-10000,0,0,0,0,10000,-10000,-10000,2021-06-09
6521,078962,T50反1兆豐0C購01,0,0,0,0,0,0,0,0,0,-10000,0,0,0,0,10000,-10000,-10000,2021-06-09
6522,078966,瑞昱兆豐07購01,0,0,0,0,0,0,0,0,0,-10000,0,0,0,0,10000,-10000,-10000,2021-06-09
6523,078969,禾伸堂兆豐07購01,0,0,0,0,0,0,0,0,0,-10000,0,0,0,10000,20000,-10000,-10000,2021-06-09
6524,076680,景碩凱基06購01,0,0,0,0,0,0,0,0,0,-10000,0,0,0,10000,20000,-10000,-10000,2021-06-09
6525,076931,麗豐元富08購01,0,0,0,0,0,0,0,0,0,-10000,0,0,0,66000,76000,-10000,-10000,2021-06-09
6526,077378,景碩元大06購02,0,0,0,0,0,0,0,0,0,-10000,0,0,0,0,10000,-10000,-10000,2021-06-09
6527,077533,景碩凱基06購02,0,0,0,0,0,0,0,0,0,-10000,0,0,0,0,10000,-10000,-10000,2021-06-09
6528,078160,聯電凱基07購02,0,0,0,0,0,0,0,0,0,-10000,0,0,0,9000,19000,-10000,-10000,2021-06-09
6529,075785,立積凱基07購01,0,0,0,0,0,0,0,0,0,-10000,0,0,0,0,10000,-10000,-10000,2021-06-09
6530,075697,景碩統一07購02,0,0,0,0,0,0,0,0,0,-10000,0,0,0,0,10000,-10000,-10000,2021-06-09
6531,076367,鴻海凱基07購02,0,0,0,0,0,0,0,0,0,-10000,0,0,0,0,10000,-10000,-10000,2021-06-09
6532,074180,大立光元富07購05,0,0,0,0,0,0,0,0,0,-10000,0,0,0,0,10000,-10000,-10000,2021-06-09
6533,073994,精元元富08購03,0,0,0,0,0,0,0,0,0,-10000,0,0,0,0,10000,-10000,-10000,2021-06-09
6534,075243,景碩統一07購01,0,0,0,0,0,0,0,0,0,-10000,0,0,0,0,10000,-10000,-10000,2021-06-09
6535,074773,新光金凱基07購01,0,0,0,0,0,0,0,0,0,-10000,0,0,0,5000,15000,-10000,-10000,2021-06-09
6536,075585,聯發科國票08購03,0,0,0,0,0,0,0,0,0,-10000,0,0,0,18000,28000,-10000,-10000,2021-06-09
6537,073014,台勝科元大07購01,0,0,0,0,0,0,0,0,0,-10000,0,0,0,0,10000,-10000,-10000,2021-06-09
6538,07277P,臺股指元大0C售33,0,0,0,0,0,0,0,0,0,-10000,0,0,0,0,10000,-10000,-10000,2021-06-09
6539,073811,大立光統一06購05,0,0,0,0,0,0,0,0,0,-10000,0,0,0,0,10000,-10000,-10000,2021-06-09
6540,073989,亞德客元富08購01,0,0,0,0,0,0,0,0,0,-10000,0,0,0,0,10000,-10000,-10000,2021-06-09
6541,073493,燿華統一06購01,0,0,0,0,0,0,0,0,0,-10000,0,0,0,0,10000,-10000,-10000,2021-06-09
6542,072180,中鋼中信07購01,0,0,0,0,0,0,0,0,0,-10000,0,0,0,0,10000,-10000,-10000,2021-06-09
6543,07244P,群創群益0C售09,0,0,0,0,0,0,0,0,0,-10000,0,0,0,0,10000,-10000,-10000,2021-06-09
6544,07253P,玉晶光凱基11售02,0,0,0,0,0,0,0,0,0,-10000,0,0,0,0,10000,-10000,-10000,2021-06-09
6545,081327,滬深2X群益08購01,0,0,0,0,0,0,0,0,0,-10000,0,0,0,0,10000,-10000,-10000,2021-06-09
6546,081269,中磊元富08購01,0,0,0,0,0,0,0,0,0,-10000,0,0,0,0,10000,-10000,-10000,2021-06-09
6547,081054,台中銀國票0A購01,0,0,0,0,0,0,0,0,0,-10000,0,0,0,0,10000,-10000,-10000,2021-06-09
6548,081162,台積電國泰09購03,0,0,0,0,0,0,0,0,0,-10000,0,0,0,0,10000,-10000,-10000,2021-06-09
6549,080584,欣興日盛08購01,0,0,0,0,0,0,0,0,0,-10000,0,0,0,2000,12000,-10000,-10000,2021-06-09
6550,080627,旭富國票0A購01,0,0,0,0,0,0,0,0,0,-10000,0,0,0,0,10000,-10000,-10000,2021-06-09
6551,080628,高股息元大06購01,0,0,0,0,0,0,0,0,0,-10000,0,0,0,0,10000,-10000,-10000,2021-06-09
6552,080701,燿華凱基07購01,0,0,0,0,0,0,0,0,0,-10000,0,0,0,0,10000,-10000,-10000,2021-06-09
6553,080755,台化元大06購02,0,0,0,0,0,0,0,0,0,-10000,0,0,0,0,10000,-10000,-10000,2021-06-09
6554,081019,友達統一08購02,0,0,0,0,0,0,0,0,0,-10000,0,0,0,0,10000,-10000,-10000,2021-06-09
6555,080867,創意統一09購01,0,0,0,0,0,0,0,0,0,-10000,0,0,0,0,10000,-10000,-10000,2021-06-09
6556,079440,T50反1元富09購02,0,0,0,0,0,0,0,0,0,-10000,0,0,0,0,10000,-10000,-10000,2021-06-09
6557,079475,微星兆豐06購01,0,0,0,0,0,0,0,0,0,-10000,0,0,0,9000,19000,-10000,-10000,2021-06-09
6558,079120,景碩凱基06購03,0,0,0,0,0,0,0,0,0,-10000,0,0,0,0,10000,-10000,-10000,2021-06-09
6559,079177,裕隆富邦08購01,0,0,0,0,0,0,0,0,0,-10000,0,0,0,0,10000,-10000,-10000,2021-06-09
6560,079191,仁寶兆豐06購01,0,0,0,0,0,0,0,0,0,-10000,0,0,0,10000,20000,-10000,-10000,2021-06-09
6561,079287,友達統一07購01,0,0,0,0,0,0,0,0,0,-10000,0,0,0,0,10000,-10000,-10000,2021-06-09
6562,079379,台積電元大09購03,0,0,0,0,0,0,0,0,0,-10000,0,0,0,0,10000,-10000,-10000,2021-06-09
6563,079360,禾伸堂凱基07購01,0,0,0,0,0,0,0,0,0,-10000,0,0,0,0,10000,-10000,-10000,2021-06-09
6564,080073,台積電元大09購04,0,0,0,0,0,0,0,0,0,-10000,0,0,0,0,10000,-10000,-10000,2021-06-09
6565,079991,台積電元富09購03,0,0,0,0,0,0,0,0,0,-10000,0,0,0,0,10000,-10000,-10000,2021-06-09
6566,079977,景碩群益07購01,0,0,0,0,0,0,0,0,0,-10000,0,0,0,0,10000,-10000,-10000,2021-06-09
6567,080370,中石化永豐06購02,0,0,0,0,0,0,0,0,0,-10000,0,0,0,0,10000,-10000,-10000,2021-06-09
6568,080344,聯電統一08購04,0,0,0,0,0,0,0,0,0,-10000,0,0,0,0,10000,-10000,-10000,2021-06-09
6569,080321,泰山凱基08購01,0,0,0,0,0,0,0,0,0,-10000,0,0,0,0,10000,-10000,-10000,2021-06-09
6570,080467,材料凱基09購01,0,0,0,0,0,0,0,0,0,-10000,0,0,0,0,10000,-10000,-10000,2021-06-09
6571,080395,宏碁元大06購05,0,0,0,0,0,0,0,0,0,-10000,0,0,0,0,10000,-10000,-10000,2021-06-09
6572,082794,大立光元富07購09,0,0,0,0,0,0,0,0,0,-10000,0,0,0,30000,40000,-10000,-10000,2021-06-09
6573,082662,巨大永豐07購01,0,0,0,0,0,0,0,0,0,-10000,0,0,0,0,10000,-10000,-10000,2021-06-09
6574,082509,光磊兆豐07購01,0,0,0,0,0,0,0,0,0,-10000,0,0,0,0,10000,-10000,-10000,2021-06-09
6575,082499,晶技統一08購01,0,0,0,0,0,0,0,0,0,-10000,0,0,0,0,10000,-10000,-10000,2021-06-09
6576,082458,光磊元大07購02,0,0,0,0,0,0,0,0,0,-10000,0,0,0,0,10000,-10000,-10000,2021-06-09
6577,082464,義隆元大07購04,0,0,0,0,0,0,0,0,0,-10000,0,0,0,0,10000,-10000,-10000,2021-06-09
6578,083199,鴻海統一11購01,0,0,0,0,0,0,0,0,0,-10000,0,0,0,0,10000,-10000,-10000,2021-06-09
6579,083261,可成凱基08購01,0,0,0,0,0,0,0,0,0,-10000,0,0,0,0,10000,-10000,-10000,2021-06-09
6580,083233,廣宇中信08購01,0,0,0,0,0,0,0,0,0,-10000,0,0,0,20000,30000,-10000,-10000,2021-06-09
6581,083128,台積電凱基09購04,0,0,0,0,0,0,0,0,0,-10000,0,0,0,0,10000,-10000,-10000,2021-06-09
6582,083143,台郡凱基08購01,0,0,0,0,0,0,0,0,0,-10000,0,0,0,0,10000,-10000,-10000,2021-06-09
6583,083032,鴻海中信0B購01,0,0,0,0,0,0,0,0,0,-10000,0,0,0,0,10000,-10000,-10000,2021-06-09
6584,082091,臺股指元大07購14,0,0,0,0,0,0,0,0,0,-10000,0,0,0,0,10000,-10000,-10000,2021-06-09
6585,082048,華新科凱基08購01,0,0,0,0,0,0,0,0,0,-10000,0,0,0,0,10000,-10000,-10000,2021-06-09
6586,081994,矽格元大07購01,0,0,0,0,0,0,0,0,0,-10000,0,0,0,40000,50000,-10000,-10000,2021-06-09
6587,082407,欣興凱基07購01,0,0,0,0,0,0,0,0,0,-10000,0,0,0,20000,30000,-10000,-10000,2021-06-09
6588,082380,中石化兆豐08購01,0,0,0,0,0,0,0,0,0,-10000,0,0,0,0,10000,-10000,-10000,2021-06-09
6589,082318,台達電統一09購02,0,0,0,0,0,0,0,0,0,-10000,0,0,0,0,10000,-10000,-10000,2021-06-09
6590,081507,界霖凱基08購01,0,0,0,0,0,0,0,0,0,-10000,0,0,0,10000,20000,-10000,-10000,2021-06-09
6591,081718,景碩統一09購01,0,0,0,0,0,0,0,0,0,-10000,0,0,0,0,10000,-10000,-10000,2021-06-09
6592,081904,台達電凱基08購02,0,0,0,0,0,0,0,0,0,-10000,0,0,0,20000,30000,-10000,-10000,2021-06-09
6593,081949,聯發科統一09購05,0,0,0,0,0,0,0,0,0,-10000,0,0,0,80000,90000,-10000,-10000,2021-06-09
6594,081818,仁寶凱基07購01,0,0,0,0,0,0,0,0,0,-10000,0,0,0,0,10000,-10000,-10000,2021-06-09
6595,083391,滬深2X中信09購02,0,0,0,0,0,0,0,0,0,-10000,0,0,0,0,10000,-10000,-10000,2021-06-09
6596,5538,東明-KY,1000,11000,-10000,0,0,0,0,0,0,0,0,0,0,0,0,0,-10000,2021-06-09
6597,2468,華經,2000,12000,-10000,0,0,0,0,0,0,0,0,0,0,0,0,0,-10000,2021-06-09
6598,3040,遠見,9000,19000,-10000,0,0,0,0,0,0,0,0,0,0,0,0,0,-10000,2021-06-09
6599,1439,中和,1000,11000,-10000,0,0,0,0,0,0,0,0,0,0,0,0,0,-10000,2021-06-09
6600,089974,義隆元大0A購02,0,0,0,0,0,0,0,0,0,-10000,0,0,0,30000,40000,-10000,-10000,2021-06-09
6601,089944,界霖永豐0A購01,0,0,0,0,0,0,0,0,0,-10000,0,0,0,0,10000,-10000,-10000,2021-06-09
6602,089961,聯電元大0A購01,0,0,0,0,0,0,0,0,0,-10000,0,0,0,0,10000,-10000,-10000,2021-06-09
6603,089964,鴻海元大0A購04,0,0,0,0,0,0,0,0,0,-10000,0,0,0,0,10000,-10000,-10000,2021-06-09
6604,089900,仲琦凱基11購01,0,0,0,0,0,0,0,0,0,-10000,0,0,0,0,10000,-10000,-10000,2021-06-09
6605,089884,鴻海日盛0B購01,0,0,0,0,0,0,0,0,0,-10000,0,0,0,0,10000,-10000,-10000,2021-06-09
6606,089783,華晶科凱基09購01,0,0,0,0,0,0,0,0,0,-10000,0,0,0,0,10000,-10000,-10000,2021-06-09
6607,089790,昇陽半凱基11購01,0,0,0,0,0,0,0,0,0,-10000,0,0,0,8000,18000,-10000,-10000,2021-06-09
6608,089788,申豐凱基0B購02,0,0,0,0,0,0,0,0,0,-10000,0,0,0,0,10000,-10000,-10000,2021-06-09
6609,089321,精成科國票0A購02,0,0,0,0,0,0,0,0,0,-10000,0,0,0,0,10000,-10000,-10000,2021-06-09
6610,089299,鴻海國票0A購07,0,0,0,0,0,0,0,0,0,-10000,0,0,0,0,10000,-10000,-10000,2021-06-09
6611,089346,台積電元大0C購11,0,0,0,0,0,0,0,0,0,-10000,0,0,0,0,10000,-10000,-10000,2021-06-09
6612,089327,緯創富邦09購02,0,0,0,0,0,0,0,0,0,-10000,0,0,0,0,10000,-10000,-10000,2021-06-09
6613,089080,同欣電凱基0A購01,0,0,0,0,0,0,0,0,0,-10000,0,0,0,8000,18000,-10000,-10000,2021-06-09
6614,089262,精成科統一0B購02,0,0,0,0,0,0,0,0,0,-10000,0,0,0,0,10000,-10000,-10000,2021-06-09
6615,089210,旺宏群益0B購06,0,0,0,0,0,0,0,0,0,-10000,0,0,0,0,10000,-10000,-10000,2021-06-09
6616,089203,瑞儀凱基0A購01,0,0,0,0,0,0,0,0,0,-10000,0,0,0,0,10000,-10000,-10000,2021-06-09
6617,089641,景碩凱基0B購01,0,0,0,0,0,0,0,0,0,-10000,0,0,0,9000,19000,-10000,-10000,2021-06-09
6618,089511,漢唐元大09購02,0,0,0,0,0,0,0,0,0,-10000,0,0,0,0,10000,-10000,-10000,2021-06-09
6619,0055,元大MSCI金融,1000,1000,0,0,0,0,0,0,0,-10090,0,0,0,8000,18090,-10090,-10090,2021-06-09
6620,00713,元大台灣高息低波,0,1000,-1000,0,0,0,0,0,0,-9784,0,0,0,1000,10784,-9784,-10784,2021-06-09
6621,088998,台達電元大09購01,0,0,0,0,0,0,0,0,0,-11000,0,0,0,0,11000,-11000,-11000,2021-06-09
6622,088425,中興電日盛09購01,0,0,0,0,0,0,0,0,0,-11000,0,0,0,0,11000,-11000,-11000,2021-06-09
6623,088572,大立光凱基0A購04,0,0,0,0,0,0,0,0,0,-11000,0,0,0,0,11000,-11000,-11000,2021-06-09
6624,088286,矽創群益0A購02,0,0,0,0,0,0,0,0,0,-11000,0,0,0,36000,47000,-11000,-11000,2021-06-09
6625,088265,達欣工永豐09購01,0,0,0,0,0,0,0,0,0,-11000,0,0,0,0,11000,-11000,-11000,2021-06-09
6626,087907,聯電群益09購03,0,0,0,0,0,0,0,0,0,-11000,0,0,0,61000,72000,-11000,-11000,2021-06-09
6627,086935,友達元大0C購05,0,0,0,0,0,0,0,0,0,-11000,0,0,0,236000,247000,-11000,-11000,2021-06-09
6628,086563,智易元大09購01,0,0,0,0,0,0,0,0,0,-11000,0,0,0,10000,21000,-11000,-11000,2021-06-09
6629,083777,全新永豐07購01,0,0,0,0,0,0,0,0,0,-11000,0,0,0,11000,22000,-11000,-11000,2021-06-09
6630,084502,T50正2元大0B購01,0,0,0,0,0,0,0,0,0,-11000,0,0,0,0,11000,-11000,-11000,2021-06-09
6631,084859,台積電元大09購09,0,0,0,0,0,0,0,0,0,-11000,0,0,0,132000,143000,-11000,-11000,2021-06-09
6632,085634,大立光凱基08購09,0,0,0,0,0,0,0,0,0,-11000,0,0,0,0,11000,-11000,-11000,2021-06-09
6633,00680L,元大美債20正2,0,9000,-9000,0,0,0,0,0,0,-2000,0,0,0,2000,4000,-2000,-11000,2021-06-09
6634,00681R,元大美債20反1,0,0,0,0,0,0,0,0,0,-11000,0,0,0,0,11000,-11000,-11000,2021-06-09
6635,030038,長興元大11購01,0,0,0,0,0,0,0,0,0,-11000,0,0,0,1000,12000,-11000,-11000,2021-06-09
6636,030314,聯電麥證0C購04,0,0,0,0,11000,-11000,0,0,0,-11000,0,0,0,0,11000,-11000,-11000,2021-06-09
6637,030160,宏達電中信0B購01,0,0,0,0,0,0,0,0,0,-11000,0,0,0,0,11000,-11000,-11000,2021-06-09
6638,031346,界霖元大0A購01,0,0,0,0,0,0,0,0,0,-11000,0,0,0,9000,20000,-11000,-11000,2021-06-09
6639,030944,復盛群益0A購01,0,0,0,0,0,0,0,0,0,-11000,0,0,0,0,11000,-11000,-11000,2021-06-09
6640,033211,長榮群益11購05,0,0,0,0,0,0,0,0,0,-11000,0,0,0,123000,134000,-11000,-11000,2021-06-09
6641,033475,大立光凱基0C購02,0,0,0,0,0,0,0,0,0,-11000,0,0,0,0,11000,-11000,-11000,2021-06-09
6642,033246,義隆元大0B購03,0,0,0,0,0,0,0,0,0,-11000,0,0,0,84000,95000,-11000,-11000,2021-06-09
6643,032007,臺股指群益0A購09,0,0,0,0,0,0,0,0,0,-11000,0,0,0,0,11000,-11000,-11000,2021-06-09
6644,032531,友達凱基0A購08,0,0,0,0,0,0,0,0,0,-11000,0,0,0,0,11000,-11000,-11000,2021-06-09
6645,034679,愛普凱基11購01,0,0,0,0,0,0,0,0,0,-11000,0,0,0,0,11000,-11000,-11000,2021-06-09
6646,034571,友達第一15購01,0,0,0,0,0,0,0,0,0,-11000,0,0,0,60000,71000,-11000,-11000,2021-06-09
6647,034476,台玻元大0B購07,0,0,0,0,0,0,0,0,0,-11000,0,0,0,34000,45000,-11000,-11000,2021-06-09
6648,034212,台玻元富0B購01,0,0,0,0,0,0,0,0,0,-11000,0,0,0,88000,99000,-11000,-11000,2021-06-09
6649,034247,新光鋼統一12購02,0,0,0,0,0,0,0,0,0,-11000,0,0,0,0,11000,-11000,-11000,2021-06-09
6650,034132,中石化第一15購01,0,0,0,0,0,0,0,0,0,-11000,0,0,0,0,11000,-11000,-11000,2021-06-09
6651,06301P,臺股指凱基08售12,0,0,0,0,0,0,0,0,0,-11000,0,0,0,0,11000,-11000,-11000,2021-06-09
6652,06146P,聯發科兆豐08售03,0,0,0,0,0,0,0,0,0,-11000,0,0,0,0,11000,-11000,-11000,2021-06-09
6653,035621,光罩國票0C購03,0,0,0,0,0,0,0,0,0,-11000,0,0,0,51000,62000,-11000,-11000,2021-06-09
6654,036112,同欣電國泰12購01,0,0,0,0,0,0,0,0,0,-11000,0,0,0,0,11000,-11000,-11000,2021-06-09
6655,036118,智邦群益0C購01,0,0,0,0,0,0,0,0,0,-11000,0,0,0,36000,47000,-11000,-11000,2021-06-09
6656,033960,聯詠富邦11購01,0,0,0,0,0,0,0,0,0,-11000,0,0,0,0,11000,-11000,-11000,2021-06-09
6657,035829,威致元大0B購01,0,0,0,0,0,0,0,0,0,-11000,0,0,0,36000,47000,-11000,-11000,2021-06-09
6658,036011,友達凱基0C購05,0,0,0,0,0,0,0,0,0,-11000,0,0,0,0,11000,-11000,-11000,2021-06-09
6659,036555,可成元大11購01,0,0,0,0,0,0,0,0,0,-11000,0,0,0,0,11000,-11000,-11000,2021-06-09
6660,035344,富邦金元富12購09,0,0,0,0,0,0,0,0,0,-11000,0,0,0,0,11000,-11000,-11000,2021-06-09
6661,035165,友達國票0B購05,0,0,0,0,0,0,0,0,0,-11000,0,0,0,0,11000,-11000,-11000,2021-06-09
6662,083382,臺股指國票0A購06,0,0,0,0,0,0,0,0,0,-11000,0,0,0,0,11000,-11000,-11000,2021-06-09
6663,083030,鴻海中信09購05,0,0,0,0,0,0,0,0,0,-11000,0,0,0,0,11000,-11000,-11000,2021-06-09
6664,083246,松翰群益08購02,0,0,0,0,0,0,0,0,0,-11000,0,0,0,3000,14000,-11000,-11000,2021-06-09
6665,082679,聯發科麥證0A購02,0,0,0,0,11000,-11000,0,0,0,-11000,0,0,0,0,11000,-11000,-11000,2021-06-09
6666,080684,台積電富邦09購02,0,0,0,0,0,0,0,0,0,-11000,0,0,0,17000,28000,-11000,-11000,2021-06-09
6667,081149,神基凱基0A購01,0,0,0,0,0,0,0,0,0,-11000,0,0,0,0,11000,-11000,-11000,2021-06-09
6668,081102,永光群益09購01,0,0,0,0,0,0,0,0,0,-11000,0,0,0,0,11000,-11000,-11000,2021-06-09
6669,07254P,中鋼元大0B售15,0,0,0,0,0,0,0,0,0,-11000,0,0,0,0,11000,-11000,-11000,2021-06-09
6670,07272P,中鋼元富0C售01,0,0,0,0,0,0,0,0,0,-11000,0,0,0,25000,36000,-11000,-11000,2021-06-09
6671,075533,台積電國票09購03,0,0,0,0,0,0,0,0,0,-11000,0,0,0,0,11000,-11000,-11000,2021-06-09
6672,078610,台積電第一0A購01,0,0,0,0,0,0,0,0,0,-11000,0,0,0,0,11000,-11000,-11000,2021-06-09
6673,06573P,台灣50元大0C售04,0,0,0,0,0,0,0,0,0,-11000,0,0,0,27000,38000,-11000,-11000,2021-06-09
6674,06653P,鴻海元大0C售07,0,0,0,0,0,0,0,0,0,-11000,0,0,0,10000,21000,-11000,-11000,2021-06-09
6675,089108,台積電國票0A購06,0,0,0,0,0,0,0,0,0,-11000,0,0,0,0,11000,-11000,-11000,2021-06-09
6676,2904,匯僑,10000,21000,-11000,0,0,0,0,0,0,0,0,0,0,0,0,0,-11000,2021-06-09
6677,3266,昇陽,0,11000,-11000,0,0,0,0,0,0,0,0,0,0,0,0,0,-11000,2021-06-09
6678,3669,圓展,43000,68000,-25000,0,0,0,0,0,0,14000,0,0,0,15000,1000,14000,-11000,2021-06-09
6679,4540,全球傳動,15000,26000,-11000,0,0,0,0,0,0,0,0,0,0,0,0,0,-11000,2021-06-09
6680,4576,大銀微系統,21000,38000,-17000,0,0,0,15000,0,15000,-9000,0,0,0,1000,10000,-9000,-11000,2021-06-09
6681,1726,永記,0,11000,-11000,0,0,0,0,0,0,0,0,0,0,0,0,0,-11000,2021-06-09
6682,6756,威鋒電子,14000,20000,-6000,0,0,0,0,0,0,-5000,0,0,0,0,5000,-5000,-11000,2021-06-09
6683,8466,美吉吉-KY,2000,13000,-11000,0,0,0,0,0,0,0,0,0,0,0,0,0,-11000,2021-06-09
6684,085111,鴻海元大08購14,0,0,0,0,0,0,0,0,0,-12000,0,0,0,0,12000,-12000,-12000,2021-06-09
6685,086173,群創元大0C購03,0,0,0,0,0,0,0,0,0,-12000,0,0,0,0,12000,-12000,-12000,2021-06-09
6686,086357,日月光元大09購02,0,0,0,0,0,0,0,0,0,-12000,0,0,0,0,12000,-12000,-12000,2021-06-09
6687,084935,緯創元大08購03,0,0,0,0,0,0,0,0,0,-12000,0,0,0,0,12000,-12000,-12000,2021-06-09
6688,084990,聯發科群益09購01,0,0,0,0,0,0,0,0,0,-12000,0,0,0,6000,18000,-12000,-12000,2021-06-09
6689,083721,台積電元大07購37,0,0,0,0,0,0,0,0,0,-12000,0,0,0,8000,20000,-12000,-12000,2021-06-09
6690,083962,大立光凱基08購07,0,0,0,0,0,0,0,0,0,-12000,0,0,0,8000,20000,-12000,-12000,2021-06-09
6691,087047,長榮航凱基0B購01,0,0,0,0,0,0,0,0,0,-12000,0,0,0,0,12000,-12000,-12000,2021-06-09
6692,086725,臺股指元大0A購16,0,0,0,0,0,0,0,0,0,-12000,0,0,0,0,12000,-12000,-12000,2021-06-09
6693,087499,聯電兆豐0A購01,0,0,0,0,0,0,0,0,0,-12000,0,0,0,0,12000,-12000,-12000,2021-06-09
6694,087411,滬深2X統一0B購03,0,0,0,0,0,0,0,0,0,-12000,0,0,0,0,12000,-12000,-12000,2021-06-09
6695,087426,台達化元富09購01,0,0,0,0,0,0,0,0,0,-12000,0,0,0,0,12000,-12000,-12000,2021-06-09
6696,087285,華碩元大0C購01,0,0,0,0,0,0,0,0,0,-12000,0,0,0,0,12000,-12000,-12000,2021-06-09
6697,031812,裕隆元大0B購01,0,0,0,0,0,0,0,0,0,-12000,0,0,0,0,12000,-12000,-12000,2021-06-09
6698,032920,聯電國票0B購04,0,0,0,0,0,0,0,0,0,-12000,0,0,0,1000,13000,-12000,-12000,2021-06-09
6699,033515,中鋼台新0B購01,0,0,0,0,0,0,0,0,0,-12000,0,0,0,50000,62000,-12000,-12000,2021-06-09
6700,033526,宏達電國票0B購01,0,0,0,0,0,0,0,0,0,-12000,0,0,0,3000,15000,-12000,-12000,2021-06-09
6701,031152,瀚宇博兆豐0B購01,0,0,0,0,0,0,0,0,0,-12000,0,0,0,0,12000,-12000,-12000,2021-06-09
6702,031328,友達元大0A購07,0,0,0,0,0,0,0,0,0,-12000,0,0,0,0,12000,-12000,-12000,2021-06-09
6703,030136,威健凱基11購01,0,0,0,0,0,0,0,0,0,-12000,0,0,0,22000,34000,-12000,-12000,2021-06-09
6704,031252,大立光群益12購01,0,0,0,0,0,0,0,0,0,-12000,0,0,0,0,12000,-12000,-12000,2021-06-09
6705,030360,健和興群益0A購01,0,0,0,0,0,0,0,0,0,-12000,0,0,0,0,12000,-12000,-12000,2021-06-09
6706,035202,貿聯元富0B購02,0,0,0,0,0,0,0,0,0,-12000,0,0,0,114000,126000,-12000,-12000,2021-06-09
6707,035192,南亞科元富0B購02,0,0,0,0,0,0,0,0,0,-12000,0,0,0,0,12000,-12000,-12000,2021-06-09
6708,035167,奇力新國票0B購01,0,0,0,0,0,0,0,0,0,-12000,0,0,0,12000,24000,-12000,-12000,2021-06-09
6709,035263,愛普凱基11購02,0,0,0,0,0,0,0,0,0,-12000,0,0,0,0,12000,-12000,-12000,2021-06-09
6710,03733P,大毅元富08售01,0,0,0,0,0,0,0,0,0,-12000,0,0,0,0,12000,-12000,-12000,2021-06-09
6711,035942,群創凱基13購03,0,0,0,0,0,0,0,0,0,-12000,0,0,0,0,12000,-12000,-12000,2021-06-09
6712,035887,台驊控國票11購01,0,0,0,0,0,0,0,0,0,-12000,0,0,0,5000,17000,-12000,-12000,2021-06-09
6713,035908,GIS群益0C購01,0,0,0,0,0,0,0,0,0,-12000,0,0,0,0,12000,-12000,-12000,2021-06-09
6714,034021,華夏中信0B購01,0,0,0,0,0,0,0,0,0,-12000,0,0,0,38000,50000,-12000,-12000,2021-06-09
6715,034835,榮成康和0C購01,0,0,0,0,0,0,0,0,0,-12000,0,0,0,59000,71000,-12000,-12000,2021-06-09
6716,035542,聯電統一0B購12,0,0,0,0,0,0,0,0,0,-12000,0,0,0,0,12000,-12000,-12000,2021-06-09
6717,033736,臺股指國票0B購09,0,0,0,0,0,0,0,0,0,-12000,0,0,0,0,12000,-12000,-12000,2021-06-09
6718,034147,友達凱基0C購04,0,0,0,0,0,0,0,0,0,-12000,0,0,0,0,12000,-12000,-12000,2021-06-09
6719,033841,聯詠兆豐0C購02,0,0,0,0,0,0,0,0,0,-12000,0,0,0,0,12000,-12000,-12000,2021-06-09
6720,034589,聚陽統一0C購01,0,0,0,0,0,0,0,0,0,-12000,0,0,0,18000,30000,-12000,-12000,2021-06-09
6721,06815P,友達兆豐0B售03,0,0,0,0,0,0,0,0,0,-12000,0,0,0,0,12000,-12000,-12000,2021-06-09
6722,07050P,臺股指富邦0C售02,0,0,0,0,0,0,0,0,0,-12000,0,0,0,28000,40000,-12000,-12000,2021-06-09
6723,07152P,友達元大0B售14,0,0,0,0,0,0,0,0,0,-12000,0,0,0,0,12000,-12000,-12000,2021-06-09
6724,06938P,臺股指凱基0A售21,0,0,0,0,0,0,0,0,0,-12000,0,0,0,0,12000,-12000,-12000,2021-06-09
6725,078300,聯電兆豐07購03,0,0,0,0,0,0,0,0,0,-12000,0,0,0,8000,20000,-12000,-12000,2021-06-09
6726,07259P,中鋼群益11售02,0,0,0,0,0,0,0,0,0,-12000,0,0,0,0,12000,-12000,-12000,2021-06-09
6727,07241P,群創元大0B售18,0,0,0,0,0,0,0,0,0,-12000,0,0,0,7000,19000,-12000,-12000,2021-06-09
6728,07211P,國巨元大0B售16,0,0,0,0,0,0,0,0,0,-12000,0,0,0,0,12000,-12000,-12000,2021-06-09
6729,07191P,長榮國票12售05,0,0,0,0,0,0,0,0,0,-12000,0,0,0,96000,108000,-12000,-12000,2021-06-09
6730,072833,中橡元大07購01,0,0,0,0,0,0,0,0,0,-12000,0,0,0,0,12000,-12000,-12000,2021-06-09
6731,081101,永冠群益09購01,0,0,0,0,0,0,0,0,0,-12000,0,0,0,0,12000,-12000,-12000,2021-06-09
6732,081130,愛普康和07購01,0,0,0,0,0,0,0,0,0,-12000,0,0,0,0,12000,-12000,-12000,2021-06-09
6733,080694,恆大凱基07購01,0,0,0,0,0,0,0,0,0,-12000,0,0,0,36000,48000,-12000,-12000,2021-06-09
6734,082609,日月光元大09購01,0,0,0,0,0,0,0,0,0,-12000,0,0,0,0,12000,-12000,-12000,2021-06-09
6735,081733,儒鴻元大07購03,0,0,0,0,0,0,0,0,0,-12000,0,0,0,0,12000,-12000,-12000,2021-06-09
6736,6504,南六,10000,22000,-12000,0,0,0,0,0,0,0,0,0,0,0,0,0,-12000,2021-06-09
6737,6142,友勁,69000,81000,-12000,0,0,0,0,0,0,0,0,0,0,0,0,0,-12000,2021-06-09
6738,1713,國化,14000,26000,-12000,0,0,0,0,0,0,0,0,0,0,0,0,0,-12000,2021-06-09
6739,1817,凱撒衛,12000,24000,-12000,0,0,0,0,0,0,0,0,0,0,0,0,0,-12000,2021-06-09
6740,2530,華建,35000,47000,-12000,0,0,0,0,0,0,0,0,0,0,0,0,0,-12000,2021-06-09
6741,5234,達興材料,9000,21000,-12000,0,0,0,0,0,0,0,0,0,0,0,0,0,-12000,2021-06-09
6742,2816,旺旺保,4000,16000,-12000,0,0,0,0,0,0,0,0,0,0,0,0,0,-12000,2021-06-09
6743,089355,聯發科元大09購13,0,0,0,0,0,0,0,0,0,-12000,0,0,0,150000,162000,-12000,-12000,2021-06-09
6744,4906,正文,350000,368000,-18000,0,0,0,0,0,0,5298,0,0,0,19493,14195,5298,-12702,2021-06-09
6745,087186,聯發科群益09購03,0,0,0,0,0,0,0,0,0,-13000,0,0,0,10000,23000,-13000,-13000,2021-06-09
6746,087417,晶豪科統一0B購02,0,0,0,0,0,0,0,0,0,-13000,0,0,0,0,13000,-13000,-13000,2021-06-09
6747,087051,日電貿凱基09購01,0,0,0,0,0,0,0,0,0,-13000,0,0,0,0,13000,-13000,-13000,2021-06-09
6748,087864,臺股指富邦09購03,0,0,0,0,0,0,0,0,0,-13000,0,0,0,0,13000,-13000,-13000,2021-06-09
6749,084905,聯電永豐08購05,0,0,0,0,0,0,0,0,0,-13000,0,0,0,7000,20000,-13000,-13000,2021-06-09
6750,084397,華城國票08購01,0,0,0,0,0,0,0,0,0,-13000,0,0,0,0,13000,-13000,-13000,2021-06-09
6751,085107,聯電元大08購07,0,0,0,0,0,0,0,0,0,-13000,0,0,0,173000,186000,-13000,-13000,2021-06-09
6752,085074,友達永豐08購04,0,0,0,0,0,0,0,0,0,-13000,0,0,0,0,13000,-13000,-13000,2021-06-09
6753,085720,台塑中信0B購01,0,0,0,0,0,0,0,0,0,-13000,0,0,0,0,13000,-13000,-13000,2021-06-09
6754,03012X,元展12,0,0,0,0,0,0,0,0,0,-13000,0,0,0,0,13000,-13000,-13000,2021-06-09
6755,031327,旺宏元大0A購03,0,0,0,0,0,0,0,0,0,-13000,0,0,0,3000,16000,-13000,-13000,2021-06-09
6756,030803,牧德凱基0A購01,0,0,0,0,0,0,0,0,0,-13000,0,0,0,0,13000,-13000,-13000,2021-06-09
6757,030793,瑞昱凱基0A購01,0,0,0,0,0,0,0,0,0,-13000,0,0,0,4000,17000,-13000,-13000,2021-06-09
6758,030625,立積元大0A購05,0,0,0,0,0,0,0,0,0,-13000,0,0,0,12000,25000,-13000,-13000,2021-06-09
6759,031125,華新科統一11購01,0,0,0,0,0,0,0,0,0,-13000,0,0,0,100000,113000,-13000,-13000,2021-06-09
6760,031081,惠特元大0B購02,0,0,0,0,0,0,0,0,0,-13000,0,0,0,0,13000,-13000,-13000,2021-06-09
6761,033579,和桐凱基11購01,0,0,0,0,0,0,0,0,0,-13000,0,0,0,0,13000,-13000,-13000,2021-06-09
6762,032878,可成凱基0A購02,0,0,0,0,0,0,0,0,0,-13000,0,0,0,0,13000,-13000,-13000,2021-06-09
6763,036382,台表科國票12購01,0,0,0,0,0,0,0,0,0,-13000,0,0,0,36000,49000,-13000,-13000,2021-06-09
6764,034588,新纖統一0C購02,0,0,0,0,0,0,0,0,0,-13000,0,0,0,84000,97000,-13000,-13000,2021-06-09
6765,034118,祥碩群益0B購02,0,0,0,0,0,0,0,0,0,-13000,0,0,0,2000,15000,-13000,-13000,2021-06-09
6766,035637,南亞科富邦13購01,0,0,0,0,0,0,0,0,0,-13000,0,0,0,0,13000,-13000,-13000,2021-06-09
6767,036423,威致凱基13購01,0,0,0,0,0,0,0,0,0,-13000,0,0,0,10000,23000,-13000,-13000,2021-06-09
6768,035089,新光鋼凱基11購01,0,0,0,0,0,0,0,0,0,-13000,0,0,0,0,13000,-13000,-13000,2021-06-09
6769,082732,微星群益07購02,0,0,0,0,0,0,0,0,0,-13000,0,0,0,0,13000,-13000,-13000,2021-06-09
6770,083003,聯電凱基0A購03,0,0,0,0,0,0,0,0,0,-13000,0,0,0,0,13000,-13000,-13000,2021-06-09
6771,076586,台積電中信09購02,0,0,0,0,0,0,0,0,0,-13000,0,0,0,0,13000,-13000,-13000,2021-06-09
6772,077224,聯發科凱基09購01,0,0,0,0,0,0,0,0,0,-13000,0,0,0,0,13000,-13000,-13000,2021-06-09
6773,06600P,滬深2X元富09售10,0,0,0,0,0,0,0,0,0,-13000,0,0,0,64000,77000,-13000,-13000,2021-06-09
6774,06541P,臺股指凱基09售27,0,0,0,0,0,0,0,0,0,-13000,0,0,0,27000,40000,-13000,-13000,2021-06-09
6775,1227,佳格,452000,467000,-15000,0,0,0,0,0,0,2000,0,0,0,2000,0,2000,-13000,2021-06-09
6776,6201,亞弘電,3000,16000,-13000,0,0,0,0,0,0,0,0,0,0,0,0,0,-13000,2021-06-09
6777,6449,鈺邦,17000,30000,-13000,0,0,0,0,0,0,0,0,0,0,0,0,0,-13000,2021-06-09
6778,087699,台表科元大0B購01,0,0,0,0,0,0,0,0,0,-14000,0,0,0,1000,15000,-14000,-14000,2021-06-09
6779,086926,為升元大09購01,0,0,0,0,0,0,0,0,0,-14000,0,0,0,0,14000,-14000,-14000,2021-06-09
6780,086485,欣興統一0B購02,0,0,0,0,0,0,0,0,0,-14000,0,0,0,36000,50000,-14000,-14000,2021-06-09
6781,031679,彩晶元大0B購04,0,0,0,0,0,0,0,0,0,-14000,0,0,0,2000,16000,-14000,-14000,2021-06-09
6782,032621,臺股指元大0C購05,0,0,0,0,0,0,0,0,0,-14000,0,0,0,0,14000,-14000,-14000,2021-06-09
6783,036252,京鼎凱基0C購01,0,0,0,0,0,0,0,0,0,-14000,0,0,0,0,14000,-14000,-14000,2021-06-09
6784,05644P,中工國票08售02,0,0,0,0,0,0,0,0,0,-14000,0,0,0,0,14000,-14000,-14000,2021-06-09
6785,036198,晶技統一0C購02,0,0,0,0,0,0,0,0,0,-14000,0,0,0,0,14000,-14000,-14000,2021-06-09
6786,030856,中鴻永豐0A購02,0,4000,-4000,0,0,0,0,0,0,-10000,0,0,0,0,10000,-10000,-14000,2021-06-09
6787,030963,春源元大0A購01,0,0,0,0,0,0,0,0,0,-14000,0,0,0,6000,20000,-14000,-14000,2021-06-09
6788,031298,中興電麥證0B購01,0,0,0,0,14000,-14000,0,0,0,-14000,0,0,0,0,14000,-14000,-14000,2021-06-09
6789,031443,矽統麥證0B購01,0,0,0,12000,26000,-14000,0,0,0,-14000,0,0,0,12000,26000,-14000,-14000,2021-06-09
6790,036102,惠特元大0C購02,0,0,0,0,0,0,0,0,0,-14000,0,0,0,53000,67000,-14000,-14000,2021-06-09
6791,033798,同欣電元大0B購02,0,0,0,0,0,0,0,0,0,-14000,0,0,0,0,14000,-14000,-14000,2021-06-09
6792,034774,聯電富邦12購01,0,0,0,0,0,0,0,0,0,-14000,0,0,0,220000,234000,-14000,-14000,2021-06-09
6793,035547,華邦電統一0B購06,0,0,0,0,0,0,0,0,0,-14000,0,0,0,16000,30000,-14000,-14000,2021-06-09
6794,05911P,和碩元富08售01,0,0,0,0,0,0,0,0,0,-14000,0,0,0,10000,24000,-14000,-14000,2021-06-09
6795,05920P,國巨凱基08售06,0,0,0,0,0,0,0,0,0,-14000,0,0,0,0,14000,-14000,-14000,2021-06-09
6796,034962,恆大元大11購01,0,0,0,0,0,0,0,0,0,-14000,0,0,0,0,14000,-14000,-14000,2021-06-09
6797,06646P,長華元大09售03,0,0,0,0,0,0,0,0,0,-14000,0,0,0,0,14000,-14000,-14000,2021-06-09
6798,07069P,中鋼國泰11售01,0,0,0,0,0,0,0,0,0,-14000,0,0,0,0,14000,-14000,-14000,2021-06-09
6799,081796,中興電凱基08購02,0,0,0,0,0,0,0,0,0,-14000,0,0,0,20000,34000,-14000,-14000,2021-06-09
6800,082045,聯發科凱基08購07,0,0,0,0,0,0,0,0,0,-14000,0,0,0,0,14000,-14000,-14000,2021-06-09
6801,1446,宏和,15000,29000,-14000,0,0,0,0,0,0,0,0,0,0,0,0,0,-14000,2021-06-09
6802,089914,界霖凱基11購02,0,0,0,0,0,0,0,0,0,-14000,0,0,0,8000,22000,-14000,-14000,2021-06-09
6803,089204,南電凱基12購01,1000,0,1000,0,0,0,0,0,0,-15000,0,0,0,217000,232000,-15000,-14000,2021-06-09
6804,089538,南電元大09購09,0,0,0,0,0,0,0,0,0,-14000,0,0,0,5000,19000,-14000,-14000,2021-06-09
6805,089571,美利達中信09購01,0,0,0,0,0,0,0,0,0,-14000,0,0,0,94000,108000,-14000,-14000,2021-06-09
6806,3338,泰碩,87000,101000,-14000,0,0,0,0,0,0,0,0,0,0,0,0,0,-14000,2021-06-09
6807,2702,華園,6000,20000,-14000,0,0,0,0,0,0,0,0,0,0,0,0,0,-14000,2021-06-09
6808,2493,揚博,6000,20000,-14000,0,0,0,0,0,0,0,0,0,0,0,0,0,-14000,2021-06-09
6809,2483,百容,1000,15000,-14000,0,0,0,0,0,0,0,0,0,0,0,0,0,-14000,2021-06-09
6810,1723,中碳,18000,30000,-12000,0,0,0,0,0,0,-2000,0,2000,-2000,0,0,0,-14000,2021-06-09
6811,2359,所羅門,4000,18000,-14000,0,0,0,0,0,0,0,0,0,0,0,0,0,-14000,2021-06-09
6812,00731,FH富時高息低波,0,0,0,0,0,0,0,0,0,-14667,0,0,0,250333,265000,-14667,-14667,2021-06-09
6813,086624,中纖凱基09購01,0,0,0,0,0,0,0,0,0,-15000,0,0,0,0,15000,-15000,-15000,2021-06-09
6814,087640,GIS凱基0B購01,0,0,0,0,0,0,0,0,0,-15000,0,0,0,0,15000,-15000,-15000,2021-06-09
6815,087707,台達電統一0B購01,0,0,0,0,0,0,0,0,0,-15000,0,0,0,5000,20000,-15000,-15000,2021-06-09
6816,087708,國巨統一09購15,0,0,0,0,0,0,0,0,0,-15000,0,0,0,30000,45000,-15000,-15000,2021-06-09
6817,087897,美利達元大09購01,0,0,0,0,0,0,0,0,0,-15000,0,0,0,5000,20000,-15000,-15000,2021-06-09
6818,087925,聯電統一0B購06,0,0,0,0,0,0,0,0,0,-15000,0,0,0,1000,16000,-15000,-15000,2021-06-09
6819,087987,元石油群益09購03,0,0,0,0,0,0,0,0,0,-15000,0,0,0,0,15000,-15000,-15000,2021-06-09
6820,088984,立積元富09購01,0,0,0,0,0,0,0,0,0,-15000,0,0,0,0,15000,-15000,-15000,2021-06-09
6821,085449,三陽元富09購01,0,0,0,0,0,0,0,0,0,-15000,0,0,0,50000,65000,-15000,-15000,2021-06-09
6822,085469,台積電麥證0C購02,0,0,0,5000,20000,-15000,0,0,0,-15000,0,0,0,5000,20000,-15000,-15000,2021-06-09
6823,086127,南亞科群益08購06,0,0,0,0,0,0,0,0,0,-15000,0,0,0,0,15000,-15000,-15000,2021-06-09
6824,086268,群創永豐09購01,0,0,0,0,0,0,0,0,0,-15000,0,0,0,0,15000,-15000,-15000,2021-06-09
6825,086068,景碩統一09購03,0,0,0,0,0,0,0,0,0,-15000,0,0,0,5000,20000,-15000,-15000,2021-06-09
6826,084494,晶技凱基08購01,0,0,0,0,0,0,0,0,0,-15000,0,0,0,0,15000,-15000,-15000,2021-06-09
6827,084635,欣興凱基08購08,0,0,0,0,0,0,0,0,0,-15000,0,0,0,0,15000,-15000,-15000,2021-06-09
6828,084844,大立光元富0C購01,0,0,0,0,0,0,0,0,0,-15000,0,0,0,0,15000,-15000,-15000,2021-06-09
6829,083821,聯電凱基0C購01,0,0,0,0,0,0,0,0,0,-15000,0,0,0,0,15000,-15000,-15000,2021-06-09
6830,083811,南亞科台新07購01,0,0,0,0,0,0,0,0,0,-15000,0,0,0,0,15000,-15000,-15000,2021-06-09
6831,084112,力成中信07購02,0,0,0,0,0,0,0,0,0,-15000,0,0,0,0,15000,-15000,-15000,2021-06-09
6832,083670,聯電統一09購06,0,0,0,0,0,0,0,0,0,-15000,0,0,0,0,15000,-15000,-15000,2021-06-09
6833,00714,群益道瓊美國地產,0,0,0,0,0,0,0,0,0,-15000,0,0,0,1200000,1215000,-15000,-15000,2021-06-09
6834,030005,新唐中信0A購01,0,0,0,0,0,0,0,0,0,-15000,0,0,0,0,15000,-15000,-15000,2021-06-09
6835,00661,元大日經225,0,0,0,0,0,0,0,0,0,-15000,0,0,0,0,15000,-15000,-15000,2021-06-09
6836,00647L,元大S&P500正2,0,0,0,0,0,0,0,0,0,-15000,0,0,0,52000,67000,-15000,-15000,2021-06-09
6837,031259,康普群益0C購01,0,0,0,0,0,0,0,0,0,-15000,0,0,0,5000,20000,-15000,-15000,2021-06-09
6838,031510,聯發科元大0A購12,0,0,0,0,0,0,0,0,0,-15000,0,0,0,0,15000,-15000,-15000,2021-06-09
6839,031506,宏碁元大12購02,0,0,0,0,0,0,0,0,0,-15000,0,0,0,7000,22000,-15000,-15000,2021-06-09
6840,030138,景碩凱基0A購01,0,0,0,0,0,0,0,0,0,-15000,0,0,0,0,15000,-15000,-15000,2021-06-09
6841,030544,大立光凱基0A購07,0,0,0,0,0,0,0,0,0,-15000,0,0,0,11000,26000,-15000,-15000,2021-06-09
6842,030977,聯發科元大0A購08,0,0,0,0,0,0,0,0,0,-15000,0,0,0,0,15000,-15000,-15000,2021-06-09
6843,030658,強茂永豐0A購01,0,0,0,0,0,0,0,0,0,-15000,0,0,0,124000,139000,-15000,-15000,2021-06-09
6844,030728,聯電元大0A購05,0,0,0,0,0,0,0,0,0,-15000,0,0,0,0,15000,-15000,-15000,2021-06-09
6845,030738,全新元大0A購01,0,0,0,0,0,0,0,0,0,-15000,0,0,0,15000,30000,-15000,-15000,2021-06-09
6846,032674,中石化中信0A購04,0,0,0,0,0,0,0,0,0,-15000,0,0,0,0,15000,-15000,-15000,2021-06-09
6847,032760,臺指反元大11購05,0,0,0,0,0,0,0,0,0,-15000,0,0,0,0,15000,-15000,-15000,2021-06-09
6848,036279,威致元大0C購01,0,0,0,0,0,0,0,0,0,-15000,0,0,0,0,15000,-15000,-15000,2021-06-09
6849,036321,京鼎統一11購01,0,0,0,0,0,0,0,0,0,-15000,0,0,0,0,15000,-15000,-15000,2021-06-09
6850,031682,中石化中信0C購01,0,0,0,0,0,0,0,0,0,-15000,0,0,0,40000,55000,-15000,-15000,2021-06-09
6851,031665,聯發科元大0A購15,0,0,0,0,0,0,0,0,0,-15000,0,0,0,803000,818000,-15000,-15000,2021-06-09
6852,032546,慧洋凱基14購01,0,0,0,0,0,0,0,0,0,-15000,0,0,0,0,15000,-15000,-15000,2021-06-09
6853,032022,世紀鋼統一11購01,0,0,0,0,0,0,0,0,0,-15000,0,0,0,211000,226000,-15000,-15000,2021-06-09
6854,032337,聯發科群益0A購04,0,0,0,0,0,0,0,0,0,-15000,0,0,0,16000,31000,-15000,-15000,2021-06-09
6855,033100,中工元富0A購01,0,0,0,0,0,0,0,0,0,-15000,0,0,0,0,15000,-15000,-15000,2021-06-09
6856,031837,東鋼兆豐0A購03,0,0,0,0,0,0,0,0,0,-15000,0,0,0,20000,35000,-15000,-15000,2021-06-09
6857,032425,聯電元大0A購13,0,0,0,0,0,0,0,0,0,-15000,0,0,0,0,15000,-15000,-15000,2021-06-09
6858,036180,華通永豐0C購01,0,0,0,0,0,0,0,0,0,-15000,0,0,0,0,15000,-15000,-15000,2021-06-09
6859,033805,台航富邦11購01,0,0,0,0,0,0,0,0,0,-15000,0,0,0,0,15000,-15000,-15000,2021-06-09
6860,034225,台表科元富12購01,0,0,0,0,0,0,0,0,0,-15000,0,0,0,30000,45000,-15000,-15000,2021-06-09
6861,034622,漢唐元富12購01,0,0,0,0,0,0,0,0,0,-15000,0,0,0,0,15000,-15000,-15000,2021-06-09
6862,034538,中鋼統一11購05,0,0,0,0,0,0,0,0,0,-15000,0,0,0,0,15000,-15000,-15000,2021-06-09
6863,035753,瑞昱元富12購01,0,0,0,0,0,0,0,0,0,-15000,0,0,0,0,15000,-15000,-15000,2021-06-09
6864,035716,聯發科元大0B購15,0,0,0,0,0,0,0,0,0,-15000,0,0,0,0,15000,-15000,-15000,2021-06-09
6865,034280,裕民富邦0C購01,0,0,0,0,0,0,0,0,0,-15000,0,0,0,52000,67000,-15000,-15000,2021-06-09
6866,034814,南亞科群益0B購06,0,0,0,0,0,0,0,0,0,-15000,0,0,0,9000,24000,-15000,-15000,2021-06-09
6867,034336,國泰金群益0B購02,0,0,0,0,0,0,0,0,0,-15000,0,0,0,25000,40000,-15000,-15000,2021-06-09
6868,035053,日月光富邦0C購01,0,0,0,0,0,0,0,0,0,-15000,0,0,0,5000,20000,-15000,-15000,2021-06-09
6869,035216,華邦電第一15購01,0,0,0,0,0,0,0,0,0,-15000,0,0,0,20000,35000,-15000,-15000,2021-06-09
6870,035336,聯電元富0B購03,0,0,0,0,0,0,0,0,0,-15000,0,0,0,0,15000,-15000,-15000,2021-06-09
6871,036439,台玻兆豐11購01,0,0,0,0,0,0,0,0,0,-15000,0,0,0,0,15000,-15000,-15000,2021-06-09
6872,036071,日月光群益12購01,0,0,0,0,0,0,0,0,0,-15000,0,0,0,6000,21000,-15000,-15000,2021-06-09
6873,05133P,滬深2X富邦07售03,0,0,0,0,0,0,0,0,0,-15000,0,0,0,120000,135000,-15000,-15000,2021-06-09
6874,082042,台積電凱基07購15,0,0,0,0,0,0,0,0,0,-15000,0,0,0,0,15000,-15000,-15000,2021-06-09
6875,082053,大立光凱基09購02,0,0,0,0,0,0,0,0,0,-15000,0,0,0,11000,26000,-15000,-15000,2021-06-09
6876,082101,台積電群益08購05,0,0,0,0,0,0,0,0,0,-15000,0,0,0,20000,35000,-15000,-15000,2021-06-09
6877,082204,致新永豐07購01,0,0,0,0,0,0,0,0,0,-15000,0,0,0,0,15000,-15000,-15000,2021-06-09
6878,082291,華新科元大07購06,0,0,0,0,0,0,0,0,0,-15000,0,0,0,0,15000,-15000,-15000,2021-06-09
6879,082864,台積電中信09購08,0,0,0,0,0,0,0,0,0,-15000,0,0,0,0,15000,-15000,-15000,2021-06-09
6880,080693,T50正2凱基07購04,0,0,0,0,0,0,0,0,0,-15000,0,0,0,10000,25000,-15000,-15000,2021-06-09
6881,080796,廣宇凱基07購01,0,0,0,0,0,0,0,0,0,-15000,0,0,0,0,15000,-15000,-15000,2021-06-09
6882,080802,聯發科凱基08購05,0,0,0,0,0,0,0,0,0,-15000,0,0,0,0,15000,-15000,-15000,2021-06-09
6883,081153,德律凱基0A購01,0,0,0,0,0,0,0,0,0,-15000,0,0,0,72000,87000,-15000,-15000,2021-06-09
6884,080412,上緯控元大07購03,0,0,0,0,0,0,0,0,0,-15000,0,0,0,0,15000,-15000,-15000,2021-06-09
6885,079927,SP黃豆富邦07購02,0,0,0,0,0,0,0,0,0,-15000,0,0,0,0,15000,-15000,-15000,2021-06-09
6886,080215,台聚元大08購02,0,0,0,0,0,0,0,0,0,-15000,0,0,0,0,15000,-15000,-15000,2021-06-09
6887,080210,SP黃豆元大06購07,0,0,0,0,0,0,0,0,0,-15000,0,0,0,5000,20000,-15000,-15000,2021-06-09
6888,079558,台化國票08購01,0,0,0,0,0,0,0,0,0,-15000,0,0,0,0,15000,-15000,-15000,2021-06-09
6889,07094P,聯發科元大0B售08,0,0,0,0,0,0,0,0,0,-15000,0,0,0,20000,35000,-15000,-15000,2021-06-09
6890,07170P,中鋼群益0B售16,0,0,0,0,0,0,0,0,0,-15000,0,0,0,0,15000,-15000,-15000,2021-06-09
6891,06993P,國泰金元富0B售01,0,0,0,0,0,0,0,0,0,-15000,0,0,0,5000,20000,-15000,-15000,2021-06-09
6892,06562P,元石油元富09售04,0,0,0,0,0,0,0,0,0,-15000,0,0,0,0,15000,-15000,-15000,2021-06-09
6893,06490P,臺股指元大0A售21,0,0,0,0,0,0,0,0,0,-15000,0,0,0,1000,16000,-15000,-15000,2021-06-09
6894,07298P,中鋼國票11售01,0,0,0,0,0,0,0,0,0,-15000,0,0,0,6000,21000,-15000,-15000,2021-06-09
6895,07210P,台灣50元大11售08,0,0,0,0,0,0,0,0,0,-15000,0,0,0,5000,20000,-15000,-15000,2021-06-09
6896,2471,資通,8000,23000,-15000,0,0,0,0,0,0,0,0,0,0,0,0,0,-15000,2021-06-09
6897,2704,國賓,1000,16000,-15000,0,0,0,0,0,0,0,0,0,0,0,0,0,-15000,2021-06-09
6898,089484,上証2X元富09購03,0,0,0,0,0,0,0,0,0,-15000,0,0,0,0,15000,-15000,-15000,2021-06-09
6899,089400,台積電凱基0C購09,0,0,0,0,0,0,0,0,0,-15000,0,0,0,0,15000,-15000,-15000,2021-06-09
6900,089870,力山國泰0C購01,0,0,0,0,0,0,0,0,0,-15000,0,0,0,99000,114000,-15000,-15000,2021-06-09
6901,1225,福懋油,31000,46000,-15000,0,0,0,0,0,0,0,0,0,0,0,0,0,-15000,2021-06-09
6902,1507,永大,19000,32000,-13000,0,0,0,0,0,0,-2000,0,2000,-2000,0,0,0,-15000,2021-06-09
6903,8131,福懋科,31000,46000,-15000,0,0,0,0,0,0,0,0,0,0,0,0,0,-15000,2021-06-09
6904,006207,FH滬深,39000,1000,38000,0,0,0,0,0,0,-53998,0,0,0,39002,93000,-53998,-15998,2021-06-09
6905,4572,駐龍,49001,65000,-15999,0,0,0,0,0,0,0,0,0,0,0,0,0,-15999,2021-06-09
6906,083743,大毅國票08購02,0,0,0,0,0,0,0,0,0,-16000,0,0,0,0,16000,-16000,-16000,2021-06-09
6907,083751,緯穎國票08購01,0,0,0,0,0,0,0,0,0,-16000,0,0,0,32000,48000,-16000,-16000,2021-06-09
6908,083449,志超凱基08購01,0,0,0,0,0,0,0,0,0,-16000,0,0,0,32000,48000,-16000,-16000,2021-06-09
6909,084593,台積電第一0A購02,0,0,0,0,0,0,0,0,0,-16000,0,0,0,0,16000,-16000,-16000,2021-06-09
6910,086131,聯陽群益08購02,0,0,0,0,0,0,0,0,0,-16000,0,0,0,5000,21000,-16000,-16000,2021-06-09
6911,088967,祥碩國票0A購04,0,0,0,0,0,0,0,0,0,-16000,0,0,0,4000,20000,-16000,-16000,2021-06-09
6912,088724,欣興凱基0C購02,0,0,0,0,0,0,0,0,0,-16000,0,0,0,122000,138000,-16000,-16000,2021-06-09
6913,088296,聯發科麥證12購01,0,0,0,70000,86000,-16000,0,0,0,-16000,0,0,0,70000,86000,-16000,-16000,2021-06-09
6914,088201,台郡群益09購02,0,0,0,0,0,0,0,0,0,-16000,0,0,0,200000,216000,-16000,-16000,2021-06-09
6915,087660,A50正2兆豐0A購01,0,0,0,0,0,0,0,0,0,-16000,0,0,0,0,16000,-16000,-16000,2021-06-09
6916,087584,華新科元大09購11,0,0,0,0,0,0,0,0,0,-16000,0,0,0,0,16000,-16000,-16000,2021-06-09
6917,087133,聯電國票09購04,0,0,0,0,0,0,0,0,0,-16000,0,0,0,12000,28000,-16000,-16000,2021-06-09
6918,086520,友達凱基09購08,0,0,0,0,0,0,0,0,0,-16000,0,0,0,252000,268000,-16000,-16000,2021-06-09
6919,032739,聯電凱基0A購11,0,0,0,0,0,0,0,0,0,-16000,0,0,0,120000,136000,-16000,-16000,2021-06-09
6920,033172,聯發科永豐0B購03,0,0,0,0,0,0,0,0,0,-16000,0,0,0,4000,20000,-16000,-16000,2021-06-09
6921,030806,臺股指凱基0A購10,0,0,0,0,0,0,0,0,0,-16000,0,0,0,0,16000,-16000,-16000,2021-06-09
6922,031590,力成凱基0A購01,0,0,0,0,0,0,0,0,0,-16000,0,0,0,0,16000,-16000,-16000,2021-06-09
6923,035028,祥碩凱基0C購03,0,0,0,0,0,0,0,0,0,-16000,0,0,0,0,16000,-16000,-16000,2021-06-09
6924,034452,聯發科永豐0B購05,0,0,0,0,0,0,0,0,0,-16000,0,0,0,0,16000,-16000,-16000,2021-06-09
6925,034365,臻鼎麥證0C購01,0,0,0,2000,18000,-16000,0,0,0,-16000,0,0,0,2000,18000,-16000,-16000,2021-06-09
6926,034580,光磊凱基0B購01,0,0,0,0,0,0,0,0,0,-16000,0,0,0,0,16000,-16000,-16000,2021-06-09
6927,033758,智邦凱基0B購01,0,0,0,0,0,0,0,0,0,-16000,0,0,0,4000,20000,-16000,-16000,2021-06-09
6928,033623,鴻準元富0B購01,0,0,0,0,0,0,0,0,0,-16000,0,0,0,94000,110000,-16000,-16000,2021-06-09
6929,06131P,聯電永豐07售07,0,0,0,0,0,0,0,0,0,-16000,0,0,0,1000,17000,-16000,-16000,2021-06-09
6930,078503,精成科國票08購01,0,0,0,0,0,0,0,0,0,-16000,0,0,0,0,16000,-16000,-16000,2021-06-09
6931,06491P,聯電凱基09售07,0,0,0,0,0,0,0,0,0,-16000,0,0,0,0,16000,-16000,-16000,2021-06-09
6932,06448P,和碩凱基09售02,0,0,0,0,0,0,0,0,0,-16000,0,0,0,0,16000,-16000,-16000,2021-06-09
6933,06412P,台積電凱基13售01,0,0,0,0,0,0,0,0,0,-16000,0,0,0,100000,116000,-16000,-16000,2021-06-09
6934,081098,卜蜂群益09購01,0,0,0,0,0,0,0,0,0,-16000,0,0,0,20000,36000,-16000,-16000,2021-06-09
6935,082625,凌陽國票08購01,0,0,0,0,0,0,0,0,0,-16000,0,0,0,33000,49000,-16000,-16000,2021-06-09
6936,082553,台積電麥證0A購02,0,0,0,34000,61000,-27000,0,0,0,-16000,0,0,0,45000,61000,-16000,-16000,2021-06-09
6937,082463,聯發科元大09購02,0,0,0,0,0,0,0,0,0,-16000,0,0,0,0,16000,-16000,-16000,2021-06-09
6938,082128,鴻海統一09購04,0,0,0,0,0,0,0,0,0,-16000,0,0,0,1000,17000,-16000,-16000,2021-06-09
6939,3591,艾笛森,17000,33000,-16000,0,0,0,0,0,0,0,0,0,0,0,0,0,-16000,2021-06-09
6940,2509,全坤建,15000,31000,-16000,0,0,0,0,0,0,0,0,0,0,0,0,0,-16000,2021-06-09
6941,089985,健策元大0B購01,0,0,0,0,0,0,0,0,0,-16000,0,0,0,0,16000,-16000,-16000,2021-06-09
6942,089988,松翰元大11購01,0,0,0,0,0,0,0,0,0,-16000,0,0,0,0,16000,-16000,-16000,2021-06-09
6943,089746,台積電統一13購03,0,0,0,0,0,0,0,0,0,-16000,0,0,0,0,16000,-16000,-16000,2021-06-09
6944,9944,新麗,17000,33000,-16000,0,0,0,0,0,0,0,0,0,0,0,0,0,-16000,2021-06-09
6945,088504,聯發科元大09購11,0,0,0,0,0,0,0,0,0,-17000,0,0,0,70000,87000,-17000,-17000,2021-06-09
6946,086334,台積電元大09購13,0,0,0,0,0,0,0,0,0,-17000,0,0,0,0,17000,-17000,-17000,2021-06-09
6947,085759,臺股指麥證09購03,0,0,0,13000,30000,-17000,0,0,0,-17000,0,0,0,13000,30000,-17000,-17000,2021-06-09
6948,085173,美利達凱基09購01,0,0,0,0,0,0,0,0,0,-17000,0,0,0,0,17000,-17000,-17000,2021-06-09
6949,084540,京元電統一09購05,0,0,0,0,0,0,0,0,0,-17000,0,0,0,131000,148000,-17000,-17000,2021-06-09
6950,084466,聯電凱基08購08,0,0,0,0,0,0,0,0,0,-17000,0,0,0,19000,36000,-17000,-17000,2021-06-09
6951,084765,台積電日盛0C購02,0,0,0,0,0,0,0,0,0,-17000,0,0,0,10000,27000,-17000,-17000,2021-06-09
6952,084226,矽格元大07購04,0,0,0,0,0,0,0,0,0,-17000,0,0,0,0,17000,-17000,-17000,2021-06-09
6953,031608,彩晶元富0A購02,0,0,0,0,0,0,0,0,0,-17000,0,0,0,65000,82000,-17000,-17000,2021-06-09
6954,033146,群創元大0A購24,0,0,0,0,0,0,0,0,0,-17000,0,0,0,79000,96000,-17000,-17000,2021-06-09
6955,030071,鴻海群益0C購05,0,0,0,0,0,0,0,0,0,-17000,0,0,0,0,17000,-17000,-17000,2021-06-09
6956,030129,聯發科凱基14購01,0,0,0,0,0,0,0,0,0,-17000,0,0,0,103000,120000,-17000,-17000,2021-06-09
6957,033571,聯電第一15購01,0,0,0,0,0,0,0,0,0,-17000,0,0,0,0,17000,-17000,-17000,2021-06-09
6958,032976,群創元大0A購23,0,0,0,0,0,0,0,0,0,-17000,0,0,0,0,17000,-17000,-17000,2021-06-09
6959,033010,鴻海麥證12購01,0,0,0,0,17000,-17000,0,0,0,-17000,0,0,0,0,17000,-17000,-17000,2021-06-09
6960,032021,百和統一0C購01,0,0,0,0,0,0,0,0,0,-17000,0,0,0,53000,70000,-17000,-17000,2021-06-09
6961,032447,晶技元大0A購03,0,0,0,0,0,0,0,0,0,-17000,0,0,0,10000,27000,-17000,-17000,2021-06-09
6962,036375,聯詠國票12購01,0,0,0,0,0,0,0,0,0,-17000,0,0,0,33000,50000,-17000,-17000,2021-06-09
6963,036363,順德國票11購01,0,0,0,0,0,0,0,0,0,-17000,0,0,0,0,17000,-17000,-17000,2021-06-09
6964,06218P,國巨元大08售05,0,0,0,0,0,0,0,0,0,-17000,0,0,0,3000,20000,-17000,-17000,2021-06-09
6965,034983,台玻群益11購02,0,0,0,0,0,0,0,0,0,-17000,0,0,0,0,17000,-17000,-17000,2021-06-09
6966,034898,奇鋐凱基0B購01,0,0,0,0,0,0,0,0,0,-17000,0,0,0,41000,58000,-17000,-17000,2021-06-09
6967,033742,鴻海富邦11購01,0,0,0,0,0,0,0,0,0,-17000,0,0,0,0,17000,-17000,-17000,2021-06-09
6968,034576,大成鋼凱基0B購04,0,0,0,0,0,0,0,0,0,-17000,0,0,0,193000,210000,-17000,-17000,2021-06-09
6969,034567,玉晶光國泰11購01,0,0,0,0,0,0,0,0,0,-17000,0,0,0,38000,55000,-17000,-17000,2021-06-09
6970,033778,中鋼元大0B購03,0,0,0,0,0,0,0,0,0,-17000,0,0,0,13000,30000,-17000,-17000,2021-06-09
6971,03509B,臺股指凱基0B熊23,0,0,0,0,0,0,0,0,0,-17000,0,0,0,2000,19000,-17000,-17000,2021-06-09
6972,035425,國巨元大11購04,0,0,0,0,0,0,0,0,0,-17000,0,0,0,157000,174000,-17000,-17000,2021-06-09
6973,036551,台塑元大0C購02,0,0,0,0,0,0,0,0,0,-17000,0,0,0,0,17000,-17000,-17000,2021-06-09
6974,035499,欣興國泰13購01,0,0,0,0,0,0,0,0,0,-17000,0,0,0,5000,22000,-17000,-17000,2021-06-09
6975,035989,GIS國票11購01,0,0,0,0,0,0,0,0,0,-17000,0,0,0,12000,29000,-17000,-17000,2021-06-09
6976,033904,禾伸堂統一13購01,0,0,0,0,0,0,0,0,0,-17000,0,0,0,3000,20000,-17000,-17000,2021-06-09
6977,06319P,聯電群益08售08,0,0,0,0,0,0,0,0,0,-17000,0,0,0,0,17000,-17000,-17000,2021-06-09
6978,082218,聯發科群益08購05,0,0,0,0,0,0,0,0,0,-17000,0,0,0,417000,434000,-17000,-17000,2021-06-09
6979,080722,金像電群益08購01,0,0,0,0,0,0,0,0,0,-17000,0,0,0,0,17000,-17000,-17000,2021-06-09
6980,079334,緯穎群益07購01,0,0,0,0,0,0,0,0,0,-17000,0,0,0,0,17000,-17000,-17000,2021-06-09
6981,06533P,聯電元大09售05,0,0,0,0,0,0,0,0,0,-17000,0,0,0,0,17000,-17000,-17000,2021-06-09
6982,07263P,友達元富0C售01,0,0,0,0,0,0,0,0,0,-17000,0,0,0,6000,23000,-17000,-17000,2021-06-09
6983,07295P,聯電元富0C售04,0,0,0,0,0,0,0,0,0,-17000,0,0,0,0,17000,-17000,-17000,2021-06-09
6984,6581,鋼聯,5000,22000,-17000,0,0,0,0,0,0,0,0,0,0,0,0,0,-17000,2021-06-09
6985,089956,南亞元大0A購01,0,0,0,0,0,0,0,0,0,-17000,0,0,0,5000,22000,-17000,-17000,2021-06-09
6986,089753,彩晶統一0B購04,0,0,0,0,0,0,0,0,0,-17000,0,0,0,7000,24000,-17000,-17000,2021-06-09
6987,1423,利華,0,17000,-17000,0,0,0,0,0,0,0,0,0,0,0,0,0,-17000,2021-06-09
6988,2062,橋椿,5000,22000,-17000,0,0,0,0,0,0,0,0,0,0,0,0,0,-17000,2021-06-09
6989,4532,瑞智,104000,121000,-17000,0,0,0,0,0,0,0,0,0,0,0,0,0,-17000,2021-06-09
6990,083468,華邦電統一09購07,0,0,0,0,0,0,0,0,0,-18000,0,0,0,90000,108000,-18000,-18000,2021-06-09
6991,085195,宏碁群益0A購02,0,0,0,0,0,0,0,0,0,-18000,0,0,0,8000,26000,-18000,-18000,2021-06-09
6992,088397,廣宇中信09購02,0,0,0,0,0,0,0,0,0,-18000,0,0,0,0,18000,-18000,-18000,2021-06-09
6993,088675,康舒元大09購01,0,0,0,0,0,0,0,0,0,-18000,0,0,0,0,18000,-18000,-18000,2021-06-09
6994,086436,廣宇中信09購01,0,0,0,0,0,0,0,0,0,-18000,0,0,0,0,18000,-18000,-18000,2021-06-09
6995,087094,國喬元大09購01,0,0,0,0,0,0,0,0,0,-18000,0,0,0,0,18000,-18000,-18000,2021-06-09
6996,036356,國巨國票13購01,0,0,0,0,0,0,0,0,0,-18000,0,0,0,0,18000,-18000,-18000,2021-06-09
6997,032034,台郡富邦0C購01,0,0,0,0,0,0,0,0,0,-18000,0,0,0,42000,60000,-18000,-18000,2021-06-09
6998,032053,友達國票0C購02,0,0,0,0,0,0,0,0,0,-18000,0,0,0,2000,20000,-18000,-18000,2021-06-09
6999,031886,裕民凱基0C購01,0,0,0,0,0,0,0,0,0,-18000,0,0,0,27000,45000,-18000,-18000,2021-06-09
7000,036251,景碩凱基0C購01,0,0,0,0,0,0,0,0,0,-18000,0,0,0,22000,40000,-18000,-18000,2021-06-09
7001,033077,精成科凱基0A購02,0,0,0,0,0,0,0,0,0,-18000,0,0,0,0,18000,-18000,-18000,2021-06-09
7002,033533,聯茂國票0C購01,0,0,0,0,0,0,0,0,0,-18000,0,0,0,0,18000,-18000,-18000,2021-06-09
7003,031353,臺股指元大0A購30,0,0,0,0,0,0,0,0,0,-18000,0,0,0,404000,422000,-18000,-18000,2021-06-09
7004,030955,台泥元大0B購01,0,0,0,0,0,0,0,0,0,-18000,0,0,0,266000,284000,-18000,-18000,2021-06-09
7005,033965,國喬凱基0C購01,0,0,0,0,0,0,0,0,0,-18000,0,0,0,6000,24000,-18000,-18000,2021-06-09
7006,035468,貿聯國票0C購01,0,0,0,0,0,0,0,0,0,-18000,0,0,0,0,18000,-18000,-18000,2021-06-09
7007,03726C,臺股指元大11牛01,0,0,0,0,0,0,0,0,0,-18000,0,0,0,0,18000,-18000,-18000,2021-06-09
7008,035314,智邦元大0B購02,0,0,0,0,0,0,0,0,0,-18000,0,0,0,69000,87000,-18000,-18000,2021-06-09
7009,035266,友達統一0B購13,0,0,0,0,0,0,0,0,0,-18000,0,0,0,7000,25000,-18000,-18000,2021-06-09
7010,033845,中磊兆豐0C購01,0,0,0,0,0,0,0,0,0,-18000,0,0,0,0,18000,-18000,-18000,2021-06-09
7011,034237,力麗統一11購01,0,0,0,0,0,0,0,0,0,-18000,0,0,0,0,18000,-18000,-18000,2021-06-09
7012,034238,台玻統一13購01,0,0,0,0,0,0,0,0,0,-18000,0,0,0,19000,37000,-18000,-18000,2021-06-09
7013,034240,大成鋼統一0C購03,0,0,0,0,0,0,0,0,0,-18000,0,0,0,110000,128000,-18000,-18000,2021-06-09
7014,034207,緯穎元大12購01,0,0,0,0,0,0,0,0,0,-18000,0,0,0,76000,94000,-18000,-18000,2021-06-09
7015,034645,臺股指元大0C購19,0,0,0,0,0,0,0,0,0,-18000,0,0,0,34000,52000,-18000,-18000,2021-06-09
7016,033730,群創國票11購02,0,0,0,0,0,0,0,0,0,-18000,0,0,0,0,18000,-18000,-18000,2021-06-09
7017,034897,大立光凱基0C購03,0,0,0,0,0,0,0,0,0,-18000,0,0,0,0,18000,-18000,-18000,2021-06-09
7018,06194P,臺股指凱基0A售06,0,0,0,0,0,0,0,0,0,-18000,0,0,0,1000,19000,-18000,-18000,2021-06-09
7019,06122P,台灣50元大0A售03,0,0,0,0,0,0,0,0,0,-18000,0,0,0,7000,25000,-18000,-18000,2021-06-09
7020,06800P,申豐群益0A售02,0,0,0,0,0,0,0,0,0,-18000,0,0,0,2000,20000,-18000,-18000,2021-06-09
7021,06983P,國巨元大0A售03,0,0,0,0,0,0,0,0,0,-18000,0,0,0,0,18000,-18000,-18000,2021-06-09
7022,07082P,中鋼元富0B售06,0,0,0,0,0,0,0,0,0,-18000,0,0,0,0,18000,-18000,-18000,2021-06-09
7023,079144,金像電元大06購03,0,0,0,0,0,0,0,0,0,-18000,0,0,0,88000,106000,-18000,-18000,2021-06-09
7024,079740,創意統一08購01,0,0,0,0,0,0,0,0,0,-18000,0,0,0,0,18000,-18000,-18000,2021-06-09
7025,080874,中石化中信0A購01,0,0,0,0,0,0,0,0,0,-18000,0,0,0,0,18000,-18000,-18000,2021-06-09
7026,083206,台積電統一0A購03,0,0,0,0,0,0,0,0,0,-18000,0,0,0,0,18000,-18000,-18000,2021-06-09
7027,5243,乙盛-KY,233000,248000,-15000,0,0,0,0,0,0,-3000,1000,1000,0,2000,5000,-3000,-18000,2021-06-09
7028,1443,立益,23000,41000,-18000,0,0,0,0,0,0,0,0,0,0,0,0,0,-18000,2021-06-09
7029,089855,彩晶元大0B購02,0,0,0,0,0,0,0,0,0,-18000,0,0,0,0,18000,-18000,-18000,2021-06-09
7030,089253,凌陽統一0B購03,0,0,0,0,0,0,0,0,0,-18000,0,0,0,16000,34000,-18000,-18000,2021-06-09
7031,089122,立積富邦09購01,0,0,0,0,0,0,0,0,0,-18000,0,0,0,2000,20000,-18000,-18000,2021-06-09
7032,089074,聯詠凱基0A購02,0,0,0,0,0,0,0,0,0,-18000,0,0,0,0,18000,-18000,-18000,2021-06-09
7033,087280,中鋼元大0B購01,0,0,0,0,0,0,0,0,0,-19000,0,0,0,7000,26000,-19000,-19000,2021-06-09
7034,087052,緯創凱基0A購01,0,0,0,0,0,0,0,0,0,-19000,0,0,0,0,19000,-19000,-19000,2021-06-09
7035,088030,康舒永豐09購01,0,0,0,0,0,0,0,0,0,-19000,0,0,0,0,19000,-19000,-19000,2021-06-09
7036,085138,台郡元富08購02,0,0,0,0,0,0,0,0,0,-19000,0,0,0,0,19000,-19000,-19000,2021-06-09
7037,085288,友達凱基0C購03,0,0,0,0,0,0,0,0,0,-19000,0,0,0,62000,81000,-19000,-19000,2021-06-09
7038,086303,台化凱基09購01,0,0,0,0,0,0,0,0,0,-19000,0,0,0,36000,55000,-19000,-19000,2021-06-09
7039,083787,聯電統一0A購03,0,0,0,0,0,0,0,0,0,-19000,0,0,0,0,19000,-19000,-19000,2021-06-09
7040,084208,聯發科元大07購36,0,0,0,0,0,0,0,0,0,-19000,0,0,0,60000,79000,-19000,-19000,2021-06-09
7041,031626,義隆統一0C購02,0,0,0,0,0,0,0,0,0,-19000,0,0,0,30000,49000,-19000,-19000,2021-06-09
7042,030560,長榮統一0C購03,0,0,0,0,0,0,0,0,0,-19000,0,0,0,1000,20000,-19000,-19000,2021-06-09
7043,030122,南帝凱基14購01,0,0,0,0,0,0,0,0,0,-19000,0,0,0,21000,40000,-19000,-19000,2021-06-09
7044,030520,惠特群益0B購01,0,0,0,0,0,0,0,0,0,-19000,0,0,0,49000,68000,-19000,-19000,2021-06-09
7045,00770,國泰北美科技,0,0,0,0,0,0,0,0,0,-19000,0,0,0,101000,120000,-19000,-19000,2021-06-09
7046,031825,彩晶元大0A購09,0,0,0,0,0,0,0,0,0,-19000,0,0,0,24000,43000,-19000,-19000,2021-06-09
7047,032066,大亞中信0A購01,0,0,0,0,0,0,0,0,0,-19000,0,0,0,125000,144000,-19000,-19000,2021-06-09
7048,036178,群創麥證11購02,0,0,0,0,19000,-19000,0,0,0,-19000,0,0,0,0,19000,-19000,-19000,2021-06-09
7049,034718,台灣50麥證0B購01,0,1000,-1000,1000,19000,-18000,0,0,0,-18000,0,0,0,1000,19000,-18000,-19000,2021-06-09
7050,035470,台表科國票0C購02,0,0,0,0,0,0,0,0,0,-19000,0,0,0,38000,57000,-19000,-19000,2021-06-09
7051,034275,新光鋼富邦13購01,0,0,0,0,0,0,0,0,0,-19000,0,0,0,0,19000,-19000,-19000,2021-06-09
7052,035685,瑞昱凱基0B購03,0,0,0,0,0,0,0,0,0,-19000,0,0,0,0,19000,-19000,-19000,2021-06-09
7053,082884,台光電永豐07購01,0,0,0,0,0,0,0,0,0,-19000,0,0,0,99000,118000,-19000,-19000,2021-06-09
7054,082995,臺股指元大08購08,0,0,0,0,0,0,0,0,0,-19000,0,0,0,10000,29000,-19000,-19000,2021-06-09
7055,082142,台郡統一08購02,0,0,0,0,0,0,0,0,0,-19000,0,0,0,0,19000,-19000,-19000,2021-06-09
7056,081933,南電凱基09購01,0,0,0,0,0,0,0,0,0,-19000,0,0,0,18000,37000,-19000,-19000,2021-06-09
7057,081142,華邦電凱基0A購02,0,0,0,0,0,0,0,0,0,-19000,0,0,0,0,19000,-19000,-19000,2021-06-09
7058,071144,新光金中信09購01,0,0,0,0,0,0,0,0,0,-19000,0,0,0,20000,39000,-19000,-19000,2021-06-09
7059,06897P,國喬元大0A售02,0,0,0,0,0,0,0,0,0,-19000,0,0,0,42000,61000,-19000,-19000,2021-06-09
7060,078335,台積電凱基0A購02,0,0,0,0,0,0,0,0,0,-19000,0,0,0,1000,20000,-19000,-19000,2021-06-09
7061,089379,南電國泰0B購04,0,0,0,0,0,0,0,0,0,-19000,0,0,0,1000,20000,-19000,-19000,2021-06-09
7062,1437,勤益控,5000,24000,-19000,0,0,0,0,0,0,0,0,0,0,0,0,0,-19000,2021-06-09
7063,1506,正道,2000,21000,-19000,0,0,0,0,0,0,0,0,0,0,0,0,0,-19000,2021-06-09
7064,5007,三星,0,23000,-23000,0,0,0,0,0,0,4000,4000,0,4000,0,0,0,-19000,2021-06-09
7065,2923,鼎固-KY,0,19000,-19000,0,0,0,0,0,0,0,0,0,0,0,0,0,-19000,2021-06-09
7066,6674,鋐寶科技,10000,29000,-19000,0,0,0,0,0,0,0,0,0,0,0,0,0,-19000,2021-06-09
7067,9908,大台北,2000,21000,-19000,0,0,0,0,0,0,0,0,0,0,0,0,0,-19000,2021-06-09
7068,084187,聯電元大07購20,0,0,0,0,0,0,0,0,0,-20000,0,0,0,0,20000,-20000,-20000,2021-06-09
7069,084184,T50正2元大0A購05,0,0,0,0,0,0,0,0,0,-20000,0,0,0,0,20000,-20000,-20000,2021-06-09
7070,084148,宏達電永豐07購01,0,0,0,0,0,0,0,0,0,-20000,0,0,0,2000,22000,-20000,-20000,2021-06-09
7071,083937,南六中信07購01,0,0,0,0,0,0,0,0,0,-20000,0,0,0,0,20000,-20000,-20000,2021-06-09
7072,083967,景碩凱基07購01,0,0,0,0,0,0,0,0,0,-20000,0,0,0,0,20000,-20000,-20000,2021-06-09
7073,084006,聯電統一07購05,0,0,0,0,0,0,0,0,0,-20000,0,0,0,0,20000,-20000,-20000,2021-06-09
7074,083752,鴻海國泰09購04,0,0,0,0,0,0,0,0,0,-20000,0,0,0,2349000,2369000,-20000,-20000,2021-06-09
7075,083711,恆大元大08購01,0,0,0,0,0,0,0,0,0,-20000,0,0,0,23000,43000,-20000,-20000,2021-06-09
7076,083713,聯電元大07購16,0,0,0,0,0,0,0,0,0,-20000,0,0,0,0,20000,-20000,-20000,2021-06-09
7077,083690,和碩台新07購01,0,0,0,0,0,0,0,0,0,-20000,0,0,0,0,20000,-20000,-20000,2021-06-09
7078,083611,台積電日盛0C購01,0,0,0,0,0,0,0,0,0,-20000,0,0,0,0,20000,-20000,-20000,2021-06-09
7079,084777,強茂凱基08購03,0,0,0,0,0,0,0,0,0,-20000,0,0,0,0,20000,-20000,-20000,2021-06-09
7080,084809,凌陽永豐08購02,0,0,0,0,0,0,0,0,0,-20000,0,0,0,10000,30000,-20000,-20000,2021-06-09
7081,084800,台積電群益0A購01,0,0,0,0,0,0,0,0,0,-20000,0,0,0,83000,103000,-20000,-20000,2021-06-09
7082,084704,嘉晶統一0A購01,0,0,0,0,0,0,0,0,0,-20000,0,0,0,75000,95000,-20000,-20000,2021-06-09
7083,084661,乙盛群益09購02,0,0,0,0,0,0,0,0,0,-20000,0,0,0,0,20000,-20000,-20000,2021-06-09
7084,084664,宏碁國票09購01,0,0,0,0,0,0,0,0,0,-20000,0,0,0,0,20000,-20000,-20000,2021-06-09
7085,085023,盛群元大08購01,0,0,0,0,0,0,0,0,0,-20000,0,0,0,0,20000,-20000,-20000,2021-06-09
7086,084536,台積電統一09購21,0,0,0,0,0,0,0,0,0,-20000,0,0,0,0,20000,-20000,-20000,2021-06-09
7087,084542,聯發科統一09購16,0,0,0,0,0,0,0,0,0,-20000,0,0,0,49000,69000,-20000,-20000,2021-06-09
7088,084579,臺股指國票08購04,0,0,0,0,0,0,0,0,0,-20000,0,0,0,0,20000,-20000,-20000,2021-06-09
7089,084621,鴻海凱基08購13,0,0,0,0,0,0,0,0,0,-20000,0,0,0,0,20000,-20000,-20000,2021-06-09
7090,084289,凱美永豐07購06,0,0,0,0,0,0,0,0,0,-20000,0,0,0,89000,109000,-20000,-20000,2021-06-09
7091,086300,台積電麥證09購03,0,0,0,0,20000,-20000,0,0,0,-20000,0,0,0,0,20000,-20000,-20000,2021-06-09
7092,086279,金寶群益0A購01,0,0,0,0,0,0,0,0,0,-20000,0,0,0,0,20000,-20000,-20000,2021-06-09
7093,086360,臺股指元大0B購11,0,0,0,0,0,0,0,0,0,-20000,0,0,0,0,20000,-20000,-20000,2021-06-09
7094,086378,聯發科國票09購08,0,0,0,0,0,0,0,0,0,-20000,0,0,0,0,20000,-20000,-20000,2021-06-09
7095,086258,儒鴻永豐09購01,0,0,0,0,0,0,0,0,0,-20000,0,0,0,0,20000,-20000,-20000,2021-06-09
7096,086097,微星永豐08購02,0,0,0,0,0,0,0,0,0,-20000,0,0,0,0,20000,-20000,-20000,2021-06-09
7097,086088,大立光中信0A購01,0,0,0,0,0,0,0,0,0,-20000,0,0,0,0,20000,-20000,-20000,2021-06-09
7098,085546,臺指反群益0A購02,0,0,0,0,0,0,0,0,0,-20000,0,0,0,0,20000,-20000,-20000,2021-06-09
7099,085644,聯電台新08購03,0,0,0,0,0,0,0,0,0,-20000,0,0,0,0,20000,-20000,-20000,2021-06-09
7100,085606,台積電元大08購31,0,0,0,0,0,0,0,0,0,-20000,0,0,0,0,20000,-20000,-20000,2021-06-09
7101,088014,惠特兆豐09購01,0,0,0,0,0,0,0,0,0,-20000,0,0,0,40000,60000,-20000,-20000,2021-06-09
7102,087991,聚陽群益0A購01,0,0,0,0,0,0,0,0,0,-20000,0,0,0,0,20000,-20000,-20000,2021-06-09
7103,088035,滬深2X元大0C購02,0,0,0,0,0,0,0,0,0,-20000,0,0,0,0,20000,-20000,-20000,2021-06-09
7104,088182,上証2X群益09購05,0,0,0,0,0,0,0,0,0,-20000,0,0,0,14000,34000,-20000,-20000,2021-06-09
7105,088169,富邦金元大09購06,0,0,0,0,0,0,0,0,0,-20000,0,0,0,0,20000,-20000,-20000,2021-06-09
7106,088149,台表科永豐09購01,0,0,0,0,0,0,0,0,0,-20000,0,0,0,0,20000,-20000,-20000,2021-06-09
7107,088956,台積電國票0C購05,0,0,0,0,0,0,0,0,0,-20000,0,0,0,0,20000,-20000,-20000,2021-06-09
7108,088860,友達永豐09購05,0,0,0,0,0,0,0,0,0,-20000,0,0,0,0,20000,-20000,-20000,2021-06-09
7109,088878,台灣50凱基0B購02,0,0,0,0,0,0,0,0,0,-20000,0,0,0,70000,90000,-20000,-20000,2021-06-09
7110,088354,微星統一0B購05,0,0,0,0,0,0,0,0,0,-20000,0,0,0,0,20000,-20000,-20000,2021-06-09
7111,088649,創意富邦0A購01,0,0,0,0,0,0,0,0,0,-20000,0,0,0,20000,40000,-20000,-20000,2021-06-09
7112,086989,TPK元富09購01,0,0,0,0,0,0,0,0,0,-20000,0,0,0,0,20000,-20000,-20000,2021-06-09
7113,086780,力山兆豐09購01,0,0,0,0,0,0,0,0,0,-20000,0,0,0,10000,30000,-20000,-20000,2021-06-09
7114,086806,智伸科統一0B購01,0,0,0,0,0,0,0,0,0,-20000,0,0,0,0,20000,-20000,-20000,2021-06-09
7115,086827,英業達元大09購01,0,0,0,0,0,0,0,0,0,-20000,0,0,0,0,20000,-20000,-20000,2021-06-09
7116,086821,致新元富09購01,0,0,0,0,0,0,0,0,0,-20000,0,0,0,0,20000,-20000,-20000,2021-06-09
7117,086455,旺宏群益0B購02,0,0,0,0,0,0,0,0,0,-20000,0,0,0,0,20000,-20000,-20000,2021-06-09
7118,086471,新日興兆豐0A購01,0,0,0,0,0,0,0,0,0,-20000,0,0,0,0,20000,-20000,-20000,2021-06-09
7119,086559,京鼎元大09購01,0,0,0,0,0,0,0,0,0,-20000,0,0,0,223000,243000,-20000,-20000,2021-06-09
7120,087292,大立光元大0B購01,0,0,0,0,0,0,0,0,0,-20000,0,0,0,0,20000,-20000,-20000,2021-06-09
7121,087301,巨大元大09購01,0,0,0,0,0,0,0,0,0,-20000,0,0,0,20000,40000,-20000,-20000,2021-06-09
7122,087323,盟立永豐09購01,0,0,0,0,0,0,0,0,0,-20000,0,0,0,0,20000,-20000,-20000,2021-06-09
7123,087216,華新科凱基09購03,0,0,0,0,0,0,0,0,0,-20000,0,0,0,0,20000,-20000,-20000,2021-06-09
7124,087221,景碩凱基09購03,0,0,0,0,0,0,0,0,0,-20000,0,0,0,30000,50000,-20000,-20000,2021-06-09
7125,032060,正文國票0B購01,0,0,0,0,0,0,0,0,0,-20000,0,0,0,0,20000,-20000,-20000,2021-06-09
7126,032508,長榮永豐0A購11,0,0,0,0,0,0,0,0,0,-20000,0,0,0,0,20000,-20000,-20000,2021-06-09
7127,031832,聯發科富邦14購01,0,0,0,0,0,0,0,0,0,-20000,0,0,0,0,20000,-20000,-20000,2021-06-09
7128,036271,SGBR2X元大0C購03,0,0,0,0,0,0,0,0,0,-20000,0,0,0,0,20000,-20000,-20000,2021-06-09
7129,05635P,群創中信0B售03,0,0,0,0,0,0,0,0,0,-20000,0,0,0,0,20000,-20000,-20000,2021-06-09
7130,031732,亞聚凱基12購01,0,0,0,0,0,0,0,0,0,-20000,0,0,0,38000,58000,-20000,-20000,2021-06-09
7131,033465,台灣50凱基11購02,0,0,0,0,0,0,0,0,0,-20000,0,0,0,0,20000,-20000,-20000,2021-06-09
7132,033396,矽創元大0B購02,0,0,0,0,0,0,0,0,0,-20000,0,0,0,0,20000,-20000,-20000,2021-06-09
7133,033418,聯發科永豐0B購04,0,0,0,0,0,0,0,0,0,-20000,0,0,0,0,20000,-20000,-20000,2021-06-09
7134,031878,台積電凱基0A購15,0,0,0,0,0,0,0,0,0,-20000,0,0,0,40000,60000,-20000,-20000,2021-06-09
7135,032975,群創元大0A購22,0,0,0,0,0,0,0,0,0,-20000,0,0,0,0,20000,-20000,-20000,2021-06-09
7136,032850,聯茂永豐0A購01,0,0,0,0,0,0,0,0,0,-20000,0,0,0,0,20000,-20000,-20000,2021-06-09
7137,032811,國巨國票0B購02,0,0,0,0,0,0,0,0,0,-20000,0,0,0,0,20000,-20000,-20000,2021-06-09
7138,030363,華晶科群益0A購01,0,0,0,0,0,0,0,0,0,-20000,0,0,0,0,20000,-20000,-20000,2021-06-09
7139,030095,圓剛永豐0A購01,0,0,0,0,0,0,0,0,0,-20000,0,0,0,0,20000,-20000,-20000,2021-06-09
7140,030317,台積電麥證0A購04,0,0,0,1000,21000,-20000,0,0,0,-20000,0,0,0,2000,22000,-20000,-20000,2021-06-09
7141,030453,超豐富邦0C購01,0,0,0,0,0,0,0,0,0,-20000,0,0,0,5000,25000,-20000,-20000,2021-06-09
7142,030533,台達電凱基0A購01,0,0,0,0,0,0,0,0,0,-20000,0,0,0,0,20000,-20000,-20000,2021-06-09
7143,030470,聯發科國泰0C購03,0,0,0,0,0,0,0,0,0,-20000,0,0,0,0,20000,-20000,-20000,2021-06-09
7144,030190,大成凱基0A購01,0,0,0,0,0,0,0,0,0,-20000,0,0,0,0,20000,-20000,-20000,2021-06-09
7145,031463,潤泰全群益0B購01,0,0,0,0,0,0,0,0,0,-20000,0,0,0,0,20000,-20000,-20000,2021-06-09
7146,031629,長榮統一12購02,0,0,0,0,0,0,0,0,0,-20000,0,0,0,2000,22000,-20000,-20000,2021-06-09
7147,030543,大立光凱基0A購06,0,0,0,0,0,0,0,0,0,-20000,0,0,0,0,20000,-20000,-20000,2021-06-09
7148,031325,台積電元大0A購10,5000,0,5000,0,0,0,0,0,0,-25000,0,0,0,0,25000,-25000,-20000,2021-06-09
7149,031533,台積電富邦0C購03,0,0,0,0,0,0,0,0,0,-20000,0,0,0,0,20000,-20000,-20000,2021-06-09
7150,030797,聯發科凱基0A購05,0,0,0,0,0,0,0,0,0,-20000,0,0,0,0,20000,-20000,-20000,2021-06-09
7151,030842,華新科兆豐0A購01,0,0,0,0,0,0,0,0,0,-20000,0,0,0,10000,30000,-20000,-20000,2021-06-09
7152,030587,T50正2元大11購02,0,0,0,0,0,0,0,0,0,-20000,0,0,0,0,20000,-20000,-20000,2021-06-09
7153,030612,宏達電元大0B購01,0,0,0,0,0,0,0,0,0,-20000,0,0,0,10000,30000,-20000,-20000,2021-06-09
7154,030771,群創康和0A購02,0,0,0,0,0,0,0,0,0,-20000,0,0,0,0,20000,-20000,-20000,2021-06-09
7155,030750,華晶科元大0B購01,0,0,0,0,0,0,0,0,0,-20000,0,0,0,0,20000,-20000,-20000,2021-06-09
7156,031012,京元電永豐0A購01,0,0,0,0,0,0,0,0,0,-20000,0,0,0,0,20000,-20000,-20000,2021-06-09
7157,031099,光磊群益0B購01,0,0,0,0,0,0,0,0,0,-20000,0,0,0,0,20000,-20000,-20000,2021-06-09
7158,033177,中信金永豐0B購01,0,0,0,0,0,0,0,0,0,-20000,0,0,0,0,20000,-20000,-20000,2021-06-09
7159,033224,日月光元富12購01,0,0,0,0,0,0,0,0,0,-20000,0,0,0,20000,40000,-20000,-20000,2021-06-09
7160,032795,彩晶元大0C購03,0,0,0,0,0,0,0,0,0,-20000,0,0,0,0,20000,-20000,-20000,2021-06-09
7161,036340,大銀元富0C購01,0,0,0,0,0,0,0,0,0,-20000,0,0,0,0,20000,-20000,-20000,2021-06-09
7162,035496,聯發科國泰12購01,0,0,0,0,0,0,0,0,0,-20000,0,0,0,1000,21000,-20000,-20000,2021-06-09
7163,035489,群創群益0C購08,0,0,0,0,0,0,0,0,0,-20000,0,0,0,5000,25000,-20000,-20000,2021-06-09
7164,03577P,創意元富08售03,0,0,0,0,0,0,0,0,0,-20000,0,0,0,10000,30000,-20000,-20000,2021-06-09
7165,034299,大亞永豐0B購02,0,0,0,0,0,0,0,0,0,-20000,0,0,0,0,20000,-20000,-20000,2021-06-09
7166,034285,台積電兆豐0B購02,0,0,0,0,0,0,0,0,0,-20000,0,0,0,0,20000,-20000,-20000,2021-06-09
7167,034010,裕民群益0B購02,0,0,0,0,0,0,0,0,0,-20000,0,0,0,12000,32000,-20000,-20000,2021-06-09
7168,033913,國巨台新0B購01,0,0,0,0,0,0,0,0,0,-20000,0,0,0,0,20000,-20000,-20000,2021-06-09
7169,035986,光磊國票11購01,0,0,0,0,0,0,0,0,0,-20000,0,0,0,0,20000,-20000,-20000,2021-06-09
7170,035345,玉晶光元富12購04,0,0,0,0,0,0,0,0,0,-20000,0,0,0,0,20000,-20000,-20000,2021-06-09
7171,035200,大立光元富0B購03,0,0,0,0,0,0,0,0,0,-20000,0,0,0,0,20000,-20000,-20000,2021-06-09
7172,036558,長榮航元大11購05,0,0,0,0,0,0,0,0,0,-20000,0,0,0,20000,40000,-20000,-20000,2021-06-09
7173,035400,儒鴻元富0C購03,0,0,0,0,0,0,0,0,0,-20000,0,0,0,10000,30000,-20000,-20000,2021-06-09
7174,036070,貿聯群益0C購01,0,0,0,0,0,0,0,0,0,-20000,0,0,0,0,20000,-20000,-20000,2021-06-09
7175,036029,華邦電統一12購01,0,0,0,0,0,0,0,0,0,-20000,0,0,0,0,20000,-20000,-20000,2021-06-09
7176,034649,晶技國泰11購01,0,0,0,0,0,0,0,0,0,-20000,0,0,0,31000,51000,-20000,-20000,2021-06-09
7177,034115,萬海群益0B購03,0,0,0,0,0,0,0,0,0,-20000,0,0,0,10000,30000,-20000,-20000,2021-06-09
7178,034044,奇力新元富0B購02,0,0,0,0,0,0,0,0,0,-20000,0,0,0,0,20000,-20000,-20000,2021-06-09
7179,033840,台積電兆豐0B購01,0,0,0,0,0,0,0,0,0,-20000,0,0,0,0,20000,-20000,-20000,2021-06-09
7180,034345,鴻海元富12購07,0,0,0,0,0,0,0,0,0,-20000,0,0,0,500000,520000,-20000,-20000,2021-06-09
7181,034931,欣興台新0B購02,0,0,0,0,0,0,0,0,0,-20000,0,0,0,0,20000,-20000,-20000,2021-06-09
7182,033616,富邦金群益11購02,0,0,0,0,0,0,0,0,0,-20000,0,0,0,69000,89000,-20000,-20000,2021-06-09
7183,06068P,臺股指凱基07售30,0,0,0,0,0,0,0,0,0,-20000,0,0,0,0,20000,-20000,-20000,2021-06-09
7184,06197P,T50正2群益09售01,0,0,0,0,0,0,0,0,0,-20000,0,0,0,0,20000,-20000,-20000,2021-06-09
7185,034430,儒鴻凱基13購01,0,0,0,0,0,0,0,0,0,-20000,0,0,0,0,20000,-20000,-20000,2021-06-09
7186,033857,禾伸堂凱基0B購01,0,0,0,0,0,0,0,0,0,-20000,0,0,0,80000,100000,-20000,-20000,2021-06-09
7187,033884,聯發科元富12購08,0,0,0,0,0,0,0,0,0,-20000,0,0,0,20000,40000,-20000,-20000,2021-06-09
7188,06352P,南電凱基08售05,0,0,0,0,0,0,0,0,0,-20000,0,0,0,20000,40000,-20000,-20000,2021-06-09
7189,078212,聯電富邦08購01,0,0,0,0,0,0,0,0,0,-20000,0,0,0,0,20000,-20000,-20000,2021-06-09
7190,078759,玉晶光國票09購02,0,0,0,0,0,0,0,0,0,-20000,0,0,0,0,20000,-20000,-20000,2021-06-09
7191,077068,愛普統一07購03,0,0,0,0,0,0,0,0,0,-20000,0,0,0,0,20000,-20000,-20000,2021-06-09
7192,077069,愛普統一09購01,0,0,0,0,0,0,0,0,0,-20000,0,0,0,0,20000,-20000,-20000,2021-06-09
7193,078176,強茂兆豐07購01,0,0,0,0,0,0,0,0,0,-20000,0,0,0,0,20000,-20000,-20000,2021-06-09
7194,076282,智邦兆豐06購01,0,0,0,0,0,0,0,0,0,-20000,0,0,0,20000,40000,-20000,-20000,2021-06-09
7195,074335,世紀鋼元大07購02,0,0,0,0,0,0,0,0,0,-20000,0,0,0,0,20000,-20000,-20000,2021-06-09
7196,074462,奇力新元富0A購01,0,0,0,0,0,0,0,0,0,-20000,0,0,0,0,20000,-20000,-20000,2021-06-09
7197,074360,嘉聯益元富08購01,0,0,0,0,0,0,0,0,0,-20000,0,0,0,0,20000,-20000,-20000,2021-06-09
7198,06913P,群創凱基0B售09,0,0,0,0,0,0,0,0,0,-20000,0,0,0,0,20000,-20000,-20000,2021-06-09
7199,068407,同欣電元富07購02,0,0,0,0,0,0,0,0,0,-20000,0,0,0,0,20000,-20000,-20000,2021-06-09
7200,07134P,聯電凱基0C售05,0,0,0,0,0,0,0,0,0,-20000,0,0,0,0,20000,-20000,-20000,2021-06-09
7201,07175P,群創凱基0B售11,0,0,0,0,0,0,0,0,0,-20000,0,0,0,50000,70000,-20000,-20000,2021-06-09
7202,06651P,南帝元大09售06,0,0,0,0,0,0,0,0,0,-20000,0,0,0,0,20000,-20000,-20000,2021-06-09
7203,06542P,臺股指凱基09售28,0,0,0,0,0,0,0,0,0,-20000,0,0,0,20000,40000,-20000,-20000,2021-06-09
7204,06436P,滬深2X群益09售04,0,0,0,0,0,0,0,0,0,-20000,0,0,0,0,20000,-20000,-20000,2021-06-09
7205,081063,道瓊反中信09購01,0,0,0,0,0,0,0,0,0,-20000,0,0,0,0,20000,-20000,-20000,2021-06-09
7206,081342,億豐群益09購01,0,0,0,0,0,0,0,0,0,-20000,0,0,0,0,20000,-20000,-20000,2021-06-09
7207,081388,大立光麥證09購02,0,0,0,0,20000,-20000,0,0,0,-20000,0,0,0,0,20000,-20000,-20000,2021-06-09
7208,080665,長華元大06購02,0,0,0,0,0,0,0,0,0,-20000,0,0,0,0,20000,-20000,-20000,2021-06-09
7209,079993,台積電元富09購05,0,0,0,0,0,0,0,0,0,-20000,0,0,0,0,20000,-20000,-20000,2021-06-09
7210,080296,臺股指中信0C購01,0,0,0,0,0,0,0,0,0,-20000,0,0,0,0,20000,-20000,-20000,2021-06-09
7211,081786,廣宇康和07購01,0,0,0,0,0,0,0,0,0,-20000,0,0,0,0,20000,-20000,-20000,2021-06-09
7212,081860,嘉澤中信07購01,0,0,0,0,0,0,0,0,0,-20000,0,0,0,0,20000,-20000,-20000,2021-06-09
7213,081632,聯詠元大07購04,0,0,0,0,0,0,0,0,0,-20000,0,0,0,41000,61000,-20000,-20000,2021-06-09
7214,082252,緯穎凱基07購01,0,0,0,0,0,0,0,0,0,-20000,0,0,0,0,20000,-20000,-20000,2021-06-09
7215,082207,T50反1群益09購06,0,0,0,0,0,0,0,0,0,-20000,0,0,0,0,20000,-20000,-20000,2021-06-09
7216,082436,全新國泰09購01,0,0,0,0,0,0,0,0,0,-20000,0,0,0,0,20000,-20000,-20000,2021-06-09
7217,083011,友達凱基0B購01,0,0,0,0,0,0,0,0,0,-20000,0,0,0,0,20000,-20000,-20000,2021-06-09
7218,083241,大立光群益08購02,0,0,0,0,0,0,0,0,0,-20000,0,0,0,0,20000,-20000,-20000,2021-06-09
7219,083106,智原元大07購02,0,0,0,0,0,0,0,0,0,-20000,0,0,0,0,20000,-20000,-20000,2021-06-09
7220,082541,冠德凱基08購01,0,0,0,0,0,0,0,0,0,-20000,0,0,0,0,20000,-20000,-20000,2021-06-09
7221,082716,矽格凱基08購01,0,0,0,0,0,0,0,0,0,-20000,0,0,0,0,20000,-20000,-20000,2021-06-09
7222,082837,台表科國泰09購01,0,0,0,0,0,0,0,0,0,-20000,0,0,0,0,20000,-20000,-20000,2021-06-09
7223,083399,臺股指中信0A購05,0,0,0,0,0,0,0,0,0,-20000,0,0,0,0,20000,-20000,-20000,2021-06-09
7224,1708,東鹼,57000,77000,-20000,0,0,0,0,0,0,0,0,0,0,0,0,0,-20000,2021-06-09
7225,089799,群創康和09購02,0,0,0,0,0,0,0,0,0,-20000,0,0,0,0,20000,-20000,-20000,2021-06-09
7226,089806,仁寶群益09購02,0,0,0,0,0,0,0,0,0,-20000,0,0,0,0,20000,-20000,-20000,2021-06-09
7227,089808,佳世達群益09購02,0,0,0,0,0,0,0,0,0,-20000,0,0,0,0,20000,-20000,-20000,2021-06-09
7228,089955,滬深2X元大0B購01,0,0,0,0,0,0,0,0,0,-20000,0,0,0,0,20000,-20000,-20000,2021-06-09
7229,089929,佳世達永豐0A購01,0,0,0,0,0,0,0,0,0,-20000,0,0,0,0,20000,-20000,-20000,2021-06-09
7230,089329,台灣50元大09購02,0,0,0,0,0,0,0,0,0,-20000,0,0,0,0,20000,-20000,-20000,2021-06-09
7231,089266,滬深2X日盛09購03,0,0,0,0,0,0,0,0,0,-20000,0,0,0,30000,50000,-20000,-20000,2021-06-09
7232,089085,金寶統一0B購01,0,0,0,0,0,0,0,0,0,-20000,0,0,0,10000,30000,-20000,-20000,2021-06-09
7233,089083,臺股指凱基11購03,0,0,0,0,0,0,0,0,0,-20000,0,0,0,0,20000,-20000,-20000,2021-06-09
7234,089249,國喬統一0A購01,0,0,0,0,0,0,0,0,0,-20000,0,0,0,0,20000,-20000,-20000,2021-06-09
7235,089735,群創永豐09購09,0,0,0,0,0,0,0,0,0,-20000,0,0,0,0,20000,-20000,-20000,2021-06-09
7236,089693,京鼎元大09購02,0,0,0,0,0,0,0,0,0,-20000,0,0,0,0,20000,-20000,-20000,2021-06-09
7237,089492,台積電元富0C購22,0,0,0,0,0,0,0,0,0,-20000,0,0,0,0,20000,-20000,-20000,2021-06-09
7238,089516,長榮航元大09購08,0,0,0,0,0,0,0,0,0,-20000,0,0,0,0,20000,-20000,-20000,2021-06-09
7239,089576,儒鴻永豐09購02,0,0,0,0,0,0,0,0,0,-20000,0,0,0,0,20000,-20000,-20000,2021-06-09
7240,2459,敦吉,2000,22000,-20000,0,0,0,0,0,0,-1,1000,1001,-1,0,0,0,-20001,2021-06-09
7241,087126,華夏國票0A購01,0,0,0,0,0,0,0,0,0,-21000,0,0,0,19000,40000,-21000,-21000,2021-06-09
7242,087134,聯電國票0A購01,0,0,0,0,0,0,0,0,0,-21000,0,0,0,0,21000,-21000,-21000,2021-06-09
7243,087050,華晶科凱基0A購01,0,0,0,0,0,0,0,0,0,-21000,0,0,0,0,21000,-21000,-21000,2021-06-09
7244,088647,聯發科富邦0A購03,0,0,0,0,0,0,0,0,0,-21000,0,0,0,0,21000,-21000,-21000,2021-06-09
7245,088311,乙盛凱基0A購02,0,0,0,0,0,0,0,0,0,-21000,0,0,0,130000,151000,-21000,-21000,2021-06-09
7246,087934,兆豐金統一0B購01,0,0,0,0,0,0,0,0,0,-21000,0,0,0,0,21000,-21000,-21000,2021-06-09
7247,085726,聯詠中信08購01,0,0,0,0,0,0,0,0,0,-21000,0,0,0,0,21000,-21000,-21000,2021-06-09
7248,085652,華邦電統一0A購02,0,0,0,0,0,0,0,0,0,-21000,0,0,0,30000,51000,-21000,-21000,2021-06-09
7249,085284,台積電凱基08購27,0,0,0,0,0,0,0,0,0,-21000,0,0,0,0,21000,-21000,-21000,2021-06-09
7250,085171,緯穎凱基08購02,0,0,0,0,0,0,0,0,0,-21000,0,0,0,10000,31000,-21000,-21000,2021-06-09
7251,084720,T50正2元大0B購02,0,0,0,0,0,0,0,0,0,-21000,0,0,0,0,21000,-21000,-21000,2021-06-09
7252,032780,義隆元大0B購02,0,0,0,0,0,0,0,0,0,-21000,0,0,0,163000,184000,-21000,-21000,2021-06-09
7253,030972,瑞昱元大0A購02,0,0,0,0,0,0,0,0,0,-21000,0,0,0,0,21000,-21000,-21000,2021-06-09
7254,031881,京元電凱基12購01,0,0,0,0,0,0,0,0,0,-21000,0,0,0,37000,58000,-21000,-21000,2021-06-09
7255,034595,聯電統一0C購07,0,0,0,0,0,0,0,0,0,-21000,0,0,0,31000,52000,-21000,-21000,2021-06-09
7256,034669,台積電凱基0C購13,0,0,0,0,0,0,0,0,0,-21000,0,0,0,0,21000,-21000,-21000,2021-06-09
7257,034495,大立光元大0B購02,0,0,0,0,0,0,0,0,0,-21000,0,0,0,17000,38000,-21000,-21000,2021-06-09
7258,036514,晶相光凱基11購02,0,0,0,0,0,0,0,0,0,-21000,0,0,0,0,21000,-21000,-21000,2021-06-09
7259,036392,聯發科國泰12購02,0,0,0,0,0,0,0,0,0,-21000,0,0,0,21000,42000,-21000,-21000,2021-06-09
7260,05759P,鴻海凱基0A售06,0,0,0,0,0,0,0,0,0,-21000,0,0,0,0,21000,-21000,-21000,2021-06-09
7261,035247,晶相光群益0B購03,0,0,0,0,0,0,0,0,0,-21000,0,0,0,0,21000,-21000,-21000,2021-06-09
7262,033989,瑞昱兆豐0C購01,0,0,0,0,0,0,0,0,0,-21000,0,0,0,0,21000,-21000,-21000,2021-06-09
7263,033976,國泰金凱基0B購04,0,0,0,0,0,0,0,0,0,-21000,0,0,0,24000,45000,-21000,-21000,2021-06-09
7264,082791,聯發科元富0A購06,0,0,0,0,0,0,0,0,0,-21000,0,0,0,0,21000,-21000,-21000,2021-06-09
7265,082588,T50正2元大0A購03,0,0,0,0,0,0,0,0,0,-21000,0,0,0,0,21000,-21000,-21000,2021-06-09
7266,083228,玉晶光富邦08購01,0,0,0,0,0,0,0,0,0,-21000,0,0,0,119000,140000,-21000,-21000,2021-06-09
7267,083283,瑞昱元大07購06,0,0,0,0,0,0,0,0,0,-21000,0,0,0,0,21000,-21000,-21000,2021-06-09
7268,081867,中石化麥證07購01,0,0,0,22000,21000,1000,0,0,0,-21000,0,0,0,22000,43000,-21000,-21000,2021-06-09
7269,079717,景碩群益06購01,0,0,0,0,0,0,0,0,0,-21000,0,0,0,0,21000,-21000,-21000,2021-06-09
7270,080892,愛普中信09購01,0,0,0,0,0,0,0,0,0,-21000,0,0,0,0,21000,-21000,-21000,2021-06-09
7271,081237,A50正2元富07購01,0,0,0,0,0,0,0,0,0,-21000,0,0,0,0,21000,-21000,-21000,2021-06-09
7272,07021P,中石化中信0B售03,0,0,0,0,0,0,0,0,0,-21000,0,0,0,0,21000,-21000,-21000,2021-06-09
7273,089454,台積電統一15購01,0,0,0,0,0,0,0,0,0,-21000,0,0,0,0,21000,-21000,-21000,2021-06-09
7274,089725,正新永豐09購01,0,0,0,0,0,0,0,0,0,-21000,0,0,0,0,21000,-21000,-21000,2021-06-09
7275,089356,聯發科元大09購15,0,0,0,0,0,0,0,0,0,-21000,0,0,0,51000,72000,-21000,-21000,2021-06-09
7276,084332,聯電元大07購24,0,0,0,0,0,0,0,0,0,-22000,0,0,0,30000,52000,-22000,-22000,2021-06-09
7277,086018,同欣電元大0C購01,0,0,0,0,0,0,0,0,0,-22000,0,0,0,0,22000,-22000,-22000,2021-06-09
7278,088456,聯詠統一0A購08,0,0,0,0,0,0,0,0,0,-22000,0,0,0,0,22000,-22000,-22000,2021-06-09
7279,087342,可成凱基0B購01,0,0,0,0,0,0,0,0,0,-22000,0,0,0,5000,27000,-22000,-22000,2021-06-09
7280,033446,健策元大11購01,0,0,0,0,0,0,0,0,0,-22000,0,0,0,0,22000,-22000,-22000,2021-06-09
7281,036218,群創國泰12購01,0,0,0,0,0,0,0,0,0,-22000,0,0,0,28000,50000,-22000,-22000,2021-06-09
7282,030602,仁寶元大0A購01,0,0,0,0,0,0,0,0,0,-22000,0,0,0,0,22000,-22000,-22000,2021-06-09
7283,031600,台積電富邦14購01,0,0,0,0,0,0,0,0,0,-22000,0,0,0,0,22000,-22000,-22000,2021-06-09
7284,031382,中鋼統一0C購02,0,0,0,0,0,0,0,0,0,-22000,0,0,0,68000,90000,-22000,-22000,2021-06-09
7285,031375,創意永豐0A購01,0,0,0,0,0,0,0,0,0,-22000,0,0,0,141000,163000,-22000,-22000,2021-06-09
7286,00689R,國泰20年美債反1,0,41000,-41000,0,0,0,0,0,0,19000,28000,0,28000,160000,169000,-9000,-22000,2021-06-09
7287,035923,台表科統一12購01,0,0,0,0,0,0,0,0,0,-22000,0,0,0,14000,36000,-22000,-22000,2021-06-09
7288,034851,中橡元大0C購01,0,0,0,0,0,0,0,0,0,-22000,0,0,0,79000,101000,-22000,-22000,2021-06-09
7289,035695,T50正2元大0C購01,0,0,0,0,0,0,0,0,0,-22000,0,0,0,0,22000,-22000,-22000,2021-06-09
7290,035260,晶相光凱基11購01,0,0,0,0,0,0,0,0,0,-22000,0,0,0,3000,25000,-22000,-22000,2021-06-09
7291,035440,群創元大11購02,0,0,0,0,0,0,0,0,0,-22000,0,0,0,0,22000,-22000,-22000,2021-06-09
7292,034441,萬海凱基11購01,0,0,0,0,0,0,0,0,0,-22000,0,0,0,0,22000,-22000,-22000,2021-06-09
7293,06620P,國巨元富0C售09,0,0,0,0,0,0,0,0,0,-22000,0,0,0,1000,23000,-22000,-22000,2021-06-09
7294,07202P,中鋼凱基11售03,0,0,0,0,0,0,0,0,0,-22000,0,0,0,0,22000,-22000,-22000,2021-06-09
7295,081108,光磊群益0A購01,0,0,0,0,0,0,0,0,0,-22000,0,0,0,55000,77000,-22000,-22000,2021-06-09
7296,080635,榮成元大08購01,0,0,0,0,0,0,0,0,0,-22000,0,0,0,414000,436000,-22000,-22000,2021-06-09
7297,083366,恆大國票08購01,0,0,0,0,0,0,0,0,0,-22000,0,0,0,0,22000,-22000,-22000,2021-06-09
7298,089509,微星元大09購05,0,0,0,0,0,0,0,0,0,-22000,0,0,0,0,22000,-22000,-22000,2021-06-09
7299,089814,玉晶光群益0B購02,0,0,0,0,0,0,0,0,0,-22000,0,0,0,9000,31000,-22000,-22000,2021-06-09
7300,3022,威強電,30000,52000,-22000,0,0,0,0,0,0,0,0,0,0,0,0,0,-22000,2021-06-09
7301,2908,特力,7000,29000,-22000,0,0,0,0,0,0,0,0,0,0,0,0,0,-22000,2021-06-09
7302,8482,商億-KY,0,22000,-22000,0,0,0,0,0,0,0,0,0,0,0,0,0,-22000,2021-06-09
7303,6152,百一,60000,82000,-22000,0,0,0,0,0,0,0,0,0,0,0,0,0,-22000,2021-06-09
7304,087048,奇鋐凱基09購02,0,0,0,0,0,0,0,0,0,-23000,0,0,0,0,23000,-23000,-23000,2021-06-09
7305,088728,康舒凱基09購01,0,0,0,0,0,0,0,0,0,-23000,0,0,0,0,23000,-23000,-23000,2021-06-09
7306,087988,元石油群益0A購01,0,0,0,0,0,0,0,0,0,-23000,0,0,0,0,23000,-23000,-23000,2021-06-09
7307,085651,華邦電統一0A購01,0,0,0,0,0,0,0,0,0,-23000,0,0,0,56000,79000,-23000,-23000,2021-06-09
7308,030252,晶華永豐0A購01,0,0,0,0,0,0,0,0,0,-23000,0,0,0,113000,136000,-23000,-23000,2021-06-09
7309,030281,南亞科台新0A購01,0,0,0,0,0,0,0,0,0,-23000,0,0,0,10000,33000,-23000,-23000,2021-06-09
7310,036257,國喬群益0C購01,0,0,0,0,0,0,0,0,0,-23000,0,0,0,26000,49000,-23000,-23000,2021-06-09
7311,032880,國泰金凱基0B購03,0,0,0,0,0,0,0,0,0,-23000,0,0,0,5000,28000,-23000,-23000,2021-06-09
7312,033094,京元電元富0A購02,0,0,0,0,0,0,0,0,0,-23000,0,0,0,95000,118000,-23000,-23000,2021-06-09
7313,033142,和鑫元大0B購01,0,0,0,0,0,0,0,0,0,-23000,0,0,0,0,23000,-23000,-23000,2021-06-09
7314,033225,臻鼎元富12購01,0,0,0,0,0,0,0,0,0,-23000,0,0,0,27000,50000,-23000,-23000,2021-06-09
7315,034933,景碩永豐0B購01,0,0,0,0,0,0,0,0,0,-23000,0,0,0,2000,25000,-23000,-23000,2021-06-09
7316,034749,愛普元大0B購03,0,0,0,0,0,0,0,0,0,-23000,0,0,0,15000,38000,-23000,-23000,2021-06-09
7317,034648,大成鋼國泰11購01,0,0,0,0,0,0,0,0,0,-23000,0,0,0,0,23000,-23000,-23000,2021-06-09
7318,033955,欣興國票0C購03,0,0,0,0,0,0,0,0,0,-23000,0,0,0,156000,179000,-23000,-23000,2021-06-09
7319,033998,永冠群益0B購01,0,0,0,0,0,0,0,0,0,-23000,0,0,0,0,23000,-23000,-23000,2021-06-09
7320,079885,台積電元富08購33,0,0,0,0,0,0,0,0,0,-23000,0,0,0,20000,43000,-23000,-23000,2021-06-09
7321,082408,精成科凱基07購01,0,0,0,0,0,0,0,0,0,-23000,0,0,0,0,23000,-23000,-23000,2021-06-09
7322,07266P,聯發科凱基12售02,0,0,0,0,0,0,0,0,0,-23000,0,0,0,7000,30000,-23000,-23000,2021-06-09
7323,079022,聯電元大08購02,0,0,0,0,0,0,0,0,0,-23000,0,0,0,56000,79000,-23000,-23000,2021-06-09
7324,06832P,友達兆豐0A售04,0,0,0,0,0,0,0,0,0,-23000,0,0,0,0,23000,-23000,-23000,2021-06-09
7325,4526,東台,11000,34000,-23000,0,0,0,0,0,0,0,0,0,0,0,0,0,-23000,2021-06-09
7326,4119,旭富,21000,44000,-23000,0,0,0,0,0,0,0,0,0,0,0,0,0,-23000,2021-06-09
7327,3543,州巧,1000,24000,-23000,0,0,0,0,0,0,0,0,0,0,0,0,0,-23000,2021-06-09
7328,1541,錩泰,2000,22000,-20000,0,0,0,0,0,0,-3000,0,3000,-3000,0,0,0,-23000,2021-06-09
7329,1587,吉茂,40000,63000,-23000,0,0,0,0,0,0,0,0,0,0,0,0,0,-23000,2021-06-09
7330,089248,潤泰新永豐09購02,0,0,0,0,0,0,0,0,0,-23000,0,0,0,94000,117000,-23000,-23000,2021-06-09
7331,5203,訊連,11000,34000,-23000,0,0,0,0,0,0,-1,0,1,-1,0,0,0,-23001,2021-06-09
7332,085982,聯電元大0C購06,0,0,0,0,0,0,0,0,0,-24000,0,0,0,0,24000,-24000,-24000,2021-06-09
7333,084462,中興電凱基0B購02,0,0,0,0,0,0,0,0,0,-24000,0,0,0,2000,26000,-24000,-24000,2021-06-09
7334,084506,台積電元大08購06,0,0,0,0,0,0,0,0,0,-24000,0,0,0,60000,84000,-24000,-24000,2021-06-09
7335,083451,美利達凱基08購01,0,0,0,0,0,0,0,0,0,-24000,0,0,0,2000,26000,-24000,-24000,2021-06-09
7336,087167,南電永豐09購03,0,0,0,0,0,0,0,0,0,-24000,0,0,0,12000,36000,-24000,-24000,2021-06-09
7337,032298,中鋼永豐0A購06,0,0,0,0,0,0,0,0,0,-24000,0,0,0,100000,124000,-24000,-24000,2021-06-09
7338,031666,聯發科元大12購03,0,0,0,0,0,0,0,0,0,-24000,0,0,0,0,24000,-24000,-24000,2021-06-09
7339,031675,瀚宇博元大0A購01,0,0,0,0,0,0,0,0,0,-24000,0,0,0,0,24000,-24000,-24000,2021-06-09
7340,032236,滬深2X元大11購03,0,0,0,0,0,0,0,0,0,-24000,0,0,0,100000,124000,-24000,-24000,2021-06-09
7341,031498,台積電元大0A購11,0,0,0,0,0,0,0,0,0,-24000,0,0,0,0,24000,-24000,-24000,2021-06-09
7342,030339,台積電群益0C購07,0,0,0,0,0,0,0,0,0,-24000,0,0,0,34000,58000,-24000,-24000,2021-06-09
7343,030661,聯詠永豐0A購02,0,0,0,0,0,0,0,0,0,-24000,0,0,0,0,24000,-24000,-24000,2021-06-09
7344,034061,宏碁國票0C購01,0,0,0,0,0,0,0,0,0,-24000,0,0,0,0,24000,-24000,-24000,2021-06-09
7345,06519P,上銀元富09售03,0,0,0,0,0,0,0,0,0,-24000,0,0,0,6000,30000,-24000,-24000,2021-06-09
7346,07118P,長榮元大0B售09,0,0,0,0,0,0,0,0,0,-24000,0,0,0,187000,211000,-24000,-24000,2021-06-09
7347,06975P,友達元富0A售10,0,0,0,0,0,0,0,0,0,-24000,0,0,0,3000,27000,-24000,-24000,2021-06-09
7348,078721,台積電統一07購06,0,0,0,0,0,0,0,0,0,-24000,0,0,0,708000,732000,-24000,-24000,2021-06-09
7349,078122,嘉晶元富0C購01,0,0,0,0,0,0,0,0,0,-24000,0,0,0,34000,58000,-24000,-24000,2021-06-09
7350,081034,台塑富邦09購01,0,5000,-5000,0,0,0,0,0,0,-19000,0,0,0,5000,24000,-19000,-24000,2021-06-09
7351,4141,龍燈-KY,0,24000,-24000,0,0,0,0,0,0,0,0,0,0,0,0,0,-24000,2021-06-09
7352,2616,山隆,18000,42000,-24000,0,0,0,0,0,0,0,0,0,0,0,0,0,-24000,2021-06-09
7353,089481,聯發科富邦0A購04,0,0,0,0,0,0,0,0,0,-24000,0,0,0,145000,169000,-24000,-24000,2021-06-09
7354,6166,凌華,18000,42000,-24000,0,0,0,0,0,0,0,0,0,0,0,0,0,-24000,2021-06-09
7355,087077,京元電統一0B購01,0,0,0,0,0,0,0,0,0,-25000,0,0,0,51000,76000,-25000,-25000,2021-06-09
7356,087638,嘉晶凱基09購02,0,0,0,0,0,0,0,0,0,-25000,0,0,0,130000,155000,-25000,-25000,2021-06-09
7357,087935,中信金統一0B購01,0,0,0,0,0,0,0,0,0,-25000,0,0,0,2000,27000,-25000,-25000,2021-06-09
7358,088276,緯穎中信09購01,0,0,0,0,0,0,0,0,0,-25000,0,0,0,0,25000,-25000,-25000,2021-06-09
7359,088103,全新國票0A購01,0,0,0,0,0,0,0,0,0,-25000,0,0,0,0,25000,-25000,-25000,2021-06-09
7360,088490,A50正2元大0C購01,0,0,0,0,0,0,0,0,0,-25000,0,0,0,100000,125000,-25000,-25000,2021-06-09
7361,084003,南電永豐07購02,0,0,0,0,0,0,0,0,0,-25000,0,0,0,35000,60000,-25000,-25000,2021-06-09
7362,083891,台達電元大07購11,0,0,0,0,0,0,0,0,0,-25000,0,0,0,0,25000,-25000,-25000,2021-06-09
7363,084143,燿華永豐07購02,0,0,0,0,0,0,0,0,0,-25000,0,0,0,0,25000,-25000,-25000,2021-06-09
7364,084107,台灣50中信09購03,0,0,0,0,0,0,0,0,0,-25000,0,0,0,0,25000,-25000,-25000,2021-06-09
7365,084448,聯電永豐08購03,0,0,0,0,0,0,0,0,0,-25000,0,0,0,140000,165000,-25000,-25000,2021-06-09
7366,084449,仁寶永豐08購01,0,0,0,0,0,0,0,0,0,-25000,0,0,0,0,25000,-25000,-25000,2021-06-09
7367,085919,禾伸堂中信08購01,0,0,0,0,0,0,0,0,0,-25000,0,0,0,102000,127000,-25000,-25000,2021-06-09
7368,085363,松翰永豐08購01,0,0,0,0,0,0,0,0,0,-25000,0,0,0,0,25000,-25000,-25000,2021-06-09
7369,030367,揚明光群益11購01,0,0,0,0,0,0,0,0,0,-25000,0,0,0,0,25000,-25000,-25000,2021-06-09
7370,032279,大立光富邦13購01,0,0,0,0,0,0,0,0,0,-25000,0,0,0,300000,325000,-25000,-25000,2021-06-09
7371,033514,聯電日盛11購01,0,0,0,0,0,0,0,0,0,-25000,0,0,0,0,25000,-25000,-25000,2021-06-09
7372,033417,凌陽永豐0B購01,0,0,0,0,0,0,0,0,0,-25000,0,0,0,0,25000,-25000,-25000,2021-06-09
7373,031855,順德中信0A購01,0,0,0,0,0,0,0,0,0,-25000,0,0,0,315000,340000,-25000,-25000,2021-06-09
7374,032427,台積電元大0B購06,0,0,0,0,0,0,0,0,0,-25000,0,0,0,0,25000,-25000,-25000,2021-06-09
7375,032381,大成鋼統一12購01,0,0,0,0,0,0,0,0,0,-25000,0,0,0,0,25000,-25000,-25000,2021-06-09
7376,033594,亞德客兆豐0C購01,0,0,0,0,0,0,0,0,0,-25000,0,0,0,0,25000,-25000,-25000,2021-06-09
7377,034047,大立光元富15購01,0,0,0,0,0,0,0,0,0,-25000,0,0,0,0,25000,-25000,-25000,2021-06-09
7378,06017P,電子類群益07售02,0,0,0,0,0,0,0,0,0,-25000,0,0,0,5000,30000,-25000,-25000,2021-06-09
7379,034014,中鋼統一0B購01,0,0,0,0,0,0,0,0,0,-25000,0,0,0,0,25000,-25000,-25000,2021-06-09
7380,033939,臺股指元大0B購19,0,0,0,0,0,0,0,0,0,-25000,0,0,0,0,25000,-25000,-25000,2021-06-09
7381,081175,創意永豐07購01,0,0,0,0,0,0,0,0,0,-25000,0,0,0,0,25000,-25000,-25000,2021-06-09
7382,081280,旺宏統一08購02,0,0,0,0,0,0,0,0,0,-25000,0,0,0,0,25000,-25000,-25000,2021-06-09
7383,081287,創意統一09購02,0,0,0,0,0,0,0,0,0,-25000,0,0,0,60000,85000,-25000,-25000,2021-06-09
7384,079995,健策元富07購01,0,0,0,0,0,0,0,0,0,-25000,0,0,0,0,25000,-25000,-25000,2021-06-09
7385,082856,臺股指國票0B購05,0,0,0,0,0,0,0,0,0,-25000,0,0,0,0,25000,-25000,-25000,2021-06-09
7386,078825,瑞昱國票08購01,0,0,0,0,0,0,0,0,0,-25000,0,0,0,0,25000,-25000,-25000,2021-06-09
7387,07273P,臺股指群益0C售02,0,0,0,0,0,0,0,0,0,-25000,0,0,0,1000,26000,-25000,-25000,2021-06-09
7388,074503,精成科元富08購02,0,0,0,0,0,0,0,0,0,-25000,0,0,0,3000,28000,-25000,-25000,2021-06-09
7389,06936P,群創元富0A售15,0,0,0,0,0,0,0,0,0,-25000,0,0,0,2000,27000,-25000,-25000,2021-06-09
7390,07005P,偉詮電群益0B售01,0,0,0,0,0,0,0,0,0,-25000,0,0,0,62000,87000,-25000,-25000,2021-06-09
7391,06928P,臺股指元大0C售09,0,0,0,0,0,0,0,0,0,-25000,0,0,0,100000,125000,-25000,-25000,2021-06-09
7392,07063P,臺股指國票0B售17,0,0,0,0,0,0,0,0,0,-25000,0,0,0,0,25000,-25000,-25000,2021-06-09
7393,06476P,聯發科中信09售04,0,0,0,0,0,0,0,0,0,-25000,0,0,0,0,25000,-25000,-25000,2021-06-09
7394,06836P,臺股指麥證0C售05,0,0,0,14000,39000,-25000,0,0,0,-25000,0,0,0,14000,39000,-25000,-25000,2021-06-09
7395,06744P,台灣50元大0A售14,0,0,0,0,0,0,0,0,0,-25000,0,0,0,0,25000,-25000,-25000,2021-06-09
7396,8033,雷虎,51000,76000,-25000,0,0,0,0,0,0,0,0,0,0,0,0,0,-25000,2021-06-09
7397,089186,台積電凱基13購04,0,0,0,0,0,0,0,0,0,-25000,0,0,0,5000,30000,-25000,-25000,2021-06-09
7398,089851,華立元大09購02,0,0,0,0,0,0,0,0,0,-25000,0,0,0,0,25000,-25000,-25000,2021-06-09
7399,2488,漢平,6000,31000,-25000,0,0,0,0,0,0,0,0,0,0,0,0,0,-25000,2021-06-09
7400,2428,興勤,200000,235000,-35000,0,0,0,0,0,0,10000,28000,18000,10000,2000,2000,0,-25000,2021-06-09
7401,085889,光罩國票09購01,0,0,0,0,0,0,0,0,0,-26000,0,0,0,0,26000,-26000,-26000,2021-06-09
7402,084814,華晶科永豐08購04,0,0,0,0,0,0,0,0,0,-26000,0,0,0,10000,36000,-26000,-26000,2021-06-09
7403,084869,奇鋐元大08購02,0,0,0,0,0,0,0,0,0,-26000,0,0,0,30000,56000,-26000,-26000,2021-06-09
7404,088901,臺股指凱基0C購17,0,0,0,0,0,0,0,0,0,-26000,0,0,0,210000,236000,-26000,-26000,2021-06-09
7405,087196,瑞昱麥證09購01,0,0,0,0,26000,-26000,0,0,0,-26000,0,0,0,0,26000,-26000,-26000,2021-06-09
7406,086465,微星兆豐09購01,0,0,0,0,0,0,0,0,0,-26000,0,0,0,0,26000,-26000,-26000,2021-06-09
7407,030321,英業達麥證0C購01,0,0,0,4000,30000,-26000,0,0,0,-26000,0,0,0,4000,30000,-26000,-26000,2021-06-09
7408,031276,國光生統一0C購01,0,0,0,0,0,0,0,0,0,-26000,0,0,0,28000,54000,-26000,-26000,2021-06-09
7409,032746,華晶科凱基0C購01,0,0,0,0,0,0,0,0,0,-26000,0,0,0,0,26000,-26000,-26000,2021-06-09
7410,036008,台達電凱基11購01,0,0,0,0,0,0,0,0,0,-26000,0,0,0,0,26000,-26000,-26000,2021-06-09
7411,035291,萬海國票11購02,0,0,0,0,0,0,0,0,0,-26000,0,0,0,94000,120000,-26000,-26000,2021-06-09
7412,035292,聯詠國票0B購05,0,0,0,0,0,0,0,0,0,-26000,0,0,0,44000,70000,-26000,-26000,2021-06-09
7413,034783,台達電國泰11購01,0,0,0,0,0,0,0,0,0,-26000,0,0,0,0,26000,-26000,-26000,2021-06-09
7414,034404,大成鋼國票0C購03,0,0,0,0,0,0,0,0,0,-26000,0,0,0,0,26000,-26000,-26000,2021-06-09
7415,034678,愛普凱基0B購01,0,0,0,0,0,0,0,0,0,-26000,0,0,0,12000,38000,-26000,-26000,2021-06-09
7416,06473P,南電元大09售07,0,0,0,0,0,0,0,0,0,-26000,0,0,0,0,26000,-26000,-26000,2021-06-09
7417,078353,臺股指凱基0C購01,0,0,0,0,0,0,0,0,0,-26000,0,0,0,11000,37000,-26000,-26000,2021-06-09
7418,082964,台達電元大07購07,0,0,0,0,0,0,0,0,0,-26000,0,0,0,0,26000,-26000,-26000,2021-06-09
7419,082239,聯發科凱基09購02,0,0,0,0,0,0,0,0,0,-26000,0,0,0,0,26000,-26000,-26000,2021-06-09
7420,4571,鈞興-KY,27000,52000,-25000,0,0,0,0,0,0,-1000,0,1000,-1000,0,0,0,-26000,2021-06-09
7421,3011,今皓,0,26000,-26000,0,0,0,0,0,0,0,0,0,0,0,0,0,-26000,2021-06-09
7422,1236,宏亞,1000,27000,-26000,0,0,0,0,0,0,0,0,0,0,0,0,0,-26000,2021-06-09
7423,089462,國喬國票0A購03,0,0,0,0,0,0,0,0,0,-26000,0,0,0,17000,43000,-26000,-26000,2021-06-09
7424,4999,鑫禾,65000,91920,-26920,0,0,0,0,0,0,0,0,0,0,0,0,0,-26920,2021-06-09
7425,1445,大宇,5000,32000,-27000,0,0,0,0,0,0,1,1,0,1,0,0,0,-26999,2021-06-09
7426,086636,聯發科凱基09購06,0,0,0,0,0,0,0,0,0,-27000,0,0,0,60000,87000,-27000,-27000,2021-06-09
7427,086832,聯發科元大09購04,0,0,0,0,0,0,0,0,0,-27000,0,0,0,128000,155000,-27000,-27000,2021-06-09
7428,087347,貿聯凱基0B購01,0,0,0,0,0,0,0,0,0,-27000,0,0,0,10000,37000,-27000,-27000,2021-06-09
7429,087332,台灣50凱基0A購02,0,0,0,0,0,0,0,0,0,-27000,0,0,0,8000,35000,-27000,-27000,2021-06-09
7430,032740,廣宇凱基0B購02,0,0,0,0,0,0,0,0,0,-27000,0,0,0,0,27000,-27000,-27000,2021-06-09
7431,033499,王品統一0C購02,0,0,0,0,0,0,0,0,0,-27000,0,0,0,220000,247000,-27000,-27000,2021-06-09
7432,034789,健策國泰11購02,0,0,0,0,0,0,0,0,0,-27000,0,0,0,401000,428000,-27000,-27000,2021-06-09
7433,06189P,台灣50凱基09售02,0,0,0,0,0,0,0,0,0,-27000,0,0,0,3000,30000,-27000,-27000,2021-06-09
7434,05991P,同欣電元富08售03,0,0,0,0,0,0,0,0,0,-27000,0,0,0,0,27000,-27000,-27000,2021-06-09
7435,03737C,T50正2富邦0C牛01,0,0,0,0,0,0,0,0,0,-27000,0,0,0,0,27000,-27000,-27000,2021-06-09
7436,07252P,南電元富0B售02,0,0,0,0,0,0,0,0,0,-27000,0,0,0,5000,32000,-27000,-27000,2021-06-09
7437,06492P,鴻海凱基09售09,0,0,0,0,0,0,0,0,0,-27000,0,0,0,161000,188000,-27000,-27000,2021-06-09
7438,06730P,台灣50群益09售12,0,0,0,0,0,0,0,0,0,-27000,0,0,0,112000,139000,-27000,-27000,2021-06-09
7439,06696P,南亞科群益09售04,0,0,0,0,0,0,0,0,0,-27000,0,0,0,0,27000,-27000,-27000,2021-06-09
7440,06849P,友達元富0A售03,0,0,0,0,0,0,0,0,0,-27000,0,0,0,15000,42000,-27000,-27000,2021-06-09
7441,089939,景碩永豐0A購01,0,0,0,0,0,0,0,0,0,-27000,0,0,0,1000,28000,-27000,-27000,2021-06-09
7442,089543,臺股指元大09購23,0,0,0,0,0,0,0,0,0,-27000,0,0,0,0,27000,-27000,-27000,2021-06-09
7443,2545,皇翔,56000,83000,-27000,0,0,0,0,0,0,0,0,0,0,0,0,0,-27000,2021-06-09
7444,2114,鑫永銓,9000,36000,-27000,0,0,0,0,0,0,0,0,0,0,0,0,0,-27000,2021-06-09
7445,8104,錸寶,10000,37000,-27000,0,0,0,0,0,0,0,0,0,0,0,0,0,-27000,2021-06-09
7446,5434,崇越,209000,400064,-191064,0,0,0,147000,0,147000,17000,20000,0,20000,0,3000,-3000,-27064,2021-06-09
7447,087024,T50正2中信0B購03,0,0,0,0,0,0,0,0,0,-28000,0,0,0,2000,30000,-28000,-28000,2021-06-09
7448,086589,華碩國票0A購01,0,0,0,0,0,0,0,0,0,-28000,0,0,0,62000,90000,-28000,-28000,2021-06-09
7449,088099,光磊國票0A購01,0,0,0,0,0,0,0,0,0,-28000,0,0,0,0,28000,-28000,-28000,2021-06-09
7450,084708,智伸科統一0A購01,0,0,0,0,0,0,0,0,0,-28000,0,0,0,0,28000,-28000,-28000,2021-06-09
7451,084429,凌陽群益08購01,0,0,0,0,0,0,0,0,0,-28000,0,0,0,92000,120000,-28000,-28000,2021-06-09
7452,084278,聯電中信09購03,0,0,0,0,0,0,0,0,0,-28000,0,0,0,26000,54000,-28000,-28000,2021-06-09
7453,084481,宏碁凱基08購02,0,0,0,0,0,0,0,0,0,-28000,0,0,0,2000,30000,-28000,-28000,2021-06-09
7454,084044,緯穎元富0A購03,0,0,0,0,0,0,0,0,0,-28000,0,0,0,0,28000,-28000,-28000,2021-06-09
7455,085317,美利達元大08購02,0,0,0,0,0,0,0,0,0,-28000,0,0,0,155000,183000,-28000,-28000,2021-06-09
7456,085166,景碩凱基09購01,0,0,0,0,0,0,0,0,0,-28000,0,0,0,22000,50000,-28000,-28000,2021-06-09
7457,085039,瑞昱元富0B購01,0,0,0,0,0,0,0,0,0,-28000,0,0,0,0,28000,-28000,-28000,2021-06-09
7458,085536,華邦電永豐08購01,0,0,0,0,0,0,0,0,0,-28000,0,0,0,46000,74000,-28000,-28000,2021-06-09
7459,031840,燿華兆豐0B購01,0,0,0,0,0,0,0,0,0,-28000,0,0,0,38000,66000,-28000,-28000,2021-06-09
7460,031940,南亞元大0B購01,0,0,0,0,0,0,0,0,0,-28000,0,0,0,122000,150000,-28000,-28000,2021-06-09
7461,035036,南亞科麥證11購01,0,0,0,10000,38000,-28000,0,0,0,-28000,0,0,0,10000,38000,-28000,-28000,2021-06-09
7462,033981,合勤控凱基0B購01,0,0,0,0,0,0,0,0,0,-28000,0,0,0,0,28000,-28000,-28000,2021-06-09
7463,034872,美德醫元大0C購01,0,0,0,0,0,0,0,0,0,-28000,0,0,0,99000,127000,-28000,-28000,2021-06-09
7464,034918,國巨麥證0B購02,0,0,0,60000,44000,16000,0,0,0,-28000,0,0,0,66000,94000,-28000,-28000,2021-06-09
7465,034903,力麗元大0B購04,0,0,0,0,0,0,0,0,0,-28000,0,0,0,50000,78000,-28000,-28000,2021-06-09
7466,06909P,中鋼群益0A售04,0,0,0,0,0,0,0,0,0,-28000,0,0,0,31000,59000,-28000,-28000,2021-06-09
7467,06954P,大亞國票0A售02,0,0,0,0,0,0,0,0,0,-28000,0,0,0,0,28000,-28000,-28000,2021-06-09
7468,06814P,群創群益0B售09,0,0,0,0,0,0,0,0,0,-28000,0,0,0,14000,42000,-28000,-28000,2021-06-09
7469,082897,惠特永豐07購01,0,0,0,0,0,0,0,0,0,-28000,0,0,0,19000,47000,-28000,-28000,2021-06-09
7470,083109,欣興元大08購03,0,0,0,0,0,0,0,0,0,-28000,0,0,0,514000,542000,-28000,-28000,2021-06-09
7471,3003,健和興,726000,523000,203000,0,0,0,0,0,0,-231000,0,145000,-145000,0,86000,-86000,-28000,2021-06-09
7472,1558,伸興,36000,64000,-28000,0,0,0,0,0,0,0,0,0,0,0,0,0,-28000,2021-06-09
7473,085673,南電統一0A購04,0,0,0,0,0,0,0,0,0,-29000,0,0,0,0,29000,-29000,-29000,2021-06-09
7474,085190,台灣50群益09購06,0,0,0,0,0,0,0,0,0,-29000,0,0,0,55000,84000,-29000,-29000,2021-06-09
7475,084646,滬深2X群益09購01,0,0,0,0,0,0,0,0,0,-29000,0,0,0,1000,30000,-29000,-29000,2021-06-09
7476,088530,惠特國泰0B購01,0,0,0,0,0,0,0,0,0,-29000,0,0,0,243000,272000,-29000,-29000,2021-06-09
7477,087348,精成科凱基09購01,0,0,0,0,0,0,0,0,0,-29000,0,0,0,0,29000,-29000,-29000,2021-06-09
7478,089055,偉詮電永豐09購02,0,0,0,0,0,0,0,0,0,-29000,0,0,0,4000,33000,-29000,-29000,2021-06-09
7479,036304,群創元大13購01,0,0,0,0,0,0,0,0,0,-29000,0,0,0,1000,30000,-29000,-29000,2021-06-09
7480,031836,儒鴻兆豐0C購01,0,0,0,0,0,0,0,0,0,-29000,0,0,0,0,29000,-29000,-29000,2021-06-09
7481,05943P,臺股指凱基07售21,0,0,0,0,0,0,0,0,0,-29000,0,0,0,1000,30000,-29000,-29000,2021-06-09
7482,034675,聯詠凱基0B購05,0,0,0,0,0,0,0,0,0,-29000,0,0,0,30000,59000,-29000,-29000,2021-06-09
7483,035627,和鑫國票0B購01,0,0,0,0,0,0,0,0,0,-29000,0,0,0,11000,40000,-29000,-29000,2021-06-09
7484,033990,南亞科兆豐12購01,0,0,0,0,0,0,0,0,0,-29000,0,0,0,0,29000,-29000,-29000,2021-06-09
7485,035784,裕民國泰12購01,0,0,0,0,0,0,0,0,0,-29000,0,0,0,23000,52000,-29000,-29000,2021-06-09
7486,036072,康控群益0C購01,0,0,0,0,0,0,0,0,0,-29000,0,0,0,76000,105000,-29000,-29000,2021-06-09
7487,036068,聯詠群益12購01,0,0,0,0,0,0,0,0,0,-29000,0,0,0,20000,49000,-29000,-29000,2021-06-09
7488,083072,台積電麥證0C購01,0,0,0,31000,60000,-29000,0,0,0,-29000,0,0,0,31000,60000,-29000,-29000,2021-06-09
7489,082940,台灣50元富07購02,0,0,0,0,0,0,0,0,0,-29000,0,0,0,31000,60000,-29000,-29000,2021-06-09
7490,06805P,聯電元大0A售06,0,0,0,0,0,0,0,0,0,-29000,0,0,0,0,29000,-29000,-29000,2021-06-09
7491,06719P,友達凱基09售12,0,0,0,0,0,0,0,0,0,-29000,0,0,0,2000,31000,-29000,-29000,2021-06-09
7492,089818,立積群益0B購02,0,0,0,0,0,0,0,0,0,-29000,0,0,0,473000,502000,-29000,-29000,2021-06-09
7493,089640,聯詠凱基0B購01,0,0,0,0,0,0,0,0,0,-29000,0,0,0,0,29000,-29000,-29000,2021-06-09
7494,2497,怡利電,70000,99000,-29000,0,0,0,0,0,0,0,0,0,0,0,0,0,-29000,2021-06-09
7495,5533,皇鼎,0,29000,-29000,0,0,0,0,0,0,0,0,0,0,0,0,0,-29000,2021-06-09
7496,6164,華興,20000,49000,-29000,0,0,0,0,0,0,0,0,0,0,0,0,0,-29000,2021-06-09
7497,089069,偉詮電凱基09購02,0,0,0,0,0,0,0,0,0,-30000,0,0,0,0,30000,-30000,-30000,2021-06-09
7498,087075,金像電統一0B購01,0,0,0,0,0,0,0,0,0,-30000,0,0,0,1000,31000,-30000,-30000,2021-06-09
7499,087540,晶豪科統一0B購04,0,0,0,0,0,0,0,0,0,-30000,0,0,0,0,30000,-30000,-30000,2021-06-09
7500,087533,同欣電凱基09購02,0,0,0,0,0,0,0,0,0,-30000,0,0,0,14000,44000,-30000,-30000,2021-06-09
7501,086731,亞德客中信0A購01,0,0,0,0,0,0,0,0,0,-30000,0,0,0,5000,35000,-30000,-30000,2021-06-09
7502,087045,技嘉凱基0A購01,0,0,0,0,0,0,0,0,0,-30000,0,0,0,20000,50000,-30000,-30000,2021-06-09
7503,086903,仁寶凱基09購01,0,0,0,0,0,0,0,0,0,-30000,0,0,0,0,30000,-30000,-30000,2021-06-09
7504,086779,臺股指凱基09購21,0,0,0,0,0,0,0,0,0,-30000,0,0,0,0,30000,-30000,-30000,2021-06-09
7505,088435,台積電凱基09購21,0,0,0,0,0,0,0,0,0,-30000,0,0,0,0,30000,-30000,-30000,2021-06-09
7506,088879,台泥凱基09購01,0,0,0,0,0,0,0,0,0,-30000,0,0,0,320000,350000,-30000,-30000,2021-06-09
7507,088954,聯電國票0B購02,0,0,0,0,0,0,0,0,0,-30000,0,0,0,11000,41000,-30000,-30000,2021-06-09
7508,088287,聯電日盛09購02,0,0,0,0,0,0,0,0,0,-30000,0,0,0,0,30000,-30000,-30000,2021-06-09
7509,087905,儒鴻群益09購01,0,0,0,0,0,0,0,0,0,-30000,0,0,0,102000,132000,-30000,-30000,2021-06-09
7510,084276,致新國票08購02,0,0,0,0,0,0,0,0,0,-30000,0,0,0,30000,60000,-30000,-30000,2021-06-09
7511,084687,裕隆統一0A購01,0,0,0,0,0,0,0,0,0,-30000,0,0,0,0,30000,-30000,-30000,2021-06-09
7512,084770,鴻海凱基09購08,0,0,0,0,0,0,0,0,0,-30000,0,0,0,20000,50000,-30000,-30000,2021-06-09
7513,084166,台積電凱基09購08,0,0,0,0,0,0,0,0,0,-30000,0,0,0,0,30000,-30000,-30000,2021-06-09
7514,084013,台積電統一09購14,0,0,0,0,0,0,0,0,0,-30000,0,0,0,0,30000,-30000,-30000,2021-06-09
7515,083991,致新群益07購01,0,0,0,0,0,0,0,0,0,-30000,0,0,0,0,30000,-30000,-30000,2021-06-09
7516,083954,瑞昱凱基09購01,0,0,0,0,0,0,0,0,0,-30000,0,0,0,10000,40000,-30000,-30000,2021-06-09
7517,085162,大立光凱基0A購03,0,0,0,0,0,0,0,0,0,-30000,0,0,0,20000,50000,-30000,-30000,2021-06-09
7518,085351,聯發科永豐09購02,0,0,0,0,0,0,0,0,0,-30000,0,0,0,20000,50000,-30000,-30000,2021-06-09
7519,085742,矽格兆豐08購01,0,0,0,0,0,0,0,0,0,-30000,0,0,0,0,30000,-30000,-30000,2021-06-09
7520,086110,泰鼎兆豐08購01,0,0,0,0,0,0,0,0,0,-30000,0,0,0,0,30000,-30000,-30000,2021-06-09
7521,033569,南電永豐0B購01,0,0,0,0,0,0,0,0,0,-30000,0,0,0,144000,174000,-30000,-30000,2021-06-09
7522,033374,力麗元大11購01,0,0,0,0,0,0,0,0,0,-30000,0,0,0,0,30000,-30000,-30000,2021-06-09
7523,033140,健和興元大0C購01,0,0,0,0,0,0,0,0,0,-30000,0,0,0,20000,50000,-30000,-30000,2021-06-09
7524,032622,臺股指元大0C購06,0,0,0,0,0,0,0,0,0,-30000,0,0,0,0,30000,-30000,-30000,2021-06-09
7525,032610,群創元大0A購17,0,0,0,0,0,0,0,0,0,-30000,0,0,0,1098000,1128000,-30000,-30000,2021-06-09
7526,031961,華邦電元大0A購10,0,0,0,0,0,0,0,0,0,-30000,0,0,0,0,30000,-30000,-30000,2021-06-09
7527,031994,台積電群益11購02,0,0,0,0,0,0,0,0,0,-30000,0,0,0,0,30000,-30000,-30000,2021-06-09
7528,031912,技嘉永豐0A購01,0,0,0,0,0,0,0,0,0,-30000,0,0,0,0,30000,-30000,-30000,2021-06-09
7529,032731,中石化凱基0A購03,0,0,0,0,0,0,0,0,0,-30000,0,0,0,0,30000,-30000,-30000,2021-06-09
7530,032662,群創麥證0A購02,0,0,0,0,30000,-30000,0,0,0,-30000,0,0,0,0,30000,-30000,-30000,2021-06-09
7531,033193,聯發科凱基15購01,0,0,0,0,0,0,0,0,0,-30000,0,0,0,0,30000,-30000,-30000,2021-06-09
7532,031095,台積電群益12購01,0,0,0,0,0,0,0,0,0,-30000,0,0,0,0,30000,-30000,-30000,2021-06-09
7533,031085,臺股指元大11購09,0,0,0,0,0,0,0,0,0,-30000,0,0,0,0,30000,-30000,-30000,2021-06-09
7534,030772,台積電麥證11購03,0,0,0,0,30000,-30000,0,0,0,-30000,0,0,0,0,30000,-30000,-30000,2021-06-09
7535,031598,晶技國票0B購01,0,0,0,0,0,0,0,0,0,-30000,0,0,0,0,30000,-30000,-30000,2021-06-09
7536,030585,聚鼎康和0A購01,0,0,0,0,0,0,0,0,0,-30000,0,0,0,100000,130000,-30000,-30000,2021-06-09
7537,031001,友達麥證0A購03,0,0,0,0,30000,-30000,0,0,0,-30000,0,0,0,0,30000,-30000,-30000,2021-06-09
7538,030169,益登國泰0C購01,0,0,0,0,0,0,0,0,0,-30000,0,0,0,0,30000,-30000,-30000,2021-06-09
7539,030225,聯德凱基0C購01,0,0,0,0,0,0,0,0,0,-30000,0,0,0,0,30000,-30000,-30000,2021-06-09
7540,035418,東鋼元大0B購05,0,0,0,0,0,0,0,0,0,-30000,0,0,0,0,30000,-30000,-30000,2021-06-09
7541,04874P,臺股指中信09售04,0,0,0,0,0,0,0,0,0,-30000,0,0,0,0,30000,-30000,-30000,2021-06-09
7542,03783P,玉晶光元富09售01,0,0,0,0,0,0,0,0,0,-30000,0,0,0,1000,31000,-30000,-30000,2021-06-09
7543,035241,上銀群益0B購01,0,0,0,0,0,0,0,0,0,-30000,0,0,0,20000,50000,-30000,-30000,2021-06-09
7544,035256,允強凱基11購01,0,0,0,0,0,0,0,0,0,-30000,0,0,0,5000,35000,-30000,-30000,2021-06-09
7545,033926,台積電元大0B購08,0,0,0,0,0,0,0,0,0,-30000,0,0,0,5000,35000,-30000,-30000,2021-06-09
7546,036098,新唐元大0C購03,0,0,0,0,0,0,0,0,0,-30000,0,0,0,0,30000,-30000,-30000,2021-06-09
7547,035699,亞聚元大0B購04,0,0,0,0,0,0,0,0,0,-30000,0,0,0,50000,80000,-30000,-30000,2021-06-09
7548,035715,友達元大0B購16,0,0,0,0,0,0,0,0,0,-30000,0,0,0,0,30000,-30000,-30000,2021-06-09
7549,034863,群創元大0B購13,0,0,0,0,0,0,0,0,0,-30000,0,0,0,12000,42000,-30000,-30000,2021-06-09
7550,034655,國泰金中信0B購01,0,0,0,0,0,0,0,0,0,-30000,0,0,0,20000,50000,-30000,-30000,2021-06-09
7551,034510,新光金凱基0B購02,0,0,0,0,0,0,0,0,0,-30000,0,0,0,0,30000,-30000,-30000,2021-06-09
7552,034372,大亞元大0B購05,0,0,0,0,0,0,0,0,0,-30000,0,0,0,0,30000,-30000,-30000,2021-06-09
7553,034151,亞光凱基0B購02,0,0,0,0,0,0,0,0,0,-30000,0,0,0,0,30000,-30000,-30000,2021-06-09
7554,05889P,欣興元大07售07,0,0,0,0,0,0,0,0,0,-30000,0,0,0,3000,33000,-30000,-30000,2021-06-09
7555,06117P,台灣50富邦07售02,0,0,0,0,0,0,0,0,0,-30000,0,0,0,0,30000,-30000,-30000,2021-06-09
7556,06181P,台灣50台新08售02,0,0,0,0,0,0,0,0,0,-30000,0,0,0,0,30000,-30000,-30000,2021-06-09
7557,034913,臺股指元大0B購27,0,0,0,0,0,0,0,0,0,-30000,0,0,0,0,30000,-30000,-30000,2021-06-09
7558,033622,台積電元富12購08,0,0,0,0,0,0,0,0,0,-30000,0,0,0,0,30000,-30000,-30000,2021-06-09
7559,034941,萬海群益0B購06,0,0,0,0,0,0,0,0,0,-30000,0,0,0,0,30000,-30000,-30000,2021-06-09
7560,035565,愛普統一14購02,0,0,0,0,0,0,0,0,0,-30000,0,0,0,0,30000,-30000,-30000,2021-06-09
7561,033762,億光凱基0C購01,0,0,0,0,0,0,0,0,0,-30000,0,0,0,88000,118000,-30000,-30000,2021-06-09
7562,06663P,立積元富09售07,0,0,0,0,0,0,0,0,0,-30000,0,0,0,0,30000,-30000,-30000,2021-06-09
7563,06839P,台灣50元大11售01,0,0,0,0,0,0,0,0,0,-30000,0,0,0,0,30000,-30000,-30000,2021-06-09
7564,06458P,強茂中信09售01,0,0,0,0,0,0,0,0,0,-30000,0,0,0,0,30000,-30000,-30000,2021-06-09
7565,06502P,聯詠元大09售03,0,0,0,0,0,0,0,0,0,-30000,0,0,0,99000,129000,-30000,-30000,2021-06-09
7566,06601P,A50正2元富09售04,0,0,0,0,0,0,0,0,0,-30000,0,0,0,20000,50000,-30000,-30000,2021-06-09
7567,06594P,臺股指國票0A售14,0,0,0,0,0,0,0,0,0,-30000,0,0,0,0,30000,-30000,-30000,2021-06-09
7568,06968P,南亞科群益0A售04,0,0,0,0,0,0,0,0,0,-30000,0,0,0,0,30000,-30000,-30000,2021-06-09
7569,07042P,道瓊2X中信0B售02,0,0,0,0,0,0,0,0,0,-30000,0,0,0,0,30000,-30000,-30000,2021-06-09
7570,07219P,台積電元大0C售13,0,0,0,0,0,0,0,0,0,-30000,0,0,0,0,30000,-30000,-30000,2021-06-09
7571,078750,台積電國票08購06,0,0,0,0,0,0,0,0,0,-30000,0,0,0,0,30000,-30000,-30000,2021-06-09
7572,082863,鴻海中信09購04,0,0,0,0,0,0,0,0,0,-30000,0,0,0,0,30000,-30000,-30000,2021-06-09
7573,083127,台積電凱基08購10,0,0,0,0,0,0,0,0,0,-30000,0,0,0,0,30000,-30000,-30000,2021-06-09
7574,082568,富邦金統一09購01,0,0,0,0,0,0,0,0,0,-30000,0,0,0,10000,40000,-30000,-30000,2021-06-09
7575,082602,凌陽元大07購02,0,0,0,0,0,0,0,0,0,-30000,0,0,0,0,30000,-30000,-30000,2021-06-09
7576,081508,聚鼎凱基07購01,0,0,0,0,0,0,0,0,0,-30000,0,0,0,10000,40000,-30000,-30000,2021-06-09
7577,079665,台積電元大07購06,0,0,0,0,0,0,0,0,0,-30000,0,0,0,0,30000,-30000,-30000,2021-06-09
7578,080656,聯詠元大06購07,0,0,0,0,0,0,0,0,0,-30000,0,0,0,0,30000,-30000,-30000,2021-06-09
7579,083322,鈺齊元大07購01,0,0,0,0,0,0,0,0,0,-30000,0,0,0,0,30000,-30000,-30000,2021-06-09
7580,089524,正文元大09購01,0,0,0,0,0,0,0,0,0,-30000,0,0,0,0,30000,-30000,-30000,2021-06-09
7581,089117,上証2X富邦0A購01,0,0,0,0,0,0,0,0,0,-30000,0,0,0,0,30000,-30000,-30000,2021-06-09
7582,089163,台積電中信0A購07,0,0,0,0,0,0,0,0,0,-30000,0,0,0,0,30000,-30000,-30000,2021-06-09
7583,089350,宏碁元大09購05,0,0,0,0,0,0,0,0,0,-30000,0,0,0,30000,60000,-30000,-30000,2021-06-09
7584,089771,仁寶凱基0B購01,0,0,0,0,0,0,0,0,0,-30000,0,0,0,0,30000,-30000,-30000,2021-06-09
7585,089758,巨大統一0B購01,0,0,0,0,0,0,0,0,0,-30000,0,0,0,0,30000,-30000,-30000,2021-06-09
7586,089927,聯電永豐0A購01,0,0,0,0,0,0,0,0,0,-30000,0,0,0,186000,216000,-30000,-30000,2021-06-09
7587,089986,立積元大0A購02,0,0,0,0,0,0,0,0,0,-30000,0,0,0,20000,50000,-30000,-30000,2021-06-09
7588,083851,大立光群益08購03,0,0,0,0,0,0,0,0,0,-31000,0,0,0,0,31000,-31000,-31000,2021-06-09
7589,084733,台積電元大09購08,0,0,0,0,0,0,0,0,0,-31000,0,0,0,0,31000,-31000,-31000,2021-06-09
7590,030010,聯發科元富0A購09,0,0,0,0,0,0,0,0,0,-31000,0,0,0,0,31000,-31000,-31000,2021-06-09
7591,00674R,期元大S&P黃金反1,0,0,0,0,0,0,0,0,0,-31000,0,0,0,2000,33000,-31000,-31000,2021-06-09
7592,030685,聯發科兆豐0A購01,0,0,0,0,0,0,0,0,0,-31000,0,0,0,0,31000,-31000,-31000,2021-06-09
7593,031933,宏達電元富0A購01,0,0,0,0,0,0,0,0,0,-31000,0,0,0,0,31000,-31000,-31000,2021-06-09
7594,036301,欣興元大0C購04,0,0,0,0,0,0,0,0,0,-31000,0,0,0,97000,128000,-31000,-31000,2021-06-09
7595,033038,光罩兆豐0B購02,0,0,0,0,0,0,0,0,0,-31000,0,0,0,437000,468000,-31000,-31000,2021-06-09
7596,035559,群創統一0B購18,0,0,0,0,0,0,0,0,0,-31000,0,0,0,0,31000,-31000,-31000,2021-06-09
7597,034797,T50正2凱基0C購03,0,0,0,0,0,0,0,0,0,-31000,0,0,0,23000,54000,-31000,-31000,2021-06-09
7598,035589,允強元大0B購03,0,0,0,0,0,0,0,0,0,-31000,0,0,0,5000,36000,-31000,-31000,2021-06-09
7599,035712,智邦元大13購01,0,0,0,0,0,0,0,0,0,-31000,0,0,0,15000,46000,-31000,-31000,2021-06-09
7600,05709P,華邦電元大07售10,0,0,0,0,0,0,0,0,0,-31000,0,0,0,9000,40000,-31000,-31000,2021-06-09
7601,080708,漢翔凱基09購01,0,0,0,0,0,0,0,0,0,-31000,0,0,0,0,31000,-31000,-31000,2021-06-09
7602,082288,聯發科元大07購19,0,0,0,0,0,0,0,0,0,-31000,0,0,0,0,31000,-31000,-31000,2021-06-09
7603,082880,南電兆豐07購02,0,0,0,0,0,0,0,0,0,-31000,0,0,0,10000,41000,-31000,-31000,2021-06-09
7604,078900,立積元大09購01,0,0,0,0,0,0,0,0,0,-31000,0,0,0,19000,50000,-31000,-31000,2021-06-09
7605,07083P,國巨國泰11售02,0,0,0,0,0,0,0,0,0,-31000,0,0,0,0,31000,-31000,-31000,2021-06-09
7606,06901P,大成鋼元大0A售08,0,0,0,0,0,0,0,0,0,-31000,0,0,0,16000,47000,-31000,-31000,2021-06-09
7607,089142,健和興元大09購01,0,0,0,0,0,0,0,0,0,-31000,0,0,0,48000,79000,-31000,-31000,2021-06-09
7608,5288,豐祥-KY,13000,44000,-31000,0,0,0,0,0,0,0,0,0,0,0,0,0,-31000,2021-06-09
7609,8367,建新國際,120000,151000,-31000,0,0,0,0,0,0,0,0,0,0,0,0,0,-31000,2021-06-09
7610,8473,山林水,3000,34000,-31000,0,0,0,0,0,0,0,0,0,0,0,0,0,-31000,2021-06-09
7611,085037,台積電元富12購02,0,0,0,0,0,0,0,0,0,-32000,0,0,0,0,32000,-32000,-32000,2021-06-09
7612,083742,聯發科國票09購03,0,0,0,0,0,0,0,0,0,-32000,0,0,0,2000,34000,-32000,-32000,2021-06-09
7613,086337,友達元大09購05,0,0,0,0,0,0,0,0,0,-32000,0,0,0,828000,860000,-32000,-32000,2021-06-09
7614,088297,聯陽麥證0B購01,0,0,0,195000,227000,-32000,0,0,0,-32000,0,0,0,195000,227000,-32000,-32000,2021-06-09
7615,087112,聯發科元大09購07,0,0,0,0,0,0,0,0,0,-32000,0,0,0,151000,183000,-32000,-32000,2021-06-09
7616,032960,聯電元大0A購16,0,0,0,0,0,0,0,0,0,-32000,0,0,0,17000,49000,-32000,-32000,2021-06-09
7617,032859,南亞科群益0A購03,0,0,0,0,0,0,0,0,0,-32000,0,0,0,96000,128000,-32000,-32000,2021-06-09
7618,032346,欣陸群益0A購01,0,0,0,0,0,0,0,0,0,-32000,0,0,0,0,32000,-32000,-32000,2021-06-09
7619,031762,大成鋼元富0A購02,0,0,0,0,0,0,0,0,0,-32000,0,0,0,51000,83000,-32000,-32000,2021-06-09
7620,030889,台灣50凱基0C購05,0,0,0,0,0,0,0,0,0,-32000,0,0,0,1000,33000,-32000,-32000,2021-06-09
7621,031596,聯電國票0A購04,0,0,0,0,0,0,0,0,0,-32000,0,0,0,80000,112000,-32000,-32000,2021-06-09
7622,035255,中鋼凱基11購04,0,0,0,0,0,0,0,0,0,-32000,0,0,0,0,32000,-32000,-32000,2021-06-09
7623,035102,旺宏元大0C購03,0,0,0,0,0,0,0,0,0,-32000,0,0,0,33000,65000,-32000,-32000,2021-06-09
7624,035113,國巨兆豐12購01,0,0,0,0,0,0,0,0,0,-32000,0,0,0,0,32000,-32000,-32000,2021-06-09
7625,035655,新光鋼國泰12購01,0,0,0,0,0,0,0,0,0,-32000,0,0,0,24000,56000,-32000,-32000,2021-06-09
7626,033899,友達統一0B購06,0,0,0,0,0,0,0,0,0,-32000,0,0,0,23000,55000,-32000,-32000,2021-06-09
7627,034998,聯電元大0B購04,0,0,0,0,0,0,0,0,0,-32000,0,0,0,51000,83000,-32000,-32000,2021-06-09
7628,034029,永豐餘元富0B購01,0,0,0,0,0,0,0,0,0,-32000,0,0,0,30000,62000,-32000,-32000,2021-06-09
7629,034384,國巨元大0B購10,0,0,0,0,0,0,0,0,0,-32000,0,0,0,53000,85000,-32000,-32000,2021-06-09
7630,06898P,中石化元大0A售06,0,0,0,0,0,0,0,0,0,-32000,0,0,0,17000,49000,-32000,-32000,2021-06-09
7631,06715P,南電中信0B售01,0,0,0,0,0,0,0,0,0,-32000,0,0,0,254000,286000,-32000,-32000,2021-06-09
7632,077039,世芯國泰07購01,0,0,0,0,0,0,0,0,0,-32000,0,0,0,0,32000,-32000,-32000,2021-06-09
7633,080593,力麗統一08購01,0,0,0,0,0,0,0,0,0,-32000,0,0,0,0,32000,-32000,-32000,2021-06-09
7634,6573,虹揚-KY,6000,38000,-32000,0,0,0,0,0,0,0,0,0,0,0,0,0,-32000,2021-06-09
7635,089159,群創元富09購09,0,0,0,0,0,0,0,0,0,-32000,0,0,0,0,32000,-32000,-32000,2021-06-09
7636,089928,仁寶永豐0A購01,0,0,0,0,0,0,0,0,0,-32000,0,0,0,0,32000,-32000,-32000,2021-06-09
7637,2106,建大,90960,120000,-29040,0,0,0,0,0,0,-3592,0,3592,-3592,0,0,0,-32632,2021-06-09
7638,086578,南電元大0B購01,0,0,0,0,0,0,0,0,0,-33000,0,0,0,232000,265000,-33000,-33000,2021-06-09
7639,088913,立積群益0B購01,0,0,0,0,0,0,0,0,0,-33000,0,0,0,0,33000,-33000,-33000,2021-06-09
7640,088771,智伸科兆豐0A購01,0,0,0,0,0,0,0,0,0,-33000,0,0,0,21000,54000,-33000,-33000,2021-06-09
7641,085304,台積電元大0C購06,0,0,0,0,0,0,0,0,0,-33000,0,0,0,0,33000,-33000,-33000,2021-06-09
7642,084622,台積電凱基08購18,0,0,0,0,0,0,0,0,0,-33000,0,0,0,1000,34000,-33000,-33000,2021-06-09
7643,033195,群創凱基0B購10,0,0,0,0,0,0,0,0,0,-33000,0,0,0,0,33000,-33000,-33000,2021-06-09
7644,00686R,群益臺灣加權反1,0,0,0,0,0,0,0,0,0,-33000,0,0,0,30000,63000,-33000,-33000,2021-06-09
7645,033012,華碩麥證0A購01,0,0,0,375000,408000,-33000,0,0,0,-33000,0,0,0,375000,408000,-33000,-33000,2021-06-09
7646,033558,亞聚永豐0B購01,0,0,0,0,0,0,0,0,0,-33000,0,0,0,100000,133000,-33000,-33000,2021-06-09
7647,031879,燿華凱基0A購01,0,0,0,0,0,0,0,0,0,-33000,0,0,0,0,33000,-33000,-33000,2021-06-09
7648,034663,台灣50凱基0B購07,0,0,0,0,0,0,0,0,0,-33000,0,0,0,5000,38000,-33000,-33000,2021-06-09
7649,033814,亞德客統一11購01,0,0,0,0,0,0,0,0,0,-33000,0,0,0,0,33000,-33000,-33000,2021-06-09
7650,05343P,全新元富09售02,0,0,0,0,0,0,0,0,0,-33000,0,0,0,0,33000,-33000,-33000,2021-06-09
7651,036046,愛普元富0C購01,0,0,0,0,0,0,0,0,0,-33000,0,0,0,0,33000,-33000,-33000,2021-06-09
7652,080052,T50反1元大09購03,0,0,0,0,0,0,0,0,0,-33000,0,0,0,0,33000,-33000,-33000,2021-06-09
7653,082841,聯電國票08購04,0,0,0,0,0,0,0,0,0,-33000,0,0,0,0,33000,-33000,-33000,2021-06-09
7654,07251P,愛普國票0C售03,0,0,0,0,0,0,0,0,0,-33000,0,0,0,0,33000,-33000,-33000,2021-06-09
7655,1598,岱宇,105000,220000,-115000,0,0,0,0,0,0,82000,0,0,0,83000,1000,82000,-33000,2021-06-09
7656,089242,群創永豐09購08,0,0,0,0,0,0,0,0,0,-33000,0,0,0,0,33000,-33000,-33000,2021-06-09
7657,084103,緯穎元大07購06,0,0,0,0,0,0,0,0,0,-34000,0,0,0,0,34000,-34000,-34000,2021-06-09
7658,086341,義隆元大0A購01,0,0,0,0,0,0,0,0,0,-34000,0,0,0,56000,90000,-34000,-34000,2021-06-09
7659,085819,宏碁群益09購02,0,0,0,0,0,0,0,0,0,-34000,0,0,0,24000,58000,-34000,-34000,2021-06-09
7660,087827,光罩凱基09購03,0,0,0,0,0,0,0,0,0,-34000,0,0,0,10000,44000,-34000,-34000,2021-06-09
7661,033349,祥碩永豐0B購01,0,0,0,0,0,0,0,0,0,-34000,0,0,0,76000,110000,-34000,-34000,2021-06-09
7662,036292,友達元大12購01,0,0,0,0,0,0,0,0,0,-34000,0,0,0,0,34000,-34000,-34000,2021-06-09
7663,032221,長榮統一11購03,0,0,0,0,0,0,0,0,0,-34000,0,0,0,26000,60000,-34000,-34000,2021-06-09
7664,030999,台化麥證0A購01,0,0,0,0,34000,-34000,0,0,0,-34000,0,0,0,0,34000,-34000,-34000,2021-06-09
7665,033928,友達元大0B購08,0,0,0,0,0,0,0,0,0,-34000,0,0,0,2000,36000,-34000,-34000,2021-06-09
7666,033924,國巨元大0B購07,0,0,0,0,0,0,0,0,0,-34000,0,0,0,66000,100000,-34000,-34000,2021-06-09
7667,035788,嘉澤國泰12購01,0,0,0,0,0,0,0,0,0,-34000,0,0,0,0,34000,-34000,-34000,2021-06-09
7668,034597,國巨統一0B購06,0,0,0,0,0,0,0,0,0,-34000,0,0,0,126000,160000,-34000,-34000,2021-06-09
7669,05935P,聯電凱基08售05,0,0,0,0,0,0,0,0,0,-34000,0,0,0,33000,67000,-34000,-34000,2021-06-09
7670,034762,長榮統一11購06,0,0,0,0,0,0,0,0,0,-34000,0,0,0,0,34000,-34000,-34000,2021-06-09
7671,076811,台積電國泰07購11,0,0,0,0,0,0,0,0,0,-34000,0,0,0,56000,90000,-34000,-34000,2021-06-09
7672,06664P,精英中信09售01,0,0,0,0,0,0,0,0,0,-34000,0,0,0,56000,90000,-34000,-34000,2021-06-09
7673,06803P,T50正2凱基0B售03,0,0,0,0,0,0,0,0,0,-34000,0,0,0,11000,45000,-34000,-34000,2021-06-09
7674,082978,凌陽元大08購02,0,0,0,0,0,0,0,0,0,-34000,0,0,0,407000,441000,-34000,-34000,2021-06-09
7675,081612,益航元大07購01,0,0,0,0,0,0,0,0,0,-34000,0,0,0,32000,66000,-34000,-34000,2021-06-09
7676,1612,宏泰,469000,503000,-34000,0,0,0,0,0,0,0,0,0,0,0,0,0,-34000,2021-06-09
7677,1449,佳和,11000,45000,-34000,0,0,0,0,0,0,0,0,0,0,0,0,0,-34000,2021-06-09
7678,1110,東泥,7000,41000,-34000,0,0,0,0,0,0,0,0,0,0,0,0,0,-34000,2021-06-09
7679,088788,滬深2X群益09購09,0,0,0,0,0,0,0,0,0,-35000,0,0,0,0,35000,-35000,-35000,2021-06-09
7680,086913,健策凱基09購02,0,0,0,0,0,0,0,0,0,-35000,0,0,0,42000,77000,-35000,-35000,2021-06-09
7681,087065,台積電群益0B購03,0,0,0,0,0,0,0,0,0,-35000,0,0,0,0,35000,-35000,-35000,2021-06-09
7682,087217,大立光凱基09購08,0,0,0,0,0,0,0,0,0,-35000,0,0,0,0,35000,-35000,-35000,2021-06-09
7683,085813,台積電群益08購23,0,0,0,0,0,0,0,0,0,-35000,0,0,0,5000,40000,-35000,-35000,2021-06-09
7684,085142,滬深2X中信0B購01,0,0,0,0,0,0,0,0,0,-35000,0,0,0,50000,85000,-35000,-35000,2021-06-09
7685,084086,凱美元大09購01,0,0,0,0,0,0,0,0,0,-35000,0,0,0,5000,40000,-35000,-35000,2021-06-09
7686,083832,京鼎凱基0A購01,0,0,0,0,0,0,0,0,0,-35000,0,0,0,64000,99000,-35000,-35000,2021-06-09
7687,083965,欣興凱基07購03,0,0,0,0,0,0,0,0,0,-35000,0,0,0,0,35000,-35000,-35000,2021-06-09
7688,084361,京鼎元大07購04,0,0,0,0,0,0,0,0,0,-35000,0,0,0,0,35000,-35000,-35000,2021-06-09
7689,030973,瑞昱元大0B購01,0,0,0,0,0,0,0,0,0,-35000,0,0,0,32000,67000,-35000,-35000,2021-06-09
7690,030385,佳格元大0A購02,0,0,0,0,0,0,0,0,0,-35000,0,0,0,0,35000,-35000,-35000,2021-06-09
7691,033312,奇鋐元富0B購01,0,0,0,0,0,0,0,0,0,-35000,0,0,0,398000,433000,-35000,-35000,2021-06-09
7692,032078,台玻兆豐0B購02,0,0,0,0,0,0,0,0,0,-35000,0,0,0,10000,45000,-35000,-35000,2021-06-09
7693,05507P,滬深2X國票07售03,0,0,0,0,0,0,0,0,0,-35000,0,0,0,0,35000,-35000,-35000,2021-06-09
7694,033479,臺股指凱基0C購26,0,0,0,0,0,0,0,0,0,-35000,0,0,0,0,35000,-35000,-35000,2021-06-09
7695,034889,美德醫群益0B購02,0,0,0,0,0,0,0,0,0,-35000,0,0,0,0,35000,-35000,-35000,2021-06-09
7696,05909P,台灣50元富07售03,0,0,0,0,0,0,0,0,0,-35000,0,0,0,115000,150000,-35000,-35000,2021-06-09
7697,033705,亞德客國票0C購01,0,0,0,0,0,0,0,0,0,-35000,0,0,0,0,35000,-35000,-35000,2021-06-09
7698,033667,臻鼎統一13購01,0,0,0,0,0,0,0,0,0,-35000,0,0,0,0,35000,-35000,-35000,2021-06-09
7699,033682,微星元大0B購02,0,0,0,0,0,0,0,0,0,-35000,0,0,0,10000,45000,-35000,-35000,2021-06-09
7700,034638,泰鼎元大0B購01,0,0,0,0,0,0,0,0,0,-35000,0,0,0,10000,45000,-35000,-35000,2021-06-09
7701,034219,友達元富12購04,0,0,0,0,0,0,0,0,0,-35000,0,0,0,5000,40000,-35000,-35000,2021-06-09
7702,035813,台驊控凱基13購02,0,0,0,0,0,0,0,0,0,-35000,0,0,0,9000,44000,-35000,-35000,2021-06-09
7703,035483,萬海群益13購01,0,0,0,0,0,0,0,0,0,-35000,0,0,0,5000,40000,-35000,-35000,2021-06-09
7704,034282,中石化兆豐0C購02,0,0,0,0,0,0,0,0,0,-35000,0,0,0,3000,38000,-35000,-35000,2021-06-09
7705,035181,上銀元富0B購03,0,0,0,0,0,0,0,0,0,-35000,0,0,0,16000,51000,-35000,-35000,2021-06-09
7706,035349,新纖國泰11購01,0,0,0,0,0,0,0,0,0,-35000,0,0,0,5000,40000,-35000,-35000,2021-06-09
7707,06345P,台灣50元大08售09,0,0,0,0,0,0,0,0,0,-35000,0,0,0,0,35000,-35000,-35000,2021-06-09
7708,081930,愛普凱基08購01,0,0,0,0,0,0,0,0,0,-35000,0,0,0,0,35000,-35000,-35000,2021-06-09
7709,083222,凱美元富07購02,0,0,0,0,0,0,0,0,0,-35000,0,0,0,71000,106000,-35000,-35000,2021-06-09
7710,082700,華碩凱基09購01,0,0,0,0,0,0,0,0,0,-35000,0,0,0,33000,68000,-35000,-35000,2021-06-09
7711,082550,緯穎凱基07購02,0,0,0,0,0,0,0,0,0,-35000,0,0,0,0,35000,-35000,-35000,2021-06-09
7712,079745,帆宣統一07購02,0,0,0,0,0,0,0,0,0,-35000,0,0,0,0,35000,-35000,-35000,2021-06-09
7713,06633P,滬深2X群益09售10,0,0,0,0,0,0,0,0,0,-35000,0,0,0,0,35000,-35000,-35000,2021-06-09
7714,06722P,滬深2X元富09售14,0,0,0,0,0,0,0,0,0,-35000,0,0,0,0,35000,-35000,-35000,2021-06-09
7715,069631,金像電元富08購02,0,0,0,0,0,0,0,0,0,-35000,0,0,0,309000,344000,-35000,-35000,2021-06-09
7716,07125P,臺股指元大0C售24,0,0,0,0,0,0,0,0,0,-35000,0,0,0,0,35000,-35000,-35000,2021-06-09
7717,07309P,台灣50元大11售11,0,0,0,0,0,0,0,0,0,-35000,0,0,0,0,35000,-35000,-35000,2021-06-09
7718,074078,精元元富08購04,0,0,0,0,0,0,0,0,0,-35000,0,0,0,0,35000,-35000,-35000,2021-06-09
7719,075728,玉晶光元大08購02,0,0,0,0,0,0,0,0,0,-35000,0,0,0,0,35000,-35000,-35000,2021-06-09
7720,089091,友達統一0B購03,0,0,0,0,0,0,0,0,0,-35000,0,0,0,0,35000,-35000,-35000,2021-06-09
7721,089410,大立光凱基13購02,0,0,0,0,0,0,0,0,0,-35000,0,0,0,0,35000,-35000,-35000,2021-06-09
7722,089519,景碩元大0A購01,0,0,0,0,0,0,0,0,0,-35000,0,0,0,21000,56000,-35000,-35000,2021-06-09
7723,2239,英利-KY,40000,82000,-42000,0,0,0,0,0,0,7000,0,0,0,7000,0,7000,-35000,2021-06-09
7724,2849,安泰銀,5000,40000,-35000,0,0,0,0,0,0,0,0,0,0,0,0,0,-35000,2021-06-09
7725,6743,安普新,28000,63000,-35000,0,0,0,0,0,0,0,0,0,0,0,0,0,-35000,2021-06-09
7726,6235,華孚,32000,67000,-35000,0,0,0,0,0,0,0,0,0,0,0,0,0,-35000,2021-06-09
7727,9930,中聯資源,0,35000,-35000,0,0,0,0,0,0,0,0,0,0,0,0,0,-35000,2021-06-09
7728,085024,緯穎元大08購03,0,0,0,0,0,0,0,0,0,-36000,0,0,0,0,36000,-36000,-36000,2021-06-09
7729,084055,智原富邦08購01,0,0,0,0,0,0,0,0,0,-36000,0,0,0,185000,221000,-36000,-36000,2021-06-09
7730,083662,日月光群益07購09,0,0,0,0,0,0,0,0,0,-36000,0,0,0,0,36000,-36000,-36000,2021-06-09
7731,083479,GIS統一09購02,0,0,0,0,0,0,0,0,0,-36000,0,0,0,0,36000,-36000,-36000,2021-06-09
7732,085254,臺股指國票08購08,0,0,0,0,0,0,0,0,0,-36000,0,0,0,9000,45000,-36000,-36000,2021-06-09
7733,085839,台表科群益08購03,0,0,0,0,0,0,0,0,0,-36000,0,0,0,0,36000,-36000,-36000,2021-06-09
7734,086772,奇鋐凱基0A購02,0,0,0,0,0,0,0,0,0,-36000,0,0,0,4000,40000,-36000,-36000,2021-06-09
7735,088824,界霖元大09購01,0,0,0,0,0,0,0,0,0,-36000,0,0,0,0,36000,-36000,-36000,2021-06-09
7736,087822,中興電凱基09購02,0,0,0,0,0,0,0,0,0,-36000,0,0,0,10000,46000,-36000,-36000,2021-06-09
7737,088306,技嘉凱基09購01,0,0,0,0,0,0,0,0,0,-36000,0,0,0,0,36000,-36000,-36000,2021-06-09
7738,087993,台達電群益09購01,0,0,0,0,0,0,0,0,0,-36000,0,0,0,0,36000,-36000,-36000,2021-06-09
7739,033082,裕民統一13購01,0,0,0,0,0,0,0,0,0,-36000,0,0,0,0,36000,-36000,-36000,2021-06-09
7740,030907,光磊凱基0A購01,0,0,0,0,0,0,0,0,0,-36000,0,0,0,0,36000,-36000,-36000,2021-06-09
7741,030801,華晶科凱基0B購01,0,0,0,0,0,0,0,0,0,-36000,0,0,0,0,36000,-36000,-36000,2021-06-09
7742,033173,長榮永豐0B購01,0,0,0,0,0,0,0,0,0,-36000,0,0,0,0,36000,-36000,-36000,2021-06-09
7743,035296,華晶科國票0C購02,0,0,0,0,0,0,0,0,0,-36000,0,0,0,16000,52000,-36000,-36000,2021-06-09
7744,035193,京元電元富0B購01,0,0,0,0,0,0,0,0,0,-36000,0,0,0,119000,155000,-36000,-36000,2021-06-09
7745,06595P,臺股指國票0A售15,0,0,0,0,0,0,0,0,0,-36000,0,0,0,370000,406000,-36000,-36000,2021-06-09
7746,080632,永光元大09購01,0,0,0,0,0,0,0,0,0,-36000,0,0,0,130000,166000,-36000,-36000,2021-06-09
7747,083062,凱美永豐07購03,0,0,0,0,0,0,0,0,0,-36000,0,0,0,35000,71000,-36000,-36000,2021-06-09
7748,081964,台達電元大08購02,0,0,0,0,0,0,0,0,0,-36000,0,0,0,0,36000,-36000,-36000,2021-06-09
7749,9941,裕融,49000,85000,-36000,0,0,0,0,0,0,0,0,0,0,0,0,0,-36000,2021-06-09
7750,089836,台達電元大09購02,0,0,0,0,0,0,0,0,0,-36000,0,0,0,0,36000,-36000,-36000,2021-06-09
7751,1234,黑松,2000,38000,-36000,0,0,0,0,0,0,0,0,0,0,0,0,0,-36000,2021-06-09
7752,088016,統一永豐09購01,0,0,0,0,0,0,0,0,0,-37000,0,0,0,0,37000,-37000,-37000,2021-06-09
7753,086664,精成科國票0A購01,0,0,0,0,0,0,0,0,0,-37000,0,0,0,0,37000,-37000,-37000,2021-06-09
7754,084667,聯發科國票08購10,0,0,0,0,0,0,0,0,0,-37000,0,0,0,65000,102000,-37000,-37000,2021-06-09
7755,032727,玉晶光第一14購01,0,0,0,0,0,0,0,0,0,-37000,0,0,0,10000,47000,-37000,-37000,2021-06-09
7756,032691,友達永豐0A購07,0,0,0,0,0,0,0,0,0,-37000,0,0,0,95000,132000,-37000,-37000,2021-06-09
7757,031056,友達元大0A購05,0,0,0,0,0,0,0,0,0,-37000,0,0,0,0,37000,-37000,-37000,2021-06-09
7758,033039,聯發科兆豐0A購06,0,0,0,0,0,0,0,0,0,-37000,0,0,0,0,37000,-37000,-37000,2021-06-09
7759,033355,東聯群益0B購01,0,0,0,0,0,0,0,0,0,-37000,0,0,0,33000,70000,-37000,-37000,2021-06-09
7760,033570,東鋼第一15購01,0,0,0,0,0,0,0,0,0,-37000,0,0,0,0,37000,-37000,-37000,2021-06-09
7761,032165,大立光元富14購01,0,0,0,0,0,0,0,0,0,-37000,0,0,0,10000,47000,-37000,-37000,2021-06-09
7762,034816,全新群益11購01,0,0,0,0,0,0,0,0,0,-37000,0,0,0,170000,207000,-37000,-37000,2021-06-09
7763,034079,上銀元大12購01,0,0,0,0,0,0,0,0,0,-37000,0,0,0,175000,212000,-37000,-37000,2021-06-09
7764,034208,亞聚元富0B購02,0,0,0,0,0,0,0,0,0,-37000,0,0,0,5000,42000,-37000,-37000,2021-06-09
7765,06240P,亞德客元大08售02,0,0,0,0,0,0,0,0,0,-37000,0,0,0,1000,38000,-37000,-37000,2021-06-09
7766,083368,台揚國票08購01,0,0,0,0,0,0,0,0,0,-37000,0,0,0,3000,40000,-37000,-37000,2021-06-09
7767,1453,大將,1000,38000,-37000,0,0,0,0,0,0,0,0,0,0,0,0,0,-37000,2021-06-09
7768,3024,憶聲,168000,205000,-37000,0,0,0,0,0,0,0,0,0,0,0,0,0,-37000,2021-06-09
7769,3046,建碁,8000,45000,-37000,0,0,0,0,0,0,0,0,0,0,0,0,0,-37000,2021-06-09
7770,6668,中揚光,57000,94000,-37000,0,0,0,0,0,0,0,0,0,0,0,0,0,-37000,2021-06-09
7771,9105,泰金寶-DR,83000,120942,-37942,0,0,0,0,0,0,0,0,0,0,0,0,0,-37942,2021-06-09
7772,083453,台達電麥證09購01,0,0,0,0,38000,-38000,0,0,0,-38000,0,0,0,0,38000,-38000,-38000,2021-06-09
7773,083619,台達電凱基0B購01,0,0,0,0,0,0,0,0,0,-38000,0,0,0,0,38000,-38000,-38000,2021-06-09
7774,085820,台光電群益09購01,0,0,0,0,0,0,0,0,0,-38000,0,0,0,497000,535000,-38000,-38000,2021-06-09
7775,085324,T50正2群益08購12,0,0,0,0,0,0,0,0,0,-38000,0,0,0,2000,40000,-38000,-38000,2021-06-09
7776,088718,宏碁凱基09購04,0,0,0,0,0,0,0,0,0,-38000,0,0,0,1000,39000,-38000,-38000,2021-06-09
7777,033351,矽格永豐0B購01,0,0,0,0,0,0,0,0,0,-38000,0,0,0,0,38000,-38000,-38000,2021-06-09
7778,033435,偉詮電元大11購01,0,0,0,0,0,0,0,0,0,-38000,0,0,0,97000,135000,-38000,-38000,2021-06-09
7779,034990,友達群益0B購09,0,0,0,0,0,0,0,0,0,-38000,0,0,0,8000,46000,-38000,-38000,2021-06-09
7780,034922,富邦金麥證0B購02,0,0,0,0,39000,-39000,0,0,0,-38000,0,0,0,1000,39000,-38000,-38000,2021-06-09
7781,035534,聯發科兆豐0B購04,0,0,0,0,0,0,0,0,0,-38000,0,0,0,0,38000,-38000,-38000,2021-06-09
7782,034180,力山元大0C購02,0,0,0,0,0,0,0,0,0,-38000,0,0,0,915000,953000,-38000,-38000,2021-06-09
7783,034592,中鋼統一0B購03,0,0,0,0,0,0,0,0,0,-38000,0,0,0,146000,184000,-38000,-38000,2021-06-09
7784,035740,華晶科國票0C購03,0,0,0,0,0,0,0,0,0,-38000,0,0,0,4000,42000,-38000,-38000,2021-06-09
7785,035889,新唐國票11購01,0,0,0,0,0,0,0,0,0,-38000,0,0,0,7000,45000,-38000,-38000,2021-06-09
7786,033984,惠特凱基0B購02,0,0,0,0,0,0,0,0,0,-38000,0,0,0,0,38000,-38000,-38000,2021-06-09
7787,035081,聯詠第一15購01,0,0,0,0,0,0,0,0,0,-38000,0,0,0,25000,63000,-38000,-38000,2021-06-09
7788,035356,國巨兆豐11購01,0,0,0,0,0,0,0,0,0,-38000,0,0,0,0,38000,-38000,-38000,2021-06-09
7789,082240,立隆電凱基09購01,0,0,0,0,0,0,0,0,0,-38000,0,0,0,0,38000,-38000,-38000,2021-06-09
7790,06933P,中鋼中信0A售06,0,0,0,0,0,0,0,0,0,-38000,0,0,0,0,38000,-38000,-38000,2021-06-09
7791,2731,雄獅,20000,50000,-30000,0,0,0,0,0,0,-8000,0,8000,-8000,0,0,0,-38000,2021-06-09
7792,3557,嘉威,4000,41000,-37000,0,0,0,0,0,0,-1000,0,0,0,0,1000,-1000,-38000,2021-06-09
7793,1416,廣豐,15000,53000,-38000,0,0,0,0,0,0,0,0,0,0,0,0,0,-38000,2021-06-09
7794,1531,高林股,0,38000,-38000,0,0,0,0,0,0,0,0,0,0,0,0,0,-38000,2021-06-09
7795,088666,燿華元大0A購01,0,0,0,0,0,0,0,0,0,-39000,0,0,0,73000,112000,-39000,-39000,2021-06-09
7796,088028,科嘉永豐09購01,0,0,0,0,0,0,0,0,0,-39000,0,0,0,0,39000,-39000,-39000,2021-06-09
7797,087847,臺股指凱基0C購08,0,0,0,0,0,0,0,0,0,-39000,0,0,0,10000,49000,-39000,-39000,2021-06-09
7798,084813,華晶科永豐08購03,0,0,0,0,0,0,0,0,0,-39000,0,0,0,0,39000,-39000,-39000,2021-06-09
7799,032116,SGBR2X凱基0B購02,0,0,0,0,0,0,0,0,0,-39000,0,0,0,6000,45000,-39000,-39000,2021-06-09
7800,032575,A50正2元大0A購05,0,0,0,0,0,0,0,0,0,-39000,0,0,0,17000,56000,-39000,-39000,2021-06-09
7801,032709,力麗群益0A購01,0,0,0,0,0,0,0,0,0,-39000,0,0,0,0,39000,-39000,-39000,2021-06-09
7802,035347,群創元富0B購10,0,0,0,0,0,0,0,0,0,-39000,0,0,0,48000,87000,-39000,-39000,2021-06-09
7803,035647,瀚宇博群益0C購01,0,0,0,0,0,0,0,0,0,-39000,0,0,0,0,39000,-39000,-39000,2021-06-09
7804,034378,中鋼元大0B購06,0,0,0,0,0,0,0,0,0,-39000,0,0,0,87000,126000,-39000,-39000,2021-06-09
7805,034379,中鋼元大13購01,0,0,0,0,0,0,0,0,0,-39000,0,0,0,0,39000,-39000,-39000,2021-06-09
7806,033715,技嘉國票0C購01,0,0,0,0,0,0,0,0,0,-39000,0,0,0,26000,65000,-39000,-39000,2021-06-09
7807,06571P,台灣50元大0C售02,0,0,0,0,0,0,0,0,0,-39000,0,0,0,0,39000,-39000,-39000,2021-06-09
7808,06776P,鴻海凱基0A售16,0,0,0,0,0,0,0,0,0,-39000,0,0,0,75000,114000,-39000,-39000,2021-06-09
7809,072984,可成元富07購07,0,0,0,0,0,0,0,0,0,-39000,0,0,0,0,39000,-39000,-39000,2021-06-09
7810,07301P,金像電元富13售01,0,0,0,0,0,0,0,0,0,-39000,0,0,0,0,39000,-39000,-39000,2021-06-09
7811,079467,緯穎元富07購03,0,0,0,0,0,0,0,0,0,-39000,0,0,0,0,39000,-39000,-39000,2021-06-09
7812,2109,華豐,44000,83000,-39000,0,0,0,0,0,0,0,0,0,0,0,0,0,-39000,2021-06-09
7813,2516,新建,13000,52000,-39000,0,0,0,0,0,0,0,0,0,0,0,0,0,-39000,2021-06-09
7814,084789,台郡凱基09購02,0,0,0,0,0,0,0,0,0,-40000,0,0,0,0,40000,-40000,-40000,2021-06-09
7815,084926,宏碁元大08購02,0,0,0,0,0,0,0,0,0,-40000,0,0,0,4000,44000,-40000,-40000,2021-06-09
7816,083561,聯電群益09購01,0,0,0,0,0,0,0,0,0,-40000,0,0,0,0,40000,-40000,-40000,2021-06-09
7817,085282,台積電凱基08購25,0,0,0,0,0,0,0,0,0,-40000,0,0,0,0,40000,-40000,-40000,2021-06-09
7818,085699,同欣電國泰0A購01,0,0,0,0,0,0,0,0,0,-40000,0,0,0,10000,50000,-40000,-40000,2021-06-09
7819,085523,華新科富邦0A購01,0,0,0,0,0,0,0,0,0,-40000,0,0,0,0,40000,-40000,-40000,2021-06-09
7820,085978,臺股指凱基12購01,0,0,0,0,0,0,0,0,0,-40000,0,0,0,170000,210000,-40000,-40000,2021-06-09
7821,086316,景碩凱基09購02,0,0,0,0,0,0,0,0,0,-40000,0,0,0,0,40000,-40000,-40000,2021-06-09
7822,086187,亞德客凱基08購02,0,0,0,0,0,0,0,0,0,-40000,0,0,0,0,40000,-40000,-40000,2021-06-09
7823,086189,大成鋼凱基0C購01,0,0,0,0,0,0,0,0,0,-40000,0,0,0,0,40000,-40000,-40000,2021-06-09
7824,088596,台積電日盛15購01,0,0,0,0,0,0,0,0,0,-40000,0,0,0,0,40000,-40000,-40000,2021-06-09
7825,086534,矽創凱基09購02,0,0,0,0,0,0,0,0,0,-40000,0,0,0,0,40000,-40000,-40000,2021-06-09
7826,086868,旺宏國票0B購01,0,0,0,0,0,0,0,0,0,-40000,0,0,0,0,40000,-40000,-40000,2021-06-09
7827,087647,京元電群益0A購01,0,0,0,0,0,0,0,0,0,-40000,0,0,0,0,40000,-40000,-40000,2021-06-09
7828,087666,中磊兆豐0A購01,0,0,0,0,0,0,0,0,0,-40000,0,0,0,10000,50000,-40000,-40000,2021-06-09
7829,030705,華晶科群益0B購01,0,0,0,0,0,0,0,0,0,-40000,0,0,0,0,40000,-40000,-40000,2021-06-09
7830,030657,友達永豐0A購01,0,0,0,0,0,0,0,0,0,-40000,0,0,0,0,40000,-40000,-40000,2021-06-09
7831,00730,富邦臺灣優質高息,4000,4000,0,0,0,0,0,0,0,-40000,0,0,0,293000,333000,-40000,-40000,2021-06-09
7832,030199,中環凱基0A購01,0,0,0,0,0,0,0,0,0,-40000,0,0,0,0,40000,-40000,-40000,2021-06-09
7833,031242,金像電群益0A購01,0,0,0,0,0,0,0,0,0,-40000,0,0,0,0,40000,-40000,-40000,2021-06-09
7834,031373,長榮航永豐0A購01,0,0,0,0,0,0,0,0,0,-40000,0,0,0,0,40000,-40000,-40000,2021-06-09
7835,032192,奇力新群益0A購01,0,0,0,0,0,0,0,0,0,-40000,0,0,0,0,40000,-40000,-40000,2021-06-09
7836,032069,正新中信0A購01,0,0,0,0,0,0,0,0,0,-40000,0,0,0,0,40000,-40000,-40000,2021-06-09
7837,031915,長榮永豐0A購08,0,0,0,0,0,0,0,0,0,-40000,0,0,0,0,40000,-40000,-40000,2021-06-09
7838,031896,台塑永豐0A購01,0,0,0,0,0,0,0,0,0,-40000,0,0,0,0,40000,-40000,-40000,2021-06-09
7839,032406,台苯元大0B購01,0,0,0,0,0,0,0,0,0,-40000,0,0,0,81000,121000,-40000,-40000,2021-06-09
7840,033279,南亞科統一15購01,0,0,0,0,0,0,0,0,0,-40000,0,0,0,0,40000,-40000,-40000,2021-06-09
7841,033653,台積電統一0C購09,0,0,0,0,0,0,0,0,0,-40000,0,0,0,0,40000,-40000,-40000,2021-06-09
7842,034751,愛普元大13購01,0,0,0,0,0,0,0,0,0,-40000,0,0,0,0,40000,-40000,-40000,2021-06-09
7843,034790,祥碩國泰11購01,0,0,0,0,0,0,0,0,0,-40000,0,0,0,77000,117000,-40000,-40000,2021-06-09
7844,034388,國泰金元大0C購03,0,0,0,0,0,0,0,0,0,-40000,0,0,0,0,40000,-40000,-40000,2021-06-09
7845,034646,臺股指元大0C購20,0,0,0,0,0,0,0,0,0,-40000,0,0,0,0,40000,-40000,-40000,2021-06-09
7846,034690,鴻海群益0B購10,0,0,0,0,0,0,0,0,0,-40000,0,0,0,65000,105000,-40000,-40000,2021-06-09
7847,034236,新纖統一13購01,0,0,0,0,0,0,0,0,0,-40000,0,0,0,20000,60000,-40000,-40000,2021-06-09
7848,033827,台灣50台新0B購01,0,0,0,0,0,0,0,0,0,-40000,0,0,0,0,40000,-40000,-40000,2021-06-09
7849,035484,萬海群益13購02,0,0,0,0,0,0,0,0,0,-40000,0,0,0,0,40000,-40000,-40000,2021-06-09
7850,034879,東鋼群益0B購04,0,0,0,0,0,0,0,0,0,-40000,0,0,0,56000,96000,-40000,-40000,2021-06-09
7851,034284,聯電兆豐0C購02,0,0,0,0,0,0,0,0,0,-40000,0,0,0,0,40000,-40000,-40000,2021-06-09
7852,035090,友達凱基11購05,0,0,0,0,0,0,0,0,0,-40000,0,0,0,10000,50000,-40000,-40000,2021-06-09
7853,036531,南電兆豐12購01,0,0,0,0,0,0,0,0,0,-40000,0,0,0,0,40000,-40000,-40000,2021-06-09
7854,080465,大聯大凱基09購01,0,0,0,0,0,0,0,0,0,-40000,0,0,0,0,40000,-40000,-40000,2021-06-09
7855,081376,聯電麥證0A購01,0,0,0,0,40000,-40000,0,0,0,-40000,0,0,0,0,40000,-40000,-40000,2021-06-09
7856,082400,金像電凱基07購02,0,0,0,0,0,0,0,0,0,-40000,0,0,0,0,40000,-40000,-40000,2021-06-09
7857,081673,南電富邦07購02,0,0,0,0,0,0,0,0,0,-40000,0,0,0,0,40000,-40000,-40000,2021-06-09
7858,082622,玉晶光永豐07購01,0,0,0,0,0,0,0,0,0,-40000,0,0,0,10000,50000,-40000,-40000,2021-06-09
7859,082781,鴻海元富07購22,0,0,0,0,0,0,0,0,0,-40000,0,0,0,0,40000,-40000,-40000,2021-06-09
7860,073508,松翰元富0A購01,0,0,0,0,0,0,0,0,0,-40000,0,0,0,10000,50000,-40000,-40000,2021-06-09
7861,076009,滬深2X元大08購01,0,0,0,0,0,0,0,0,0,-40000,0,0,0,100000,140000,-40000,-40000,2021-06-09
7862,06934P,長榮中信0A售05,0,0,0,0,0,0,0,0,0,-40000,0,0,0,10000,50000,-40000,-40000,2021-06-09
7863,06942P,彩晶元大0A售12,0,0,0,0,0,0,0,0,0,-40000,0,0,0,0,40000,-40000,-40000,2021-06-09
7864,2527,宏璟,3000,43000,-40000,0,0,0,0,0,0,0,0,0,0,0,0,0,-40000,2021-06-09
7865,2024,志聯,3000,42000,-39000,0,0,0,0,0,0,-1000,0,1000,-1000,0,0,0,-40000,2021-06-09
7866,1603,華電,473000,513000,-40000,0,0,0,0,0,0,0,0,0,0,0,0,0,-40000,2021-06-09
7867,089603,華邦電群益0B購01,0,0,0,0,0,0,0,0,0,-40000,0,0,0,0,40000,-40000,-40000,2021-06-09
7868,089155,台積電元富0C購18,0,0,0,0,0,0,0,0,0,-40000,0,0,0,0,40000,-40000,-40000,2021-06-09
7869,6415,矽力-KY,185950,218100,-32150,0,0,0,0,2000,-2000,-5870,12000,17870,-5870,0,0,0,-40020,2021-06-09
7870,4739,康普,117050,198000,-80950,0,0,0,0,0,0,40000,40000,0,40000,0,0,0,-40950,2021-06-09
7871,086713,強茂元大09購01,0,0,0,0,0,0,0,0,0,-41000,0,0,0,546000,587000,-41000,-41000,2021-06-09
7872,088465,仁寶元富09購02,0,0,0,0,0,0,0,0,0,-41000,0,0,0,0,41000,-41000,-41000,2021-06-09
7873,088295,廣宇麥證0A購01,0,0,0,0,41000,-41000,0,0,0,-41000,0,0,0,0,41000,-41000,-41000,2021-06-09
7874,085507,松翰凱基08購01,0,0,0,0,0,0,0,0,0,-41000,0,0,0,10000,51000,-41000,-41000,2021-06-09
7875,084798,鴻海群益09購07,0,0,0,0,0,0,0,0,0,-41000,0,0,0,0,41000,-41000,-41000,2021-06-09
7876,032959,聯電元大0A購15,0,0,0,0,0,0,0,0,0,-41000,0,0,0,9000,50000,-41000,-41000,2021-06-09
7877,031370,瑞昱永豐0A購02,0,0,0,0,0,0,0,0,0,-41000,0,0,0,0,41000,-41000,-41000,2021-06-09
7878,031211,華邦電凱基0B購02,0,0,0,0,0,0,0,0,0,-41000,0,0,0,32000,73000,-41000,-41000,2021-06-09
7879,030246,威盛永豐0A購01,0,0,0,0,0,0,0,0,0,-41000,0,0,0,4000,45000,-41000,-41000,2021-06-09
7880,031532,國巨富邦0C購02,0,0,0,0,0,0,0,0,0,-41000,0,0,0,35000,76000,-41000,-41000,2021-06-09
7881,034820,群創群益0B購12,0,0,0,0,0,0,0,0,0,-41000,0,0,0,0,41000,-41000,-41000,2021-06-09
7882,035622,智邦國票0C購02,0,0,0,0,0,0,0,0,0,-41000,0,0,0,8000,49000,-41000,-41000,2021-06-09
7883,034025,友達中信11購02,0,0,0,0,0,0,0,0,0,-41000,0,0,0,1000,42000,-41000,-41000,2021-06-09
7884,034223,萬海元富0C購01,0,0,0,0,0,0,0,0,0,-41000,0,0,0,0,41000,-41000,-41000,2021-06-09
7885,082392,聯電凱基07購06,0,0,0,0,0,0,0,0,0,-41000,0,0,0,9000,50000,-41000,-41000,2021-06-09
7886,079646,台積電凱基0C購01,0,0,0,0,0,0,0,0,0,-41000,0,0,0,10000,51000,-41000,-41000,2021-06-09
7887,1808,潤隆,27000,68000,-41000,0,0,0,0,0,0,0,0,0,0,0,0,0,-41000,2021-06-09
7888,084625,宏碁凱基09購01,0,0,0,0,0,0,0,0,0,-42000,0,0,0,2000,44000,-42000,-42000,2021-06-09
7889,087912,微星群益0A購01,0,0,0,0,0,0,0,0,0,-42000,0,0,0,138000,180000,-42000,-42000,2021-06-09
7890,088753,華碩統一0B購03,0,0,0,0,0,0,0,0,0,-42000,0,0,0,0,42000,-42000,-42000,2021-06-09
7891,088912,立積群益0A購01,0,0,0,0,0,0,0,0,0,-42000,0,0,0,0,42000,-42000,-42000,2021-06-09
7892,032967,宏達電元大0A購05,0,0,0,0,0,0,0,0,0,-42000,0,0,0,5000,47000,-42000,-42000,2021-06-09
7893,031727,彩晶群益0A購03,0,0,0,0,0,0,0,0,0,-42000,0,0,0,0,42000,-42000,-42000,2021-06-09
7894,031709,聯發科永豐0B購02,0,0,0,0,0,0,0,0,0,-42000,0,0,0,0,42000,-42000,-42000,2021-06-09
7895,05490P,聯電兆豐07售04,0,0,0,0,0,0,0,0,0,-42000,0,0,0,0,42000,-42000,-42000,2021-06-09
7896,034339,創意群益0B購01,0,0,0,0,0,0,0,0,0,-42000,0,0,0,169000,211000,-42000,-42000,2021-06-09
7897,034155,緯穎凱基0C購01,0,0,0,0,0,0,0,0,0,-42000,0,0,0,0,42000,-42000,-42000,2021-06-09
7898,05982P,台積電兆豐08售07,0,0,0,0,0,0,0,0,0,-42000,0,0,0,8000,50000,-42000,-42000,2021-06-09
7899,06099P,台灣50凱基07售18,0,0,0,0,0,0,0,0,0,-42000,0,0,0,75000,117000,-42000,-42000,2021-06-09
7900,035678,晶技永豐0B購02,0,0,0,0,0,0,0,0,0,-42000,0,0,0,0,42000,-42000,-42000,2021-06-09
7901,036442,聯詠兆豐11購01,0,0,0,0,0,0,0,0,0,-42000,0,0,0,0,42000,-42000,-42000,2021-06-09
7902,082158,廣宇國泰09購01,0,0,0,0,0,0,0,0,0,-42000,0,0,0,27000,69000,-42000,-42000,2021-06-09
7903,06883P,臺股指群益0A售13,0,0,0,0,0,0,0,0,0,-42000,0,0,0,12000,54000,-42000,-42000,2021-06-09
7904,2012,春雨,127000,169000,-42000,0,0,0,0,0,0,0,0,0,0,0,0,0,-42000,2021-06-09
7905,089764,恆大凱基11購01,0,0,0,0,0,0,0,0,0,-42000,0,0,0,8000,50000,-42000,-42000,2021-06-09
7906,9942,茂順,16000,58000,-42000,0,0,0,0,0,0,0,0,0,0,0,0,0,-42000,2021-06-09
7907,088391,緯穎富邦09購02,0,0,0,0,0,0,0,0,0,-43000,0,0,0,8000,51000,-43000,-43000,2021-06-09
7908,088199,日月光群益11購01,0,0,0,0,0,0,0,0,0,-43000,0,0,0,96000,139000,-43000,-43000,2021-06-09
7909,033124,聯電元大0A購17,0,0,0,0,0,0,0,0,0,-43000,0,0,0,48000,91000,-43000,-43000,2021-06-09
7910,036380,健策國票11購01,0,0,0,0,0,0,0,0,0,-43000,0,0,0,67000,110000,-43000,-43000,2021-06-09
7911,035156,台玻國票0C購04,0,0,0,0,0,0,0,0,0,-43000,0,0,0,0,43000,-43000,-43000,2021-06-09
7912,035348,南電元富0B購01,0,0,0,0,0,0,0,0,0,-43000,0,0,0,90000,133000,-43000,-43000,2021-06-09
7913,034880,大成鋼群益11購01,0,0,0,0,0,0,0,0,0,-43000,0,0,0,77000,120000,-43000,-43000,2021-06-09
7914,034637,創意元大0B購01,0,0,0,0,0,0,0,0,0,-43000,0,0,0,65000,108000,-43000,-43000,2021-06-09
7915,06980P,彩晶元富0A售06,0,0,0,0,0,0,0,0,0,-43000,0,0,0,0,43000,-43000,-43000,2021-06-09
7916,07084P,大成鋼凱基0B售06,0,0,0,0,0,0,0,0,0,-43000,0,0,0,37000,80000,-43000,-43000,2021-06-09
7917,06599P,南電群益0A售01,0,0,0,0,0,0,0,0,0,-43000,0,0,0,0,43000,-43000,-43000,2021-06-09
7918,06405P,友達元富08售04,0,0,0,0,0,0,0,0,0,-43000,0,0,0,2000,45000,-43000,-43000,2021-06-09
7919,083351,力山永豐07購01,0,0,0,0,0,0,0,0,0,-43000,0,0,0,0,43000,-43000,-43000,2021-06-09
7920,2206,三陽工業,127000,184000,-57000,0,0,0,0,0,0,14000,0,0,0,14000,0,14000,-43000,2021-06-09
7921,088294,廣宇麥證09購02,0,0,0,0,44000,-44000,0,0,0,-44000,0,0,0,0,44000,-44000,-44000,2021-06-09
7922,086662,嘉澤國票0A購01,0,0,0,0,0,0,0,0,0,-44000,0,0,0,31000,75000,-44000,-44000,2021-06-09
7923,084928,凌陽元大08購08,0,0,0,0,0,0,0,0,0,-44000,0,0,0,545000,589000,-44000,-44000,2021-06-09
7924,085109,台達電元大08購03,0,0,0,0,0,0,0,0,0,-44000,0,0,0,89000,133000,-44000,-44000,2021-06-09
7925,085830,欣興群益08購04,0,0,0,0,0,0,0,0,0,-44000,0,0,0,16000,60000,-44000,-44000,2021-06-09
7926,035051,聯發科富邦11購01,0,0,0,0,0,0,0,0,0,-44000,0,0,0,0,44000,-44000,-44000,2021-06-09
7927,036511,長榮航凱基14購01,0,0,0,0,0,0,0,0,0,-44000,0,0,0,0,44000,-44000,-44000,2021-06-09
7928,082426,精成科永豐07購01,0,0,0,0,0,0,0,0,0,-44000,0,0,0,0,44000,-44000,-44000,2021-06-09
7929,2211,長榮鋼,14000,58000,-44000,0,0,0,0,0,0,0,0,0,0,0,0,0,-44000,2021-06-09
7930,087248,國喬國票0A購02,0,0,0,0,0,0,0,0,0,-45000,0,0,0,41000,86000,-45000,-45000,2021-06-09
7931,088136,南茂凱基09購01,0,0,0,0,0,0,0,0,0,-45000,0,0,0,221000,266000,-45000,-45000,2021-06-09
7932,033113,欣興富邦0C購01,0,0,0,0,0,0,0,0,0,-45000,0,0,0,287000,332000,-45000,-45000,2021-06-09
7933,030435,元翎元大0A購01,0,0,0,0,0,0,0,0,0,-45000,0,0,0,10000,55000,-45000,-45000,2021-06-09
7934,031472,臺股指群益0A購07,0,0,0,0,0,0,0,0,0,-45000,0,0,0,4000,49000,-45000,-45000,2021-06-09
7935,036079,國喬元大0C購04,0,0,0,0,0,0,0,0,0,-45000,0,0,0,19000,64000,-45000,-45000,2021-06-09
7936,035211,中石化富邦11購01,0,0,0,0,0,0,0,0,0,-45000,0,0,0,413000,458000,-45000,-45000,2021-06-09
7937,034177,台聚元大0B購04,0,0,0,0,0,0,0,0,0,-45000,0,0,0,2000,47000,-45000,-45000,2021-06-09
7938,034028,T50反1元富12購06,0,0,0,0,0,0,0,0,0,-45000,0,0,0,0,45000,-45000,-45000,2021-06-09
7939,06256P,聯發科元富08售10,0,0,0,0,0,0,0,0,0,-45000,0,0,0,5000,50000,-45000,-45000,2021-06-09
7940,081242,大立光元富07購06,0,0,0,0,0,0,0,0,0,-45000,0,0,0,0,45000,-45000,-45000,2021-06-09
7941,06896P,台達化元大0A售03,0,0,0,0,0,0,0,0,0,-45000,0,0,0,0,45000,-45000,-45000,2021-06-09
7942,089858,南電元大0B購02,0,0,0,0,0,0,0,0,0,-45000,0,0,0,81000,126000,-45000,-45000,2021-06-09
7943,1707,葡萄王,17000,61000,-44000,0,0,0,0,0,0,-1000,0,1000,-1000,0,0,0,-45000,2021-06-09
7944,087591,晶相光元大0B購01,0,0,0,0,0,0,0,0,0,-46000,0,0,0,8000,54000,-46000,-46000,2021-06-09
7945,085986,廣宇元大08購06,0,0,0,0,0,0,0,0,0,-46000,0,0,0,0,46000,-46000,-46000,2021-06-09
7946,086425,聯發科富邦0C購02,0,0,0,0,0,0,0,0,0,-46000,0,0,0,0,46000,-46000,-46000,2021-06-09
7947,084924,台積電元大08購19,0,0,0,0,0,0,0,0,0,-46000,0,0,0,0,46000,-46000,-46000,2021-06-09
7948,084801,旺宏群益0A購01,0,0,0,0,0,0,0,0,0,-46000,0,0,0,159000,205000,-46000,-46000,2021-06-09
7949,084431,聯發科群益08購13,0,0,0,0,0,0,0,0,0,-46000,0,0,0,22000,68000,-46000,-46000,2021-06-09
7950,084310,光磊凱基07購01,0,0,0,0,0,0,0,0,0,-46000,0,0,0,0,46000,-46000,-46000,2021-06-09
7951,030567,惠特統一0C購02,0,0,0,0,0,0,0,0,0,-46000,0,0,0,0,46000,-46000,-46000,2021-06-09
7952,031632,長榮航統一0C購03,0,0,0,0,0,0,0,0,0,-46000,0,0,0,2000,48000,-46000,-46000,2021-06-09
7953,06426P,南電中信09售02,0,0,0,0,0,0,0,0,0,-46000,0,0,0,0,46000,-46000,-46000,2021-06-09
7954,081262,聯電永豐07購01,0,0,0,0,0,0,0,0,0,-46000,0,0,0,0,46000,-46000,-46000,2021-06-09
7955,081484,廣宇凱基0A購01,0,0,0,0,0,0,0,0,0,-46000,0,0,0,3000,49000,-46000,-46000,2021-06-09
7956,1215,卜蜂,61000,133000,-72000,0,0,0,0,0,0,26000,23000,0,23000,5000,2000,3000,-46000,2021-06-09
7957,3021,鴻名,11000,57000,-46000,0,0,0,0,0,0,0,0,0,0,0,0,0,-46000,2021-06-09
7958,087996,聯發科群益09購05,0,0,0,0,0,0,0,0,0,-47000,0,0,0,70000,117000,-47000,-47000,2021-06-09
7959,031265,聯電統一0C購02,0,0,0,0,0,0,0,0,0,-47000,0,0,0,0,47000,-47000,-47000,2021-06-09
7960,032305,國巨永豐0A購01,0,0,0,0,0,0,0,0,0,-47000,0,0,0,92000,139000,-47000,-47000,2021-06-09
7961,032973,嘉晶元大0B購02,0,0,0,0,0,0,0,0,0,-47000,0,0,0,134000,181000,-47000,-47000,2021-06-09
7962,033615,富邦金群益11購01,0,0,0,0,0,0,0,0,0,-47000,0,0,0,6000,53000,-47000,-47000,2021-06-09
7963,034610,群創統一0B購12,0,0,0,0,0,0,0,0,0,-47000,0,0,0,0,47000,-47000,-47000,2021-06-09
7964,035411,國泰金麥證0B購02,0,0,0,0,47000,-47000,0,0,0,-47000,0,0,0,0,47000,-47000,-47000,2021-06-09
7965,04356P,大立光元富0A售02,0,0,0,0,0,0,0,0,0,-47000,0,0,0,1000,48000,-47000,-47000,2021-06-09
7966,081503,台勝科凱基08購01,0,0,0,0,0,0,0,0,0,-47000,0,0,0,27000,74000,-47000,-47000,2021-06-09
7967,081344,康那香群益0A購01,0,0,0,0,0,0,0,0,0,-47000,0,0,0,0,47000,-47000,-47000,2021-06-09
7968,06596P,國巨中信09售03,0,0,0,0,0,0,0,0,0,-47000,0,0,0,0,47000,-47000,-47000,2021-06-09
7969,070153,創意元富08購02,0,0,0,0,0,0,0,0,0,-47000,0,0,0,135000,182000,-47000,-47000,2021-06-09
7970,074529,鴻海元大06購02,0,0,0,0,0,0,0,0,0,-47000,0,0,0,0,47000,-47000,-47000,2021-06-09
7971,07223P,臺股指元大0C售28,0,0,0,0,0,0,0,0,0,-47000,0,0,0,56000,103000,-47000,-47000,2021-06-09
7972,2302,麗正,67000,114000,-47000,0,0,0,0,0,0,0,0,0,0,0,0,0,-47000,2021-06-09
7973,089751,立積統一11購03,0,0,0,0,0,0,0,0,0,-47000,0,0,0,3000,50000,-47000,-47000,2021-06-09
7974,089265,南電統一0B購01,0,0,0,0,0,0,0,0,0,-47000,0,0,0,19000,66000,-47000,-47000,2021-06-09
7975,084842,聯發科元富0B購03,0,0,0,0,0,0,0,0,0,-48000,0,0,0,10000,58000,-48000,-48000,2021-06-09
7976,083616,中興電凱基0A購01,0,0,0,0,0,0,0,0,0,-48000,0,0,0,0,48000,-48000,-48000,2021-06-09
7977,084002,矽格永豐07購02,0,0,0,0,0,0,0,0,0,-48000,0,0,0,0,48000,-48000,-48000,2021-06-09
7978,086093,中橡永豐08購01,0,0,0,0,0,0,0,0,0,-48000,0,0,0,2000,50000,-48000,-48000,2021-06-09
7979,033400,和桐中信0C購01,0,0,0,0,0,0,0,0,0,-48000,0,0,0,12000,60000,-48000,-48000,2021-06-09
7980,030369,圓展群益0A購01,0,0,0,0,0,0,0,0,0,-48000,0,0,0,0,48000,-48000,-48000,2021-06-09
7981,00682U,期元大美元指數,0,0,0,0,0,0,0,0,0,-48000,0,0,0,0,48000,-48000,-48000,2021-06-09
7982,030608,南亞科元大0A購02,0,0,0,0,0,0,0,0,0,-48000,0,0,0,2000,50000,-48000,-48000,2021-06-09
7983,030864,王品永豐0A購01,0,0,0,0,0,0,0,0,0,-48000,0,0,0,0,48000,-48000,-48000,2021-06-09
7984,033157,矽創元大0C購02,0,0,0,0,0,0,0,0,0,-48000,0,0,0,0,48000,-48000,-48000,2021-06-09
7985,035162,國巨國票0B購05,0,0,0,0,0,0,0,0,0,-48000,0,0,0,108000,156000,-48000,-48000,2021-06-09
7986,035122,長榮永豐0B購05,0,0,0,0,0,0,0,0,0,-48000,0,0,0,12000,60000,-48000,-48000,2021-06-09
7987,035075,禾伸堂群益0B購01,0,0,0,0,0,0,0,0,0,-48000,0,0,0,0,48000,-48000,-48000,2021-06-09
7988,034126,聯發科兆豐0C購01,0,0,0,0,0,0,0,0,0,-48000,0,0,0,0,48000,-48000,-48000,2021-06-09
7989,07048P,富邦金元富12售05,0,0,0,0,0,0,0,0,0,-48000,0,0,0,2000,50000,-48000,-48000,2021-06-09
7990,06496P,大立光凱基09售09,0,0,0,0,0,0,0,0,0,-48000,0,0,0,0,48000,-48000,-48000,2021-06-09
7991,081820,廣宇凱基09購01,0,0,0,0,0,0,0,0,0,-48000,0,0,0,0,48000,-48000,-48000,2021-06-09
7992,1582,信錦,77000,125000,-48000,0,0,0,0,0,0,0,0,0,0,0,0,0,-48000,2021-06-09
7993,4720,德淵,31000,79000,-48000,0,0,0,0,0,0,0,0,0,0,0,0,0,-48000,2021-06-09
7994,085191,T50正2群益09購03,0,0,0,0,0,0,0,0,0,-49000,0,0,0,7000,56000,-49000,-49000,2021-06-09
7995,086646,精成科凱基0A購01,0,0,0,0,0,0,0,0,0,-49000,0,0,0,0,49000,-49000,-49000,2021-06-09
7996,087030,T50正2凱基0B購01,0,0,0,0,0,0,0,0,0,-49000,0,0,0,10000,59000,-49000,-49000,2021-06-09
7997,030671,惠特永豐0A購02,0,0,0,0,0,0,0,0,0,-49000,0,0,0,200000,249000,-49000,-49000,2021-06-09
7998,030045,瑞昱元大0A購01,0,0,0,0,0,0,0,0,0,-49000,0,0,0,6000,55000,-49000,-49000,2021-06-09
7999,033496,聯發科統一15購04,0,0,0,0,0,0,0,0,0,-49000,0,0,0,0,49000,-49000,-49000,2021-06-09
8000,033097,聯發科元富12購04,0,0,0,0,0,0,0,0,0,-49000,0,0,0,238000,287000,-49000,-49000,2021-06-09
8001,032087,國喬永豐0A購02,0,0,0,0,0,0,0,0,0,-49000,0,0,0,200000,249000,-49000,-49000,2021-06-09
8002,032452,群創元大12購04,0,0,0,0,0,0,0,0,0,-49000,0,0,0,499000,548000,-49000,-49000,2021-06-09
8003,06976P,長榮元富0A售21,0,0,0,0,0,0,0,0,0,-49000,0,0,0,77000,126000,-49000,-49000,2021-06-09
8004,074171,奇鋐統一06購01,0,0,0,0,0,0,0,0,0,-49000,0,0,0,0,49000,-49000,-49000,2021-06-09
8005,076738,台積電凱基08購05,0,0,0,0,0,0,0,0,0,-49000,0,0,0,22000,71000,-49000,-49000,2021-06-09
8006,2506,太設,3000,52000,-49000,0,0,0,0,0,0,-44,0,44,-44,0,0,0,-49044,2021-06-09
8007,086691,國巨元富0C購02,0,0,0,0,0,0,0,0,0,-50000,0,0,0,0,50000,-50000,-50000,2021-06-09
8008,086607,TPK永豐09購01,0,0,0,0,0,0,0,0,0,-50000,0,0,0,400000,450000,-50000,-50000,2021-06-09
8009,087536,道瓊銅統一0C購01,0,0,0,0,0,0,0,0,0,-50000,0,0,0,0,50000,-50000,-50000,2021-06-09
8010,087564,國泰金國票0A購01,0,0,0,0,0,0,0,0,0,-50000,0,0,0,0,50000,-50000,-50000,2021-06-09
8011,087455,台達化國票0A購02,0,0,0,0,0,0,0,0,0,-50000,0,0,0,0,50000,-50000,-50000,2021-06-09
8012,087351,聯電麥證09購02,0,0,0,8000,58000,-50000,0,0,0,-50000,0,0,0,12000,62000,-50000,-50000,2021-06-09
8013,087268,帆宣富邦0B購01,0,0,0,0,0,0,0,0,0,-50000,0,0,0,0,50000,-50000,-50000,2021-06-09
8014,087224,松翰凱基09購01,0,0,0,0,0,0,0,0,0,-50000,0,0,0,24000,74000,-50000,-50000,2021-06-09
8015,087232,台達化兆豐09購01,0,0,0,0,0,0,0,0,0,-50000,0,0,0,0,50000,-50000,-50000,2021-06-09
8016,087324,晶豪科永豐09購01,0,0,0,0,0,0,0,0,0,-50000,0,0,0,0,50000,-50000,-50000,2021-06-09
8017,088090,可成元富0C購01,0,0,0,0,0,0,0,0,0,-50000,0,0,0,0,50000,-50000,-50000,2021-06-09
8018,088443,同欣電凱基09購03,0,0,0,0,0,0,0,0,0,-50000,0,0,0,50000,100000,-50000,-50000,2021-06-09
8019,088710,華碩中信09購02,0,0,0,0,0,0,0,0,0,-50000,0,0,0,0,50000,-50000,-50000,2021-06-09
8020,085206,台郡群益09購01,0,0,0,0,0,0,0,0,0,-50000,0,0,0,0,50000,-50000,-50000,2021-06-09
8021,085335,A50正2中信09購01,0,0,0,0,0,0,0,0,0,-50000,0,0,0,0,50000,-50000,-50000,2021-06-09
8022,085621,T50反1凱基0C購05,0,0,0,0,0,0,0,0,0,-50000,0,0,0,20000,70000,-50000,-50000,2021-06-09
8023,085848,旺宏統一09購05,0,0,0,0,0,0,0,0,0,-50000,0,0,0,0,50000,-50000,-50000,2021-06-09
8024,086310,南亞科凱基11購01,0,0,0,0,0,0,0,0,0,-50000,0,0,0,0,50000,-50000,-50000,2021-06-09
8025,086259,聚陽永豐09購01,0,0,0,0,0,0,0,0,0,-50000,0,0,0,0,50000,-50000,-50000,2021-06-09
8026,084028,中興電元富07購04,0,0,0,0,0,0,0,0,0,-50000,0,0,0,0,50000,-50000,-50000,2021-06-09
8027,083756,義隆富邦08購01,0,0,0,0,0,0,0,0,0,-50000,0,0,0,0,50000,-50000,-50000,2021-06-09
8028,083793,瑞昱統一08購01,0,0,0,0,0,0,0,0,0,-50000,0,0,0,0,50000,-50000,-50000,2021-06-09
8029,083450,鈺齊凱基08購01,0,0,0,0,0,0,0,0,0,-50000,0,0,0,0,50000,-50000,-50000,2021-06-09
8030,084291,松翰永豐07購02,0,0,0,0,0,0,0,0,0,-50000,0,0,0,0,50000,-50000,-50000,2021-06-09
8031,032494,上緯控兆豐0B購01,0,0,0,0,0,0,0,0,0,-50000,0,0,0,0,50000,-50000,-50000,2021-06-09
8032,032511,裕民永豐0A購04,0,0,0,0,0,0,0,0,0,-50000,0,0,0,0,50000,-50000,-50000,2021-06-09
8033,031804,中石化元大0B購01,0,0,0,0,0,0,0,0,0,-50000,0,0,0,0,50000,-50000,-50000,2021-06-09
8034,032574,滬深2X元大0A購07,0,0,0,0,0,0,0,0,0,-50000,0,0,0,10000,60000,-50000,-50000,2021-06-09
8035,032568,群創群益11購03,0,0,0,0,0,0,0,0,0,-50000,0,0,0,0,50000,-50000,-50000,2021-06-09
8036,032624,臺股指元大0C購10,0,0,0,0,0,0,0,0,0,-50000,0,0,0,0,50000,-50000,-50000,2021-06-09
8037,032302,金寶永豐0A購02,0,0,0,0,0,0,0,0,0,-50000,0,0,0,0,50000,-50000,-50000,2021-06-09
8038,031244,南亞科群益0B購05,0,0,0,0,0,0,0,0,0,-50000,0,0,0,0,50000,-50000,-50000,2021-06-09
8039,030200,中環凱基0C購01,0,0,0,0,0,0,0,0,0,-50000,0,0,0,30000,80000,-50000,-50000,2021-06-09
8040,030350,立隆電群益0A購01,0,0,0,0,0,0,0,0,0,-50000,0,0,0,0,50000,-50000,-50000,2021-06-09
8041,030664,群創永豐0A購04,0,0,0,0,0,0,0,0,0,-50000,0,0,0,0,50000,-50000,-50000,2021-06-09
8042,030808,大成鋼富邦0C購01,0,50000,-50000,0,0,0,0,0,0,0,0,0,0,0,0,0,-50000,2021-06-09
8043,031576,矽統凱基0A購01,0,0,0,0,0,0,0,0,0,-50000,0,0,0,142000,192000,-50000,-50000,2021-06-09
8044,031531,鴻海富邦0C購02,0,0,0,0,0,0,0,0,0,-50000,0,0,0,0,50000,-50000,-50000,2021-06-09
8045,031015,群創永豐0A購05,0,0,0,0,0,0,0,0,0,-50000,0,0,0,0,50000,-50000,-50000,2021-06-09
8046,034129,中壽兆豐12購02,0,0,0,0,0,0,0,0,0,-50000,0,0,0,0,50000,-50000,-50000,2021-06-09
8047,033797,同欣電元大0B購01,0,0,0,0,0,0,0,0,0,-50000,0,0,0,0,50000,-50000,-50000,2021-06-09
8048,034458,技嘉群益0C購03,0,0,0,0,0,0,0,0,0,-50000,0,0,0,0,50000,-50000,-50000,2021-06-09
8049,034501,台灣50凱基0B購06,0,0,0,0,0,0,0,0,0,-50000,0,0,0,0,50000,-50000,-50000,2021-06-09
8050,034908,南亞科元大0C購03,0,0,0,0,0,0,0,0,0,-50000,0,0,0,26000,76000,-50000,-50000,2021-06-09
8051,035535,華新科兆豐0B購01,0,0,0,0,0,0,0,0,0,-50000,0,0,0,0,50000,-50000,-50000,2021-06-09
8052,034800,技嘉凱基0B購02,0,0,0,0,0,0,0,0,0,-50000,0,0,0,29000,79000,-50000,-50000,2021-06-09
8053,033722,富邦金國票0B購02,0,0,0,0,0,0,0,0,0,-50000,0,0,0,5000,55000,-50000,-50000,2021-06-09
8054,080855,台郡元富08購01,0,0,0,0,0,0,0,0,0,-50000,0,0,0,0,50000,-50000,-50000,2021-06-09
8055,06049P,美利達元大07售02,0,0,0,0,0,0,0,0,0,-50000,0,0,0,0,50000,-50000,-50000,2021-06-09
8056,033885,貿聯元富0B購01,0,0,0,0,0,0,0,0,0,-50000,0,0,0,0,50000,-50000,-50000,2021-06-09
8057,036566,健策元大11購02,0,0,0,0,0,0,0,0,0,-50000,0,0,0,1000,51000,-50000,-50000,2021-06-09
8058,05395P,T50正2元大09售04,0,0,0,0,0,0,0,0,0,-50000,0,0,0,0,50000,-50000,-50000,2021-06-09
8059,034287,中壽兆豐0B購01,0,0,0,0,0,0,0,0,0,-50000,0,0,0,0,50000,-50000,-50000,2021-06-09
8060,035486,富邦金群益11購04,0,0,0,0,0,0,0,0,0,-50000,0,0,0,1000,51000,-50000,-50000,2021-06-09
8061,034004,友達群益0B購03,0,0,0,0,0,0,0,0,0,-50000,0,0,0,96000,146000,-50000,-50000,2021-06-09
8062,033943,華新國票0B購01,0,0,0,0,0,0,0,0,0,-50000,0,0,0,0,50000,-50000,-50000,2021-06-09
8063,077807,瑞儀元富08購01,0,0,0,0,0,0,0,0,0,-50000,0,0,0,0,50000,-50000,-50000,2021-06-09
8064,078600,臻鼎元大07購01,0,0,0,0,0,0,0,0,0,-50000,0,0,0,0,50000,-50000,-50000,2021-06-09
8065,076555,全新元富08購01,0,0,0,0,0,0,0,0,0,-50000,0,0,0,0,50000,-50000,-50000,2021-06-09
8066,07275P,玉晶光元大0C售06,0,0,0,0,0,0,0,0,0,-50000,0,0,0,0,50000,-50000,-50000,2021-06-09
8067,073404,可成元富07購08,0,0,0,0,0,0,0,0,0,-50000,0,0,0,0,50000,-50000,-50000,2021-06-09
8068,07286P,玉晶光元富13售05,0,0,0,0,0,0,0,0,0,-50000,0,0,0,0,50000,-50000,-50000,2021-06-09
8069,069043,上銀元富08購01,0,0,0,0,0,0,0,0,0,-50000,0,0,0,92000,142000,-50000,-50000,2021-06-09
8070,06851P,長榮康和0A售06,0,0,0,0,0,0,0,0,0,-50000,0,0,0,0,50000,-50000,-50000,2021-06-09
8071,07039P,南電群益0B售04,0,0,0,0,0,0,0,0,0,-50000,0,0,0,0,50000,-50000,-50000,2021-06-09
8072,06549P,臺股指元大09售11,0,0,0,0,0,0,0,0,0,-50000,0,0,0,0,50000,-50000,-50000,2021-06-09
8073,081809,上銀凱基09購01,0,0,0,0,0,0,0,0,0,-50000,0,0,0,0,50000,-50000,-50000,2021-06-09
8074,081878,上証2X群益07購01,0,0,0,0,0,0,0,0,0,-50000,0,0,0,0,50000,-50000,-50000,2021-06-09
8075,082067,亞德客元大07購02,0,0,0,0,0,0,0,0,0,-50000,0,0,0,0,50000,-50000,-50000,2021-06-09
8076,082787,瑞昱元富08購01,0,0,0,0,0,0,0,0,0,-50000,0,0,0,0,50000,-50000,-50000,2021-06-09
8077,082860,台灣50中信09購01,0,0,0,0,0,0,0,0,0,-50000,0,0,0,0,50000,-50000,-50000,2021-06-09
8078,082696,台積電凱基0C購02,0,0,0,0,0,0,0,0,0,-50000,0,0,0,0,50000,-50000,-50000,2021-06-09
8079,082555,美指2X統一09購01,0,0,0,0,0,0,0,0,0,-50000,0,0,0,0,50000,-50000,-50000,2021-06-09
8080,083182,宏碁國票08購01,0,0,0,0,0,0,0,0,0,-50000,0,0,0,0,50000,-50000,-50000,2021-06-09
8081,082975,瑞昱元大07購05,0,0,0,0,0,0,0,0,0,-50000,0,0,0,0,50000,-50000,-50000,2021-06-09
8082,082943,鴻海元富07購23,0,0,0,0,0,0,0,0,0,-50000,0,0,0,350000,400000,-50000,-50000,2021-06-09
8083,082908,高鐵群益09購01,0,0,0,0,0,0,0,0,0,-50000,0,0,0,0,50000,-50000,-50000,2021-06-09
8084,081329,台泥群益09購01,0,0,0,0,0,0,0,0,0,-50000,0,0,0,224000,274000,-50000,-50000,2021-06-09
8085,081355,光磊凱基08購01,0,0,0,0,0,0,0,0,0,-50000,0,0,0,50000,100000,-50000,-50000,2021-06-09
8086,081047,台郡富邦09購01,0,0,0,0,0,0,0,0,0,-50000,0,0,0,0,50000,-50000,-50000,2021-06-09
8087,080553,南亞科國泰08購01,0,0,0,0,0,0,0,0,0,-50000,0,0,0,20000,70000,-50000,-50000,2021-06-09
8088,079759,瑞昱元富07購05,0,0,0,0,0,0,0,0,0,-50000,0,0,0,0,50000,-50000,-50000,2021-06-09
8089,079979,喬山統一08購01,0,0,0,0,0,0,0,0,0,-50000,0,0,0,0,50000,-50000,-50000,2021-06-09
8090,1805,寶徠,3000,53000,-50000,0,0,0,0,0,0,0,0,0,0,0,0,0,-50000,2021-06-09
8091,3058,立德,225000,275000,-50000,0,0,0,0,0,0,0,0,0,0,0,0,0,-50000,2021-06-09
8092,089082,臺股指凱基0C購18,0,0,0,0,0,0,0,0,0,-50000,0,0,0,0,50000,-50000,-50000,2021-06-09
8093,088754,南亞科統一0B購04,0,0,0,0,0,0,0,0,0,-51000,0,0,0,0,51000,-51000,-51000,2021-06-09
8094,088611,華碩永豐09購02,0,0,0,0,0,0,0,0,0,-51000,0,0,0,1000,52000,-51000,-51000,2021-06-09
8095,087801,南電麥證0A購02,0,0,0,0,51000,-51000,0,0,0,-51000,0,0,0,0,51000,-51000,-51000,2021-06-09
8096,086575,台郡元大0B購01,0,0,0,0,0,0,0,0,0,-51000,0,0,0,3000,54000,-51000,-51000,2021-06-09
8097,030974,凌陽元大0A購02,0,0,0,0,0,0,0,0,0,-51000,0,0,0,124000,175000,-51000,-51000,2021-06-09
8098,031827,台灣50富邦0C購02,0,0,0,0,0,0,0,0,0,-51000,0,0,0,0,51000,-51000,-51000,2021-06-09
8099,032070,華碩中信0B購01,0,0,0,0,0,0,0,0,0,-51000,0,0,0,0,51000,-51000,-51000,2021-06-09
8100,031958,友訊元大0A購03,0,0,0,0,0,0,0,0,0,-51000,0,0,0,69000,120000,-51000,-51000,2021-06-09
8101,035879,聯詠群益11購03,0,0,0,0,0,0,0,0,0,-51000,0,0,0,20000,71000,-51000,-51000,2021-06-09
8102,035176,群創國票0C購01,0,0,0,0,0,0,0,0,0,-51000,0,0,0,300000,351000,-51000,-51000,2021-06-09
8103,035332,台表科元大0B購03,0,0,0,0,0,0,0,0,0,-51000,0,0,0,69000,120000,-51000,-51000,2021-06-09
8104,034467,亞聚元大0B購03,0,0,0,0,0,0,0,0,0,-51000,0,0,0,0,51000,-51000,-51000,2021-06-09
8105,034030,中鋼元富0B購03,0,0,0,0,0,0,0,0,0,-51000,0,0,0,225000,276000,-51000,-51000,2021-06-09
8106,082914,樺漢群益08購01,0,0,0,0,0,0,0,0,0,-51000,0,0,0,0,51000,-51000,-51000,2021-06-09
8107,083063,偉詮電永豐07購03,0,0,0,0,0,0,0,0,0,-51000,0,0,0,11000,62000,-51000,-51000,2021-06-09
8108,082773,愛普統一09購06,0,0,0,0,0,0,0,0,0,-51000,0,0,0,0,51000,-51000,-51000,2021-06-09
8109,082266,亞德客元大07購03,0,0,0,0,0,0,0,0,0,-51000,0,0,0,0,51000,-51000,-51000,2021-06-09
8110,082403,偉詮電凱基07購01,0,0,0,0,0,0,0,0,0,-51000,0,0,0,0,51000,-51000,-51000,2021-06-09
8111,081815,鴻海凱基08購03,0,0,0,0,0,0,0,0,0,-51000,0,0,0,0,51000,-51000,-51000,2021-06-09
8112,06557P,臺股指群益09售09,0,0,0,0,0,0,0,0,0,-51000,0,0,0,5000,56000,-51000,-51000,2021-06-09
8113,078641,全新凱基08購02,0,0,0,0,0,0,0,0,0,-51000,0,0,0,0,51000,-51000,-51000,2021-06-09
8114,078735,旺宏元富0C購01,0,0,0,0,0,0,0,0,0,-51000,0,0,0,0,51000,-51000,-51000,2021-06-09
8115,077217,聯電凱基09購01,0,0,0,0,0,0,0,0,0,-51000,0,0,0,673000,724000,-51000,-51000,2021-06-09
8116,1441,大東,6000,57000,-51000,0,0,0,0,0,0,0,0,0,0,0,0,0,-51000,2021-06-09
8117,1321,大洋,0,51000,-51000,0,0,0,0,0,0,0,0,0,0,0,0,0,-51000,2021-06-09
8118,088032,台灣50元大0C購01,0,0,0,0,0,0,0,0,0,-52000,0,0,0,0,52000,-52000,-52000,2021-06-09
8119,036288,台積電元大13購01,0,0,0,0,0,0,0,0,0,-52000,0,0,0,0,52000,-52000,-52000,2021-06-09
8120,032949,聚陽元大0B購01,0,0,0,0,0,0,0,0,0,-52000,0,0,0,39000,91000,-52000,-52000,2021-06-09
8121,035845,智原元大0B購06,0,0,0,0,0,0,0,0,0,-52000,0,0,0,159000,211000,-52000,-52000,2021-06-09
8122,035475,國泰金富邦13購02,0,0,0,0,0,0,0,0,0,-52000,0,0,0,11000,63000,-52000,-52000,2021-06-09
8123,078387,圓剛國泰08購02,0,0,0,0,0,0,0,0,0,-52000,0,0,0,0,52000,-52000,-52000,2021-06-09
8124,06468P,大成鋼元富09售01,0,0,0,0,0,0,0,0,0,-52000,0,0,0,35000,87000,-52000,-52000,2021-06-09
8125,07067P,大亞元大0B售03,0,0,0,0,0,0,0,0,0,-52000,0,0,0,0,52000,-52000,-52000,2021-06-09
8126,079125,臺股指凱基09購05,0,0,0,0,0,0,0,0,0,-52000,0,0,0,0,52000,-52000,-52000,2021-06-09
8127,088786,台達電富邦0A購01,0,0,0,0,0,0,0,0,0,-53000,0,0,0,87000,140000,-53000,-53000,2021-06-09
8128,085612,大立光元大0C購03,0,0,0,0,0,0,0,0,0,-53000,0,0,0,85000,138000,-53000,-53000,2021-06-09
8129,031913,微星永豐0A購01,0,0,0,0,0,0,0,0,0,-53000,0,0,0,0,53000,-53000,-53000,2021-06-09
8130,030648,聯發科日盛14購01,0,0,0,0,0,0,0,0,0,-53000,0,0,0,4000,57000,-53000,-53000,2021-06-09
8131,030135,農林凱基11購01,0,0,0,0,0,0,0,0,0,-53000,0,0,0,8000,61000,-53000,-53000,2021-06-09
8132,031431,新興凱基0A購01,0,2000,-2000,0,0,0,0,0,0,-51000,0,0,0,52000,103000,-51000,-53000,2021-06-09
8133,035738,國泰金國票0C購05,0,0,0,0,0,0,0,0,0,-53000,0,0,0,0,53000,-53000,-53000,2021-06-09
8134,036074,臺股指群益0C購01,0,0,0,0,0,0,0,0,0,-53000,0,0,0,0,53000,-53000,-53000,2021-06-09
8135,06348P,大立光元大08售07,0,0,0,0,0,0,0,0,0,-53000,0,0,0,2000,55000,-53000,-53000,2021-06-09
8136,080355,台灣50元富09購03,0,0,0,0,0,0,0,0,0,-53000,0,0,0,0,53000,-53000,-53000,2021-06-09
8137,071993,智邦元富09購02,0,0,0,0,0,0,0,0,0,-53000,0,0,0,0,53000,-53000,-53000,2021-06-09
8138,075604,台積電凱基08購02,0,0,0,0,0,0,0,0,0,-53000,0,0,0,4000,57000,-53000,-53000,2021-06-09
8139,6141,柏承,78000,131000,-53000,0,0,0,0,0,0,0,0,0,0,0,0,0,-53000,2021-06-09
8140,085272,大立光元富08購02,0,0,0,0,0,0,0,0,0,-54000,0,0,0,0,54000,-54000,-54000,2021-06-09
8141,030638,滬深2X中信0B購02,0,0,0,0,0,0,0,0,0,-54000,0,0,0,2000,56000,-54000,-54000,2021-06-09
8142,031746,廣宇凱基12購01,0,0,0,0,0,0,0,0,0,-54000,0,0,0,8000,62000,-54000,-54000,2021-06-09
8143,033443,欣興元大12購01,0,0,0,0,0,0,0,0,0,-54000,0,0,0,19000,73000,-54000,-54000,2021-06-09
8144,036341,康控元富0C購01,0,0,0,0,0,0,0,0,0,-54000,0,0,0,0,54000,-54000,-54000,2021-06-09
8145,03731P,國巨元富08售08,0,0,0,0,0,0,0,0,0,-54000,0,0,0,20000,74000,-54000,-54000,2021-06-09
8146,035204,愛普元富15購01,0,0,0,0,0,0,0,0,0,-54000,0,0,0,0,54000,-54000,-54000,2021-06-09
8147,034002,旺宏群益0C購06,0,0,0,0,0,0,0,0,0,-54000,0,0,0,1000,55000,-54000,-54000,2021-06-09
8148,034479,聯電元大0C購07,0,0,0,0,0,0,0,0,0,-54000,0,0,0,115000,169000,-54000,-54000,2021-06-09
8149,034961,聯成元大0B購03,0,0,0,0,0,0,0,0,0,-54000,0,0,0,204000,258000,-54000,-54000,2021-06-09
8150,081360,麗豐凱基0A購01,0,0,0,0,0,0,0,0,0,-54000,0,0,0,5000,59000,-54000,-54000,2021-06-09
8151,6197,佳必琪,12000,66000,-54000,0,0,0,0,0,0,0,0,0,0,0,0,0,-54000,2021-06-09
8152,1464,得力,32000,86000,-54000,0,0,0,0,0,0,0,0,0,0,0,0,0,-54000,2021-06-09
8153,4930,燦星網,69000,123000,-54000,0,0,0,0,0,0,0,0,0,0,0,0,0,-54000,2021-06-09
8154,088640,偉詮電國票0A購02,0,0,0,0,0,0,0,0,0,-55000,0,0,0,12000,67000,-55000,-55000,2021-06-09
8155,088229,南電元富09購07,0,0,0,0,0,0,0,0,0,-55000,0,0,0,12000,67000,-55000,-55000,2021-06-09
8156,087101,台積電元大09購18,0,0,0,0,0,0,0,0,0,-55000,0,0,0,0,55000,-55000,-55000,2021-06-09
8157,087514,力山凱基0B購01,0,0,0,0,0,0,0,0,0,-55000,0,0,0,52000,107000,-55000,-55000,2021-06-09
8158,033117,臺指反元大12購02,0,0,0,0,0,0,0,0,0,-55000,0,0,0,0,55000,-55000,-55000,2021-06-09
8159,033319,新纖凱基0B購02,0,0,0,0,0,0,0,0,0,-55000,0,0,0,0,55000,-55000,-55000,2021-06-09
8160,030632,惠特元大0A購01,0,0,0,0,0,0,0,0,0,-55000,0,0,0,0,55000,-55000,-55000,2021-06-09
8161,030109,明泰永豐0A購01,0,0,0,0,0,0,0,0,0,-55000,0,0,0,0,55000,-55000,-55000,2021-06-09
8162,033874,緯穎群益0C購01,0,0,0,0,0,0,0,0,0,-55000,0,0,0,0,55000,-55000,-55000,2021-06-09
8163,034436,新光鋼凱基0C購02,0,0,0,0,0,0,0,0,0,-55000,0,0,0,0,55000,-55000,-55000,2021-06-09
8164,034604,聯發科統一0B購08,0,0,0,0,0,0,0,0,0,-55000,0,0,0,120000,175000,-55000,-55000,2021-06-09
8165,034046,裕民元富12購03,0,0,0,0,0,0,0,0,0,-55000,0,0,0,0,55000,-55000,-55000,2021-06-09
8166,035799,鴻海第一15購02,0,0,0,0,0,0,0,0,0,-55000,0,0,0,0,55000,-55000,-55000,2021-06-09
8167,082416,瑞昱永豐07購01,0,0,0,0,0,0,0,0,0,-55000,0,0,0,0,55000,-55000,-55000,2021-06-09
8168,082503,緯穎統一09購01,0,0,0,0,0,0,0,0,0,-55000,0,0,0,0,55000,-55000,-55000,2021-06-09
8169,075530,台積電國票08購03,0,0,0,0,0,0,0,0,0,-55000,0,0,0,24000,79000,-55000,-55000,2021-06-09
8170,073113,精元元富08購01,0,0,0,0,0,0,0,0,0,-55000,0,0,0,0,55000,-55000,-55000,2021-06-09
8171,06375P,南電元大08售08,0,0,0,0,0,0,0,0,0,-55000,0,0,0,0,55000,-55000,-55000,2021-06-09
8172,089695,惠特元大09購04,0,0,0,0,0,0,0,0,0,-55000,0,0,0,0,55000,-55000,-55000,2021-06-09
8173,089545,凌陽國泰0B購01,0,0,0,0,0,0,0,0,0,-55000,0,0,0,0,55000,-55000,-55000,2021-06-09
8174,8271,宇瞻,196000,251000,-55000,0,0,0,0,0,0,0,0,0,0,0,0,0,-55000,2021-06-09
8175,087190,上銀麥證09購01,0,0,0,77000,133000,-56000,0,0,0,-56000,0,0,0,77000,133000,-56000,-56000,2021-06-09
8176,085329,冠德群益09購01,0,0,0,0,0,0,0,0,0,-56000,0,0,0,33000,89000,-56000,-56000,2021-06-09
8177,084396,統一國票08購01,0,0,0,0,0,0,0,0,0,-56000,0,0,0,10000,66000,-56000,-56000,2021-06-09
8178,084452,凌陽永豐08購01,0,0,0,0,0,0,0,0,0,-56000,0,0,0,0,56000,-56000,-56000,2021-06-09
8179,031213,友達凱基12購01,0,0,0,0,0,0,0,0,0,-56000,0,0,0,0,56000,-56000,-56000,2021-06-09
8180,030408,聯發科元大0A購06,0,0,0,0,0,0,0,0,0,-56000,0,0,0,0,56000,-56000,-56000,2021-06-09
8181,030606,華邦電元大12購01,0,0,0,0,0,0,0,0,0,-56000,0,0,0,0,56000,-56000,-56000,2021-06-09
8182,030996,滬深2X國泰0C購01,0,0,0,0,0,0,0,0,0,-56000,0,0,0,10000,66000,-56000,-56000,2021-06-09
8183,031104,聯發科群益0A購01,0,0,0,0,0,0,0,0,0,-56000,0,0,0,284000,340000,-56000,-56000,2021-06-09
8184,033486,台玻統一11購03,0,0,0,0,0,0,0,0,0,-56000,0,0,0,0,56000,-56000,-56000,2021-06-09
8185,033978,聯詠凱基0B購04,0,0,0,0,0,0,0,0,0,-56000,0,0,0,10000,66000,-56000,-56000,2021-06-09
8186,035447,聯電國票0B購05,0,0,0,0,0,0,0,0,0,-56000,0,0,0,1000,57000,-56000,-56000,2021-06-09
8187,036490,台郡富邦13購01,0,0,0,0,0,0,0,0,0,-56000,0,0,0,0,56000,-56000,-56000,2021-06-09
8188,036448,長榮航元富12購02,0,0,0,0,0,0,0,0,0,-56000,0,0,0,35000,91000,-56000,-56000,2021-06-09
8189,00662,富邦NASDAQ,1,5000,-4999,0,0,0,0,0,0,-52000,0,0,0,105000,157000,-52000,-56999,2021-06-09
8190,085614,亞光元大09購01,0,0,0,0,0,0,0,0,0,-57000,0,0,0,6000,63000,-57000,-57000,2021-06-09
8191,085530,南電中信0A購02,0,0,0,0,0,0,0,0,0,-57000,0,0,0,91000,148000,-57000,-57000,2021-06-09
8192,085381,松翰群益08購03,0,0,0,0,0,0,0,0,0,-57000,0,0,0,20000,77000,-57000,-57000,2021-06-09
8193,087586,華新科元大0C購02,0,0,0,0,0,0,0,0,0,-57000,0,0,0,45000,102000,-57000,-57000,2021-06-09
8194,088523,南亞科國泰0B購01,0,0,0,0,0,0,0,0,0,-57000,0,0,0,0,57000,-57000,-57000,2021-06-09
8195,031074,和碩元大0B購01,0,0,0,0,0,0,0,0,0,-57000,0,0,0,60000,117000,-57000,-57000,2021-06-09
8196,032648,台泥元富0A購01,0,0,0,0,0,0,0,0,0,-57000,0,0,0,0,57000,-57000,-57000,2021-06-09
8197,032004,晶技群益0B購01,0,0,0,0,0,0,0,0,0,-57000,0,0,0,5000,62000,-57000,-57000,2021-06-09
8198,05613P,聯電凱基07售05,0,0,0,0,0,0,0,0,0,-57000,0,0,0,0,57000,-57000,-57000,2021-06-09
8199,05657P,大立光元大07售06,0,0,0,0,0,0,0,0,0,-57000,0,0,0,0,57000,-57000,-57000,2021-06-09
8200,036016,南電凱基0C購02,0,0,0,0,0,0,0,0,0,-57000,0,0,0,0,57000,-57000,-57000,2021-06-09
8201,034310,智原永豐0B購03,0,0,0,0,0,0,0,0,0,-57000,0,0,0,113000,170000,-57000,-57000,2021-06-09
8202,035769,訊芯元富13購01,0,0,0,0,0,0,0,0,0,-57000,0,0,0,151000,208000,-57000,-57000,2021-06-09
8203,06576P,南亞科元大09售04,0,0,0,0,0,0,0,0,0,-57000,0,0,0,27000,84000,-57000,-57000,2021-06-09
8204,067844,全新元富07購01,0,0,0,0,0,0,0,0,0,-57000,0,0,0,24000,81000,-57000,-57000,2021-06-09
8205,078989,香港2X凱基07購01,0,0,0,0,0,0,0,0,0,-57000,0,0,0,8000,65000,-57000,-57000,2021-06-09
8206,088408,訊芯永豐09購01,0,0,0,0,0,0,0,0,0,-58000,0,0,0,10000,68000,-58000,-58000,2021-06-09
8207,086606,華碩永豐09購01,0,0,0,0,0,0,0,0,0,-58000,0,0,0,1000,59000,-58000,-58000,2021-06-09
8208,032980,惠特元大0B購03,0,0,0,0,0,0,0,0,0,-58000,0,0,0,18000,76000,-58000,-58000,2021-06-09
8209,030269,台積電統一0A購11,0,0,0,0,0,0,0,0,0,-58000,0,0,0,0,58000,-58000,-58000,2021-06-09
8210,035739,亞光國票0B購01,0,0,0,0,0,0,0,0,0,-58000,0,0,0,20000,78000,-58000,-58000,2021-06-09
8211,06414P,大立光元大09售07,0,0,0,0,0,0,0,0,0,-58000,0,0,0,0,58000,-58000,-58000,2021-06-09
8212,07081P,國泰金凱基0B售05,0,0,0,0,0,0,0,0,0,-58000,0,0,0,0,58000,-58000,-58000,2021-06-09
8213,07022P,友達中信0B售05,0,0,0,0,0,0,0,0,0,-58000,0,0,0,2000,60000,-58000,-58000,2021-06-09
8214,07177P,台積電富邦11售04,0,0,0,0,0,0,0,0,0,-58000,0,0,0,0,58000,-58000,-58000,2021-06-09
8215,07156P,萬海元大0B售09,0,0,0,0,0,0,0,0,0,-58000,0,0,0,146000,204000,-58000,-58000,2021-06-09
8216,082498,信邦統一09購01,0,0,0,0,0,0,0,0,0,-58000,0,0,0,0,58000,-58000,-58000,2021-06-09
8217,8210,勤誠,13000,71000,-58000,0,0,0,0,0,0,0,0,0,0,0,0,0,-58000,2021-06-09
8218,087387,旺宏元大11購01,0,0,0,0,0,0,0,0,0,-59000,0,0,0,36000,95000,-59000,-59000,2021-06-09
8219,088721,華碩凱基11購01,0,0,0,0,0,0,0,0,0,-59000,0,0,0,41000,100000,-59000,-59000,2021-06-09
8220,083579,美利達群益08購01,0,0,0,0,0,0,0,0,0,-59000,0,0,0,68000,127000,-59000,-59000,2021-06-09
8221,084119,聯發科群益08購12,0,0,0,0,0,0,0,0,0,-59000,0,0,0,26000,85000,-59000,-59000,2021-06-09
8222,032873,聚陽凱基0A購01,0,0,0,0,0,0,0,0,0,-59000,0,0,0,2000,61000,-59000,-59000,2021-06-09
8223,032857,光罩群益0B購01,0,0,0,0,0,0,0,0,0,-59000,0,0,0,168000,227000,-59000,-59000,2021-06-09
8224,031659,華碩元大0A購02,0,0,0,0,0,0,0,0,0,-59000,0,0,0,43000,102000,-59000,-59000,2021-06-09
8225,06498P,創意兆豐09售03,0,0,0,0,0,0,0,0,0,-59000,0,0,0,10000,69000,-59000,-59000,2021-06-09
8226,077720,景碩元大07購01,0,0,0,0,0,0,0,0,0,-59000,0,0,0,64000,123000,-59000,-59000,2021-06-09
8227,083882,大立光國泰0B購02,0,0,0,0,0,0,0,0,0,-60000,0,0,0,20000,80000,-60000,-60000,2021-06-09
8228,083669,聯電統一09購05,0,0,0,0,0,0,0,0,0,-60000,0,0,0,19000,79000,-60000,-60000,2021-06-09
8229,084313,宏達電凱基07購01,0,0,0,0,0,0,0,0,0,-60000,0,0,0,0,60000,-60000,-60000,2021-06-09
8230,084857,台積電元大08購14,0,0,0,0,0,0,0,0,0,-60000,0,0,0,0,60000,-60000,-60000,2021-06-09
8231,084894,台積電統一0B購09,0,0,0,0,0,0,0,0,0,-60000,0,0,0,0,60000,-60000,-60000,2021-06-09
8232,085646,聯電統一0A購05,0,0,0,0,0,0,0,0,0,-60000,0,0,0,0,60000,-60000,-60000,2021-06-09
8233,085695,聯發科國泰0A購07,0,0,0,0,0,0,0,0,0,-60000,0,0,0,0,60000,-60000,-60000,2021-06-09
8234,085366,昇陽半永豐08購01,0,0,0,0,0,0,0,0,0,-60000,0,0,0,0,60000,-60000,-60000,2021-06-09
8235,085064,京元電群益08購02,0,0,0,0,0,0,0,0,0,-60000,0,0,0,0,60000,-60000,-60000,2021-06-09
8236,086424,南亞科富邦0A購01,0,0,0,0,0,0,0,0,0,-60000,0,0,0,0,60000,-60000,-60000,2021-06-09
8237,086402,聯發科統一0B購02,0,0,0,0,0,0,0,0,0,-60000,0,0,0,0,60000,-60000,-60000,2021-06-09
8238,088904,廣宇群益0A購01,0,0,0,0,0,0,0,0,0,-60000,0,0,0,0,60000,-60000,-60000,2021-06-09
8239,088200,瑞儀群益0A購01,0,0,0,0,0,0,0,0,0,-60000,0,0,0,0,60000,-60000,-60000,2021-06-09
8240,088324,裕隆元大09購01,0,0,0,0,0,0,0,0,0,-60000,0,0,0,0,60000,-60000,-60000,2021-06-09
8241,088157,儒鴻元大0A購01,0,0,0,0,0,0,0,0,0,-60000,0,0,0,2000,62000,-60000,-60000,2021-06-09
8242,086900,統一凱基09購01,0,0,0,0,0,0,0,0,0,-60000,0,0,0,100000,160000,-60000,-60000,2021-06-09
8243,031701,燁輝永豐0A購03,0,0,0,0,0,0,0,0,0,-60000,0,0,0,21000,81000,-60000,-60000,2021-06-09
8244,032466,中環中信0B購01,0,0,0,0,0,0,0,0,0,-60000,0,0,0,0,60000,-60000,-60000,2021-06-09
8245,032515,長榮航永豐0A購02,0,0,0,0,0,0,0,0,0,-60000,0,0,0,0,60000,-60000,-60000,2021-06-09
8246,033424,嘉澤永豐0B購01,0,0,0,0,0,0,0,0,0,-60000,0,0,0,0,60000,-60000,-60000,2021-06-09
8247,031847,松翰兆豐0A購02,0,0,0,0,0,0,0,0,0,-60000,0,0,0,0,60000,-60000,-60000,2021-06-09
8248,033572,群創第一15購01,0,0,0,0,0,0,0,0,0,-60000,0,0,0,0,60000,-60000,-60000,2021-06-09
8249,033593,中石化兆豐11購01,0,0,0,0,0,0,0,0,0,-60000,0,0,0,0,60000,-60000,-60000,2021-06-09
8250,031204,直得凱基0A購01,0,0,0,0,0,0,0,0,0,-60000,0,0,0,0,60000,-60000,-60000,2021-06-09
8251,034332,順德群益0C購01,0,0,0,0,0,0,0,0,0,-60000,0,0,0,1081000,1141000,-60000,-60000,2021-06-09
8252,05712P,世紀鋼元大07售06,0,0,0,0,0,0,0,0,0,-60000,0,0,0,0,60000,-60000,-60000,2021-06-09
8253,034143,鴻海凱基14購01,0,0,0,0,0,0,0,0,0,-60000,0,0,0,0,60000,-60000,-60000,2021-06-09
8254,034218,友達元富0B購02,0,0,0,0,0,0,0,0,0,-60000,0,0,0,0,60000,-60000,-60000,2021-06-09
8255,034399,台塑國票11購01,0,0,0,0,0,0,0,0,0,-60000,0,0,0,50000,110000,-60000,-60000,2021-06-09
8256,033868,鴻海群益0B購08,0,0,0,0,0,0,0,0,0,-60000,0,0,0,0,60000,-60000,-60000,2021-06-09
8257,034966,奇力新元大0B購01,0,0,0,0,0,0,0,0,0,-60000,0,0,0,0,60000,-60000,-60000,2021-06-09
8258,034974,愛普元富0B購04,0,0,0,0,0,0,0,0,0,-60000,0,0,0,0,60000,-60000,-60000,2021-06-09
8259,033701,國喬國票0C購01,0,0,0,0,0,0,0,0,0,-60000,0,0,0,39000,99000,-60000,-60000,2021-06-09
8260,035577,國泰金康和0B購02,0,0,0,0,0,0,0,0,0,-60000,0,0,0,68000,128000,-60000,-60000,2021-06-09
8261,06346P,台灣50元大08售10,0,0,0,0,0,0,0,0,0,-60000,0,0,0,0,60000,-60000,-60000,2021-06-09
8262,078499,日月光國票08購01,0,0,0,0,0,0,0,0,0,-60000,0,0,0,0,60000,-60000,-60000,2021-06-09
8263,06735P,友達元大09售17,0,0,0,0,0,0,0,0,0,-60000,0,0,0,3000,63000,-60000,-60000,2021-06-09
8264,068123,嘉聯益元富07購01,0,0,0,0,0,0,0,0,0,-60000,0,0,0,0,60000,-60000,-60000,2021-06-09
8265,07154P,長榮元大0B售15,0,0,0,0,0,0,0,0,0,-60000,0,0,0,0,60000,-60000,-60000,2021-06-09
8266,071717,瑞昱元富09購01,0,0,0,0,0,0,0,0,0,-60000,0,0,0,12000,72000,-60000,-60000,2021-06-09
8267,082558,聯電統一09購02,0,0,0,0,0,0,0,0,0,-60000,0,0,0,3000,63000,-60000,-60000,2021-06-09
8268,081990,聯詠元大07購05,0,0,0,0,0,0,0,0,0,-60000,0,0,0,0,60000,-60000,-60000,2021-06-09
8269,081861,臺股指中信0A購03,0,0,0,0,0,0,0,0,0,-60000,0,0,0,0,60000,-60000,-60000,2021-06-09
8270,081958,南六統一09購01,0,0,0,0,0,0,0,0,0,-60000,0,0,0,0,60000,-60000,-60000,2021-06-09
8271,081277,永豐餘統一09購01,0,0,0,0,0,0,0,0,0,-60000,0,0,0,11000,71000,-60000,-60000,2021-06-09
8272,080915,嘉晶凱基09購01,0,0,0,0,0,0,0,0,0,-60000,0,0,0,0,60000,-60000,-60000,2021-06-09
8273,079320,大立光中信09購02,0,0,0,0,0,0,0,0,0,-60000,0,0,0,0,60000,-60000,-60000,2021-06-09
8274,079559,力麗國票08購01,0,0,0,0,0,0,0,0,0,-60000,0,0,0,45000,105000,-60000,-60000,2021-06-09
8275,3004,豐達科,46000,106000,-60000,0,0,0,0,0,0,0,0,0,0,0,0,0,-60000,2021-06-09
8276,1712,興農,37000,97000,-60000,0,0,0,0,0,0,0,0,0,0,0,0,0,-60000,2021-06-09
8277,086843,欣興元大09購04,0,0,0,0,0,0,0,0,0,-61000,0,0,0,5000,66000,-61000,-61000,2021-06-09
8278,087026,聯電中信0B購01,0,0,0,0,0,0,0,0,0,-61000,0,0,0,2000,63000,-61000,-61000,2021-06-09
8279,088310,聯詠凱基09購05,0,0,0,0,0,0,0,0,0,-61000,0,0,0,0,61000,-61000,-61000,2021-06-09
8280,088917,精成科群益0A購01,0,0,0,0,0,0,0,0,0,-61000,0,0,0,53000,114000,-61000,-61000,2021-06-09
8281,085499,聯詠凱基08購05,0,0,0,0,0,0,0,0,0,-61000,0,0,0,15000,76000,-61000,-61000,2021-06-09
8282,084311,京元電凱基07購02,0,0,0,0,0,0,0,0,0,-61000,0,0,0,0,61000,-61000,-61000,2021-06-09
8283,083696,廣宇元富07購05,0,0,0,0,0,0,0,0,0,-61000,0,0,0,0,61000,-61000,-61000,2021-06-09
8284,083441,聯詠凱基08購02,0,0,0,0,0,0,0,0,0,-61000,0,0,0,3000,64000,-61000,-61000,2021-06-09
8285,030653,中鋼永豐0A購01,0,0,0,0,0,0,0,0,0,-61000,0,0,0,33000,94000,-61000,-61000,2021-06-09
8286,033343,長榮航永豐0B購01,0,0,0,0,0,0,0,0,0,-61000,0,0,0,819000,880000,-61000,-61000,2021-06-09
8287,032166,寶成元富0A購01,0,0,0,0,0,0,0,0,0,-61000,0,0,0,319000,380000,-61000,-61000,2021-06-09
8288,034626,國光生元富12購01,0,0,0,0,0,0,0,0,0,-61000,0,0,0,32000,93000,-61000,-61000,2021-06-09
8289,081817,鴻海凱基0C購01,0,0,0,0,0,0,0,0,0,-61000,0,0,0,0,61000,-61000,-61000,2021-06-09
8290,082148,惠特元富0A購01,0,0,0,0,0,0,0,0,0,-61000,0,0,0,0,61000,-61000,-61000,2021-06-09
8291,06937P,群創元富0A售16,0,0,0,0,0,0,0,0,0,-61000,0,0,0,4000,65000,-61000,-61000,2021-06-09
8292,06758P,台積電凱基11售02,0,0,0,0,0,0,0,0,0,-61000,0,0,0,0,61000,-61000,-61000,2021-06-09
8293,078646,新興凱基07購01,0,0,0,0,0,0,0,0,0,-61000,0,0,0,15000,76000,-61000,-61000,2021-06-09
8294,1711,永光,407000,430000,-23000,0,0,0,0,0,0,-38000,0,0,0,0,38000,-38000,-61000,2021-06-09
8295,2204,中華,211000,272000,-61000,0,0,0,0,0,0,0,0,0,0,0,0,0,-61000,2021-06-09
8296,3090,日電貿,31000,91000,-60000,0,0,0,0,0,0,-1000,0,0,0,0,1000,-1000,-61000,2021-06-09
8297,089600,台積電群益0C購05,0,0,0,0,0,0,0,0,0,-61000,0,0,0,1000,62000,-61000,-61000,2021-06-09
8298,085257,興勤國泰0A購01,0,0,0,0,0,0,0,0,0,-62000,0,0,0,32000,94000,-62000,-62000,2021-06-09
8299,087162,聯電永豐09購01,0,0,0,0,0,0,0,0,0,-62000,0,0,0,70000,132000,-62000,-62000,2021-06-09
8300,036300,欣興元大0C購03,0,0,0,0,0,0,0,0,0,-62000,0,0,0,40000,102000,-62000,-62000,2021-06-09
8301,030720,亞德客元大0B購01,0,0,0,0,0,0,0,0,0,-62000,0,0,0,180000,242000,-62000,-62000,2021-06-09
8302,034696,長榮群益11購06,0,0,0,0,0,0,0,0,0,-62000,0,0,0,156000,218000,-62000,-62000,2021-06-09
8303,035599,裕民元大0B購07,0,0,0,0,0,0,0,0,0,-62000,0,0,0,0,62000,-62000,-62000,2021-06-09
8304,036109,凌陽國泰12購01,0,0,0,0,0,0,0,0,0,-62000,0,0,0,123000,185000,-62000,-62000,2021-06-09
8305,082195,華晶科永豐07購01,0,0,0,0,0,0,0,0,0,-62000,0,0,0,25000,87000,-62000,-62000,2021-06-09
8306,082562,瑞昱統一09購03,0,0,0,0,0,0,0,0,0,-62000,0,0,0,0,62000,-62000,-62000,2021-06-09
8307,4536,拓凱,45000,107000,-62000,0,0,0,0,0,0,0,0,0,0,0,0,0,-62000,2021-06-09
8308,8464,億豐,120000,190200,-70200,0,0,0,8000,0,8000,-119,2000,119,1881,0,2000,-2000,-62319,2021-06-09
8309,088551,台灣50凱基0A購03,0,0,0,0,0,0,0,0,0,-63000,0,0,0,2000,65000,-63000,-63000,2021-06-09
8310,083550,緯穎元大07購04,0,0,0,0,0,0,0,0,0,-63000,0,0,0,0,63000,-63000,-63000,2021-06-09
8311,032569,合勤控群益0B購01,0,0,0,0,0,0,0,0,0,-63000,0,0,0,0,63000,-63000,-63000,2021-06-09
8312,032528,廣宇凱基0A購04,0,0,0,0,0,0,0,0,0,-63000,0,0,0,0,63000,-63000,-63000,2021-06-09
8313,033366,欣興國票0C購01,0,0,0,0,0,0,0,0,0,-63000,0,0,0,44000,107000,-63000,-63000,2021-06-09
8314,032941,台灣50元大0B購03,0,0,0,0,0,0,0,0,0,-63000,0,0,0,0,63000,-63000,-63000,2021-06-09
8315,035329,聯詠元大12購02,0,0,0,0,0,0,0,0,0,-63000,0,0,0,42000,105000,-63000,-63000,2021-06-09
8316,034512,百和凱基0B購01,0,0,0,0,0,0,0,0,0,-63000,0,0,0,0,63000,-63000,-63000,2021-06-09
8317,082888,致伸永豐07購01,0,0,0,0,0,0,0,0,0,-63000,0,0,0,37000,100000,-63000,-63000,2021-06-09
8318,080189,國喬元富08購01,0,0,0,0,0,0,0,0,0,-63000,0,0,0,0,63000,-63000,-63000,2021-06-09
8319,3209,全科,8000,71000,-63000,0,0,0,0,0,0,0,0,0,0,0,0,0,-63000,2021-06-09
8320,2832,台產,2000,125000,-123000,0,0,0,0,0,0,60000,60000,0,60000,0,0,0,-63000,2021-06-09
8321,2374,佳能,14000,77000,-63000,0,0,0,0,0,0,0,0,0,0,0,0,0,-63000,2021-06-09
8322,5871,中租-KY,664000,740791,-76791,0,0,0,0,0,0,13000,17000,4000,13000,0,0,0,-63791,2021-06-09
8323,084759,安集元大0A購01,0,0,0,0,0,0,0,0,0,-64000,0,0,0,170000,234000,-64000,-64000,2021-06-09
8324,085340,聯發科中信0B購01,0,0,0,0,0,0,0,0,0,-64000,0,0,0,0,64000,-64000,-64000,2021-06-09
8325,088739,瑞軒永豐09購02,0,0,0,0,0,0,0,0,0,-64000,0,0,0,0,64000,-64000,-64000,2021-06-09
8326,035595,華邦電元大0C購05,0,0,0,0,0,0,0,0,0,-64000,0,0,0,2000,66000,-64000,-64000,2021-06-09
8327,034989,瑞昱群益0B購01,0,0,0,0,0,0,0,0,0,-64000,0,0,0,110000,174000,-64000,-64000,2021-06-09
8328,034862,晶技元大0C購02,0,0,0,0,0,0,0,0,0,-64000,0,0,0,16000,80000,-64000,-64000,2021-06-09
8329,035779,健策富邦0C購02,0,0,0,0,0,0,0,0,0,-64000,0,0,0,46000,110000,-64000,-64000,2021-06-09
8330,082000,台積電第一14購01,0,0,0,0,0,0,0,0,0,-64000,0,0,0,137000,201000,-64000,-64000,2021-06-09
8331,082337,愛普統一09購03,0,0,0,0,0,0,0,0,0,-64000,0,0,0,0,64000,-64000,-64000,2021-06-09
8332,078638,台達電凱基09購01,0,0,0,0,0,0,0,0,0,-64000,0,0,0,36000,100000,-64000,-64000,2021-06-09
8333,07281P,金像電凱基0C售02,0,0,0,0,0,0,0,0,0,-64000,0,0,0,50000,114000,-64000,-64000,2021-06-09
8334,3296,勝德,2000,66000,-64000,0,0,0,0,0,0,0,0,0,0,0,0,0,-64000,2021-06-09
8335,089412,聯詠凱基09購08,0,0,0,0,0,0,0,0,0,-64000,0,0,0,37000,101000,-64000,-64000,2021-06-09
8336,1568,倉佑,25000,89000,-64000,0,0,0,0,0,0,0,0,0,0,0,0,0,-64000,2021-06-09
8337,2515,中工,1176000,1253000,-77000,0,0,0,0,0,0,12406,0,4000,-4000,63000,46594,16406,-64594,2021-06-09
8338,087329,大立光永豐09購02,0,0,0,0,0,0,0,0,0,-65000,0,0,0,0,65000,-65000,-65000,2021-06-09
8339,083838,臺股指凱基09購12,0,0,0,0,0,0,0,0,0,-65000,0,0,0,20000,85000,-65000,-65000,2021-06-09
8340,031893,臺股指凱基0A購17,0,0,0,0,0,0,0,0,0,-65000,0,0,0,0,65000,-65000,-65000,2021-06-09
8341,031011,友達永豐0A購02,0,0,0,0,0,0,0,0,0,-65000,0,0,0,110000,175000,-65000,-65000,2021-06-09
8342,030498,新興兆豐0A購01,0,0,0,0,0,0,0,0,0,-65000,0,0,0,9000,74000,-65000,-65000,2021-06-09
8343,034338,大立光群益0B購04,0,0,0,0,0,0,0,0,0,-65000,0,0,0,15000,80000,-65000,-65000,2021-06-09
8344,06298P,臺股指凱基08售09,0,0,0,0,0,0,0,0,0,-65000,0,0,0,0,65000,-65000,-65000,2021-06-09
8345,034140,新光鋼凱基0B購01,0,0,0,0,0,0,0,0,0,-65000,0,0,0,11000,76000,-65000,-65000,2021-06-09
8346,075498,大立光元大08購02,0,0,0,0,0,0,0,0,0,-65000,0,0,0,0,65000,-65000,-65000,2021-06-09
8347,078466,台積電統一0A購01,0,0,0,0,0,0,0,0,0,-65000,0,0,0,0,65000,-65000,-65000,2021-06-09
8348,082976,瑞昱元大08購01,0,0,0,0,0,0,0,0,0,-65000,0,0,0,10000,75000,-65000,-65000,2021-06-09
8349,080217,台達化元大07購01,0,0,0,0,0,0,0,0,0,-65000,0,0,0,15000,80000,-65000,-65000,2021-06-09
8350,3550,聯穎,27000,92000,-65000,0,0,0,0,0,0,0,0,0,0,0,0,0,-65000,2021-06-09
8351,089259,大立光統一0C購01,0,0,0,0,0,0,0,0,0,-65000,0,0,0,0,65000,-65000,-65000,2021-06-09
8352,089726,光寶科永豐09購01,0,0,0,0,0,0,0,0,0,-65000,0,0,0,0,65000,-65000,-65000,2021-06-09
8353,8926,台汽電,21000,86000,-65000,0,0,0,0,0,0,0,0,0,0,0,0,0,-65000,2021-06-09
8354,085143,臺指反中信0B購01,0,0,0,0,0,0,0,0,0,-66000,0,0,0,38000,104000,-66000,-66000,2021-06-09
8355,085613,亞光元大08購02,0,0,0,0,0,0,0,0,0,-66000,0,0,0,0,66000,-66000,-66000,2021-06-09
8356,031537,中鋼永豐0A購03,0,0,0,0,0,0,0,0,0,-66000,0,0,0,6000,72000,-66000,-66000,2021-06-09
8357,032654,台泥麥證0B購01,0,0,0,0,66000,-66000,0,0,0,-66000,0,0,0,0,66000,-66000,-66000,2021-06-09
8358,034513,台泥元富0B購01,0,0,0,0,0,0,0,0,0,-66000,0,0,0,0,66000,-66000,-66000,2021-06-09
8359,034420,友達統一0C購06,0,0,0,0,0,0,0,0,0,-66000,0,0,0,0,66000,-66000,-66000,2021-06-09
8360,035140,友達統一11購04,0,0,0,0,0,0,0,0,0,-66000,0,0,0,0,66000,-66000,-66000,2021-06-09
8361,079246,友達元大09購01,0,0,0,0,0,0,0,0,0,-66000,0,0,0,0,66000,-66000,-66000,2021-06-09
8362,06565P,寶成元富09售02,0,0,0,0,0,0,0,0,0,-66000,0,0,0,53000,119000,-66000,-66000,2021-06-09
8363,089383,微星中信09購02,0,0,0,0,0,0,0,0,0,-66000,0,0,0,0,66000,-66000,-66000,2021-06-09
8364,4912,聯德控股-KY,27000,86000,-59000,0,0,0,0,0,0,-7000,3000,0,3000,2000,12000,-10000,-66000,2021-06-09
8365,2929,淘帝-KY,491000,557000,-66000,0,0,0,0,0,0,0,0,0,0,0,0,0,-66000,2021-06-09
8366,1725,元禎,13000,72000,-59000,0,0,0,0,0,0,-7000,0,7000,-7000,0,0,0,-66000,2021-06-09
8367,083779,鈺齊永豐07購01,0,0,0,0,0,0,0,0,0,-67000,0,0,0,0,67000,-67000,-67000,2021-06-09
8368,087145,聯詠國票0A購01,0,0,0,0,0,0,0,0,0,-67000,0,0,0,32000,99000,-67000,-67000,2021-06-09
8369,087590,晶相光元大09購01,0,0,0,0,0,0,0,0,0,-67000,0,0,0,7000,74000,-67000,-67000,2021-06-09
8370,086629,旺宏凱基0A購02,0,0,0,0,0,0,0,0,0,-67000,0,0,0,50000,117000,-67000,-67000,2021-06-09
8371,088423,致新群益09購01,0,0,0,0,0,0,0,0,0,-67000,0,0,0,5000,72000,-67000,-67000,2021-06-09
8372,032353,中鋼凱基0A購04,0,0,0,0,0,0,0,0,0,-67000,0,0,0,146000,213000,-67000,-67000,2021-06-09
8373,031891,新唐凱基0B購01,0,0,0,0,0,0,0,0,0,-67000,0,0,0,19000,86000,-67000,-67000,2021-06-09
8374,034747,群創元大0B購12,0,0,0,0,0,0,0,0,0,-67000,0,0,0,20000,87000,-67000,-67000,2021-06-09
8375,3622,洋華,129000,196000,-67000,0,0,0,0,0,0,0,0,0,0,0,0,0,-67000,2021-06-09
8376,030980,全新元大0A購04,0,0,0,0,0,0,0,0,0,-68000,0,0,0,0,68000,-68000,-68000,2021-06-09
8377,034712,台泥康和0B購01,0,0,0,0,0,0,0,0,0,-68000,0,0,0,0,68000,-68000,-68000,2021-06-09
8378,033777,華新元大0B購04,0,0,0,0,0,0,0,0,0,-68000,0,0,0,155000,223000,-68000,-68000,2021-06-09
8379,06487P,全新元大09售01,0,0,0,0,0,0,0,0,0,-68000,0,0,0,13000,81000,-68000,-68000,2021-06-09
8380,07182P,華邦電群益0B售11,0,0,0,0,0,0,0,0,0,-68000,0,0,0,65000,133000,-68000,-68000,2021-06-09
8381,2442,新美齊,56000,124000,-68000,0,0,0,0,0,0,0,0,0,0,0,0,0,-68000,2021-06-09
8382,9902,台火,554000,622000,-68000,0,0,0,0,0,0,0,0,0,0,0,0,0,-68000,2021-06-09
8383,4968,立積,729025,995000,-265975,0,0,0,165000,14000,151000,46841,4899,9318,-4419,55410,4150,51260,-68134,2021-06-09
8384,084670,聯發科國票0A購01,0,0,0,0,0,0,0,0,0,-69000,0,0,0,0,69000,-69000,-69000,2021-06-09
8385,031399,聯成兆豐0A購01,0,0,0,0,0,0,0,0,0,-69000,0,0,0,15000,84000,-69000,-69000,2021-06-09
8386,033559,國喬永豐0B購01,0,0,0,0,0,0,0,0,0,-69000,0,0,0,0,69000,-69000,-69000,2021-06-09
8387,033511,群創統一15購02,0,0,0,0,0,0,0,0,0,-69000,0,0,0,360000,429000,-69000,-69000,2021-06-09
8388,035014,聯發科第一15購04,0,0,0,0,0,0,0,0,0,-69000,0,0,0,1000,70000,-69000,-69000,2021-06-09
8389,035652,晶技兆豐0C購01,0,0,0,0,0,0,0,0,0,-69000,0,0,0,98000,167000,-69000,-69000,2021-06-09
8390,070874,奇鋐元富08購02,0,0,0,0,0,0,0,0,0,-69000,0,0,0,0,69000,-69000,-69000,2021-06-09
8391,083383,台達電國泰09購01,0,0,0,0,0,0,0,0,0,-69000,0,0,0,10000,79000,-69000,-69000,2021-06-09
8392,089618,南電群益0B購02,0,0,0,0,0,0,0,0,0,-69000,0,0,0,17000,86000,-69000,-69000,2021-06-09
8393,5521,工信,133000,202000,-69000,0,0,0,0,0,0,0,0,0,0,0,0,0,-69000,2021-06-09
8394,5534,長虹,780604,849000,-68396,0,0,0,0,0,0,-1418,0,1418,-1418,0,0,0,-69814,2021-06-09
8395,084507,台積電元大08購07,0,0,0,0,0,0,0,0,0,-70000,0,0,0,0,70000,-70000,-70000,2021-06-09
8396,084602,華晶科永豐08購02,0,0,0,0,0,0,0,0,0,-70000,0,0,0,0,70000,-70000,-70000,2021-06-09
8397,083661,日月光群益07購08,0,0,0,0,0,0,0,0,0,-70000,0,0,0,0,70000,-70000,-70000,2021-06-09
8398,084077,鴻海元大07購32,0,0,0,0,0,0,0,0,0,-70000,0,0,0,0,70000,-70000,-70000,2021-06-09
8399,085555,聯發科群益08購16,0,0,0,0,0,0,0,0,0,-70000,0,0,0,554000,624000,-70000,-70000,2021-06-09
8400,085383,南電群益09購02,0,0,0,0,0,0,0,0,0,-70000,0,0,0,0,70000,-70000,-70000,2021-06-09
8401,088500,微星元大09購04,0,0,0,0,0,0,0,0,0,-70000,0,0,0,0,70000,-70000,-70000,2021-06-09
8402,088593,矽格統一0B購01,0,0,0,0,0,0,0,0,0,-70000,0,0,0,395000,465000,-70000,-70000,2021-06-09
8403,088972,立積富邦0A購01,0,0,0,0,0,0,0,0,0,-70000,0,0,0,0,70000,-70000,-70000,2021-06-09
8404,088176,南電元大0C購02,0,0,0,0,0,0,0,0,0,-70000,0,0,0,271000,341000,-70000,-70000,2021-06-09
8405,087816,南亞凱基09購01,0,0,0,0,0,0,0,0,0,-70000,0,0,0,0,70000,-70000,-70000,2021-06-09
8406,087840,聚鼎凱基0A購01,0,0,0,0,0,0,0,0,0,-70000,0,0,0,30000,100000,-70000,-70000,2021-06-09
8407,086644,TPK凱基09購01,0,0,0,0,0,0,0,0,0,-70000,0,0,0,0,70000,-70000,-70000,2021-06-09
8408,086587,旺宏國票0A購01,0,0,0,0,0,0,0,0,0,-70000,0,0,0,0,70000,-70000,-70000,2021-06-09
8409,086463,南電群益09購03,0,0,0,0,0,0,0,0,0,-70000,0,0,0,44000,114000,-70000,-70000,2021-06-09
8410,087368,元石油元大0B購03,0,0,0,0,0,0,0,0,0,-70000,0,0,0,0,70000,-70000,-70000,2021-06-09
8411,033409,聯發科第一15購01,0,0,0,0,0,0,0,0,0,-70000,0,0,0,30000,100000,-70000,-70000,2021-06-09
8412,033557,台聚永豐0B購01,0,0,0,0,0,0,0,0,0,-70000,0,0,0,0,70000,-70000,-70000,2021-06-09
8413,031911,金像電永豐0A購01,0,0,0,0,0,0,0,0,0,-70000,0,0,0,20000,90000,-70000,-70000,2021-06-09
8414,032102,華邦電永豐0A購04,0,0,0,0,0,0,0,0,0,-70000,0,0,0,0,70000,-70000,-70000,2021-06-09
8415,033327,群創凱基11購01,0,0,0,0,0,0,0,0,0,-70000,0,0,0,0,70000,-70000,-70000,2021-06-09
8416,030206,志聖凱基0A購01,0,0,0,0,0,0,0,0,0,-70000,0,0,0,0,70000,-70000,-70000,2021-06-09
8417,030093,為升永豐0A購01,0,0,0,0,0,0,0,0,0,-70000,0,0,0,0,70000,-70000,-70000,2021-06-09
8418,030242,中環永豐0A購01,0,0,0,0,0,0,0,0,0,-70000,0,0,0,20000,90000,-70000,-70000,2021-06-09
8419,030734,南亞科元大0A購03,0,0,0,0,0,0,0,0,0,-70000,0,0,0,120000,190000,-70000,-70000,2021-06-09
8420,030684,瑞昱兆豐0B購01,0,0,0,0,0,0,0,0,0,-70000,0,0,0,10000,80000,-70000,-70000,2021-06-09
8421,035021,台達電凱基0B購03,0,0,0,0,0,0,0,0,0,-70000,0,0,0,0,70000,-70000,-70000,2021-06-09
8422,06303P,臺股指凱基08售14,0,0,0,0,0,0,0,0,0,-70000,0,0,0,30000,100000,-70000,-70000,2021-06-09
8423,07078P,大亞凱基0B售02,0,0,0,0,0,0,0,0,0,-70000,0,0,0,0,70000,-70000,-70000,2021-06-09
8424,071138,大立光元富09購02,0,0,0,0,0,0,0,0,0,-70000,0,0,0,75000,145000,-70000,-70000,2021-06-09
8425,080400,宏達電元大07購02,0,0,0,0,0,0,0,0,0,-70000,0,0,0,0,70000,-70000,-70000,2021-06-09
8426,080789,勝一凱基09購01,0,0,0,0,0,0,0,0,0,-70000,0,0,0,0,70000,-70000,-70000,2021-06-09
8427,081152,亞光凱基08購01,0,0,0,0,0,0,0,0,0,-70000,0,0,0,0,70000,-70000,-70000,2021-06-09
8428,082974,微星元大07購03,0,0,0,0,0,0,0,0,0,-70000,0,0,0,0,70000,-70000,-70000,2021-06-09
8429,082311,臺股指元大0A購08,0,0,0,0,0,0,0,0,0,-70000,0,0,0,0,70000,-70000,-70000,2021-06-09
8430,2347,聯強,2417000,2074900,342100,0,0,0,0,562000,-562000,149771,13000,1229,11771,138000,0,138000,-70129,2021-06-09
8431,2362,藍天,29000,100000,-71000,0,0,0,0,0,0,344,344,0,344,0,0,0,-70656,2021-06-09
8432,088900,臺股指凱基0C購16,0,0,0,0,0,0,0,0,0,-71000,0,0,0,6000,77000,-71000,-71000,2021-06-09
8433,030118,台灣50凱基0C購02,0,0,0,0,0,0,0,0,0,-71000,0,0,0,127000,198000,-71000,-71000,2021-06-09
8434,080554,華新科國泰08購03,0,0,0,0,0,0,0,0,0,-71000,0,0,0,0,71000,-71000,-71000,2021-06-09
8435,1231,聯華食,16000,87000,-71000,0,0,0,0,0,0,0,0,0,0,0,0,0,-71000,2021-06-09
8436,087960,聯詠第一13購01,0,0,0,0,0,0,0,0,0,-72000,0,0,0,60000,132000,-72000,-72000,2021-06-09
8437,087432,台積電元富0C購08,0,0,0,0,0,0,0,0,0,-72000,0,0,0,0,72000,-72000,-72000,2021-06-09
8438,087228,惠特凱基09購01,0,0,0,0,0,0,0,0,0,-72000,0,0,0,0,72000,-72000,-72000,2021-06-09
8439,086618,台灣50凱基09購05,0,0,0,0,0,0,0,0,0,-72000,0,0,0,10000,82000,-72000,-72000,2021-06-09
8440,086345,華新科元大11購02,0,0,0,0,0,0,0,0,0,-72000,0,0,0,0,72000,-72000,-72000,2021-06-09
8441,084655,凌陽群益08購02,0,0,0,0,0,0,0,0,0,-72000,0,0,0,31000,103000,-72000,-72000,2021-06-09
8442,033168,台玻永豐0B購01,0,0,0,0,0,0,0,0,0,-72000,0,0,0,30000,102000,-72000,-72000,2021-06-09
8443,033887,力麗統一13購01,0,0,0,0,0,0,0,0,0,-72000,0,0,0,0,72000,-72000,-72000,2021-06-09
8444,079583,上銀統一08購03,0,0,0,0,0,0,0,0,0,-72000,0,0,0,0,72000,-72000,-72000,2021-06-09
8445,07043P,台聚元富12售01,0,0,0,0,0,0,0,0,0,-72000,0,0,0,51000,123000,-72000,-72000,2021-06-09
8446,06463P,聯發科元大09售05,0,0,0,0,0,0,0,0,0,-72000,0,0,0,67000,139000,-72000,-72000,2021-06-09
8447,06791P,臺股指凱基0A售09,0,0,0,0,0,0,0,0,0,-72000,0,0,0,439000,511000,-72000,-72000,2021-06-09
8448,1457,宜進,772000,844000,-72000,0,0,0,0,0,0,0,0,0,0,0,0,0,-72000,2021-06-09
8449,3050,鈺德,68000,140000,-72000,0,0,0,0,0,0,0,0,0,0,0,0,0,-72000,2021-06-09
8450,2836,高雄銀,34000,106000,-72000,0,0,0,0,0,0,0,0,0,0,0,0,0,-72000,2021-06-09
8451,085584,京鼎兆豐08購01,0,0,0,0,0,0,0,0,0,-73000,0,0,0,0,73000,-73000,-73000,2021-06-09
8452,036344,世紀鋼元富0C購01,0,0,0,0,0,0,0,0,0,-73000,0,0,0,0,73000,-73000,-73000,2021-06-09
8453,033872,聯詠群益0C購02,0,0,0,0,0,0,0,0,0,-73000,0,0,0,2000,75000,-73000,-73000,2021-06-09
8454,034410,力麗統一14購01,0,0,0,0,0,0,0,0,0,-73000,0,0,0,1000,74000,-73000,-73000,2021-06-09
8455,034056,臺股指麥證0C購06,0,0,0,580000,53000,527000,0,0,0,-73000,0,0,0,580000,653000,-73000,-73000,2021-06-09
8456,034096,華擎元大12購01,0,0,0,0,0,0,0,0,0,-73000,0,0,0,46000,119000,-73000,-73000,2021-06-09
8457,035076,聯詠群益0B購04,0,0,0,0,0,0,0,0,0,-73000,0,0,0,30000,103000,-73000,-73000,2021-06-09
8458,035937,全新凱基0C購02,0,0,0,0,0,0,0,0,0,-73000,0,0,0,0,73000,-73000,-73000,2021-06-09
8459,06660P,華碩元富09售02,0,0,0,0,0,0,0,0,0,-73000,0,0,0,0,73000,-73000,-73000,2021-06-09
8460,082517,儒鴻群益07購03,0,0,0,0,0,0,0,0,0,-73000,0,0,0,0,73000,-73000,-73000,2021-06-09
8461,089906,景碩凱基11購01,0,0,0,0,0,0,0,0,0,-73000,0,0,0,9000,82000,-73000,-73000,2021-06-09
8462,089187,台積電凱基13購05,0,0,0,0,0,0,0,0,0,-73000,0,0,0,0,73000,-73000,-73000,2021-06-09
8463,031018,鈺齊永豐0A購01,0,0,0,0,0,0,0,0,0,-74000,0,0,0,0,74000,-74000,-74000,2021-06-09
8464,031559,台積電第一14購03,0,0,0,0,0,0,0,0,0,-74000,0,0,0,20000,94000,-74000,-74000,2021-06-09
8465,04559P,大立光富邦08售03,0,0,0,0,0,0,0,0,0,-74000,0,0,0,1000,75000,-74000,-74000,2021-06-09
8466,034063,晶技國票0C購02,0,0,0,0,0,0,0,0,0,-74000,0,0,0,0,74000,-74000,-74000,2021-06-09
8467,082708,欣興凱基08購04,0,0,0,0,0,0,0,0,0,-74000,0,0,0,228000,302000,-74000,-74000,2021-06-09
8468,079491,華邦電凱基07購02,0,0,0,0,0,0,0,0,0,-74000,0,0,0,0,74000,-74000,-74000,2021-06-09
8469,089158,群創元富09購08,0,0,0,0,0,0,0,0,0,-74000,0,0,0,6000,80000,-74000,-74000,2021-06-09
8470,089874,松翰國泰0C購01,0,0,0,0,0,0,0,0,0,-74000,0,0,0,288000,362000,-74000,-74000,2021-06-09
8471,1526,日馳,86000,160000,-74000,0,0,0,0,0,0,0,0,0,0,0,0,0,-74000,2021-06-09
8472,2413,環科,44000,118000,-74000,0,0,0,0,0,0,0,0,0,0,0,0,0,-74000,2021-06-09
8473,00631L,元大台灣50正2,377000,84000,293000,0,0,0,0,0,0,-367793,0,0,0,835000,1202793,-367793,-74793,2021-06-09
8474,084347,華邦電元大07購19,0,0,0,0,0,0,0,0,0,-75000,0,0,0,0,75000,-75000,-75000,2021-06-09
8475,083944,台灣50凱基07購23,0,0,0,0,0,0,0,0,0,-75000,0,0,0,0,75000,-75000,-75000,2021-06-09
8476,083423,正文永豐07購02,0,0,0,0,0,0,0,0,0,-75000,0,0,0,47000,122000,-75000,-75000,2021-06-09
8477,086936,奇力新元大09購02,0,0,0,0,0,0,0,0,0,-75000,0,0,0,5000,80000,-75000,-75000,2021-06-09
8478,030777,華晶科麥證0B購01,0,0,0,28000,103000,-75000,0,0,0,-75000,0,0,0,28000,103000,-75000,-75000,2021-06-09
8479,032448,玉晶光元大0A購04,0,0,0,0,0,0,0,0,0,-75000,0,0,0,0,75000,-75000,-75000,2021-06-09
8480,032106,裕民永豐0A購02,0,0,0,0,0,0,0,0,0,-75000,0,0,0,5000,80000,-75000,-75000,2021-06-09
8481,031782,景碩台新0A購01,0,0,0,0,0,0,0,0,0,-75000,0,0,0,0,75000,-75000,-75000,2021-06-09
8482,032409,南紡元大0A購04,0,0,0,0,0,0,0,0,0,-75000,0,0,0,60000,135000,-75000,-75000,2021-06-09
8483,033812,國泰金元富0B購03,0,0,0,0,0,0,0,0,0,-75000,0,0,0,185000,260000,-75000,-75000,2021-06-09
8484,8341,日友,27000,102000,-75000,0,0,0,0,0,0,0,0,0,0,0,0,0,-75000,2021-06-09
8485,2472,立隆電,94000,169000,-75000,0,0,0,0,0,0,-696,0,696,-696,0,0,0,-75696,2021-06-09
8486,0052,富邦科技,23000,25000,-2000,0,0,0,0,0,0,-73787,0,0,0,591220,665007,-73787,-75787,2021-06-09
8487,087537,華夏統一0B購02,0,0,0,0,0,0,0,0,0,-76000,0,0,0,102000,178000,-76000,-76000,2021-06-09
8488,088445,南茂凱基0A購01,0,0,0,0,0,0,0,0,0,-76000,0,0,0,188000,264000,-76000,-76000,2021-06-09
8489,032847,矽統永豐0A購02,0,0,0,0,0,0,0,0,0,-76000,0,0,0,24000,100000,-76000,-76000,2021-06-09
8490,034629,晶技康和0B購01,0,0,0,0,0,0,0,0,0,-76000,0,0,0,24000,100000,-76000,-76000,2021-06-09
8491,033753,禾伸堂永豐0B購01,0,0,0,0,0,0,0,0,0,-76000,0,0,0,20000,96000,-76000,-76000,2021-06-09
8492,080495,金像電元大06購07,0,0,0,0,0,0,0,0,0,-76000,0,0,0,477000,553000,-76000,-76000,2021-06-09
8493,2462,良得電,16000,92000,-76000,0,0,0,0,0,0,0,0,0,0,0,0,0,-76000,2021-06-09
8494,3311,閎暉,4000,80000,-76000,0,0,0,0,0,0,0,0,0,0,0,0,0,-76000,2021-06-09
8495,088930,友達統一09購03,0,0,0,0,0,0,0,0,0,-77000,0,0,0,9000,86000,-77000,-77000,2021-06-09
8496,086854,南電元大09購05,0,0,0,0,0,0,0,0,0,-77000,0,0,0,182000,259000,-77000,-77000,2021-06-09
8497,084971,宏碁凱基09購02,0,0,0,0,0,0,0,0,0,-77000,0,0,0,0,77000,-77000,-77000,2021-06-09
8498,033296,欣興台新0B購01,0,0,0,0,0,0,0,0,0,-77000,0,0,0,240000,317000,-77000,-77000,2021-06-09
8499,030906,台積電凱基14購03,0,0,0,0,0,0,0,0,0,-77000,0,0,0,0,77000,-77000,-77000,2021-06-09
8500,033870,友達群益0B購02,0,0,0,0,0,0,0,0,0,-77000,0,0,0,96000,173000,-77000,-77000,2021-06-09
8501,00876,元大未來關鍵科技,77000,314000,-237000,0,0,0,0,0,0,159196,0,0,0,313000,153804,159196,-77804,2021-06-09
8502,030338,廣宇群益0C購01,0,0,0,0,0,0,0,0,0,-78000,0,0,0,24000,102000,-78000,-78000,2021-06-09
8503,05965P,臺股指凱基0A售02,0,0,0,0,0,0,0,0,0,-78000,0,0,0,20000,98000,-78000,-78000,2021-06-09
8504,033655,華邦電統一13購01,0,0,0,0,0,0,0,0,0,-78000,0,0,0,30000,108000,-78000,-78000,2021-06-09
8505,036043,長榮航元富13購02,0,0,0,0,0,0,0,0,0,-78000,0,0,0,244000,322000,-78000,-78000,2021-06-09
8506,082471,精成科元大07購02,0,0,0,0,0,0,0,0,0,-78000,0,0,0,265000,343000,-78000,-78000,2021-06-09
8507,2851,中再保,18000,96000,-78000,0,0,0,0,0,0,0,0,0,0,0,0,0,-78000,2021-06-09
8508,3052,夆典,54000,132000,-78000,0,0,0,0,0,0,0,0,0,0,0,0,0,-78000,2021-06-09
8509,2534,宏盛,36000,114000,-78000,0,0,0,0,0,0,0,0,0,0,0,0,0,-78000,2021-06-09
8510,036163,緯穎元大0C購02,0,0,0,0,0,0,0,0,0,-79000,0,0,0,0,79000,-79000,-79000,2021-06-09
8511,06649P,台達化元大09售03,0,0,0,0,0,0,0,0,0,-79000,0,0,0,0,79000,-79000,-79000,2021-06-09
8512,06859P,臺股指凱基11售05,0,0,0,0,0,0,0,0,0,-79000,0,0,0,158000,237000,-79000,-79000,2021-06-09
8513,084780,緯創凱基08購02,0,0,0,0,0,0,0,0,0,-80000,0,0,0,170000,250000,-80000,-80000,2021-06-09
8514,085657,瑞昱統一0A購03,0,0,0,0,0,0,0,0,0,-80000,0,0,0,0,80000,-80000,-80000,2021-06-09
8515,086597,矽創國票0A購01,0,0,0,0,0,0,0,0,0,-80000,0,0,0,48000,128000,-80000,-80000,2021-06-09
8516,086543,永冠元大09購01,0,0,0,0,0,0,0,0,0,-80000,0,0,0,20000,100000,-80000,-80000,2021-06-09
8517,088819,聯詠元大09購11,0,0,0,0,0,0,0,0,0,-80000,0,0,0,0,80000,-80000,-80000,2021-06-09
8518,033031,宏達電群益0B購02,0,0,0,0,0,0,0,0,0,-80000,0,0,0,0,80000,-80000,-80000,2021-06-09
8519,031664,聯發科元大0A購14,0,0,0,0,0,0,0,0,0,-80000,0,0,0,0,80000,-80000,-80000,2021-06-09
8520,05426P,聯發科中信09售01,0,0,0,0,0,0,0,0,0,-80000,0,0,0,0,80000,-80000,-80000,2021-06-09
8521,032469,長榮中信0A購04,0,0,0,0,0,0,0,0,0,-80000,0,0,0,0,80000,-80000,-80000,2021-06-09
8522,034923,群創麥證0B購02,0,0,0,66000,146000,-80000,0,0,0,-80000,0,0,0,66000,146000,-80000,-80000,2021-06-09
8523,034133,中鋼第一15購01,0,0,0,0,0,0,0,0,0,-80000,0,0,0,0,80000,-80000,-80000,2021-06-09
8524,03755C,臺股指元大12牛01,0,0,0,0,0,0,0,0,0,-80000,0,0,0,38000,118000,-80000,-80000,2021-06-09
8525,036493,南紡國泰12購01,0,0,0,0,0,0,0,0,0,-80000,0,0,0,0,80000,-80000,-80000,2021-06-09
8526,033947,聯電國票0C購03,0,0,0,0,0,0,0,0,0,-80000,0,0,0,1000,81000,-80000,-80000,2021-06-09
8527,068403,南亞科元富07購01,0,0,0,0,0,0,0,0,0,-80000,0,0,0,0,80000,-80000,-80000,2021-06-09
8528,077464,國巨國票08購02,0,0,0,0,0,0,0,0,0,-80000,0,0,0,10000,90000,-80000,-80000,2021-06-09
8529,082643,聯發科中信07購06,0,80000,-80000,0,0,0,0,0,0,0,0,0,0,0,0,0,-80000,2021-06-09
8530,082377,新光金日盛07購01,0,0,0,0,0,0,0,0,0,-80000,0,0,0,0,80000,-80000,-80000,2021-06-09
8531,3703,欣陸,304000,397000,-93000,0,0,0,0,0,0,13000,0,0,0,18000,5000,13000,-80000,2021-06-09
8532,2633,台灣高鐵,934000,1083600,-149600,0,0,0,0,0,0,68860,55000,140,54860,18000,4000,14000,-80740,2021-06-09
8533,088089,京元電元富09購01,0,0,0,0,0,0,0,0,0,-81000,0,0,0,0,81000,-81000,-81000,2021-06-09
8534,083831,全新凱基08購04,0,0,0,0,0,0,0,0,0,-81000,0,0,0,0,81000,-81000,-81000,2021-06-09
8535,032439,國產元大0C購01,0,0,0,0,0,0,0,0,0,-81000,0,0,0,0,81000,-81000,-81000,2021-06-09
8536,030079,景碩群益0B購02,0,0,0,0,0,0,0,0,0,-81000,0,0,0,237000,318000,-81000,-81000,2021-06-09
8537,030946,致新群益0B購02,0,0,0,0,0,0,0,0,0,-81000,0,0,0,3000,84000,-81000,-81000,2021-06-09
8538,05734P,大立光凱基08售03,0,0,0,0,0,0,0,0,0,-81000,0,0,0,0,81000,-81000,-81000,2021-06-09
8539,034434,台玻凱基0B購02,0,0,0,0,0,0,0,0,0,-81000,0,0,0,180000,261000,-81000,-81000,2021-06-09
8540,082366,旺宏群益08購02,0,0,0,0,0,0,0,0,0,-81000,0,0,0,49000,130000,-81000,-81000,2021-06-09
8541,089254,奇力新統一0B購03,0,0,0,0,0,0,0,0,0,-81000,0,0,0,19000,100000,-81000,-81000,2021-06-09
8542,1789,神隆,239000,317000,-78000,0,0,0,0,0,0,-3009,0,9,-9,0,3000,-3000,-81009,2021-06-09
8543,085961,友達凱基08購10,0,0,0,0,0,0,0,0,0,-82000,0,0,0,33000,115000,-82000,-82000,2021-06-09
8544,030448,臺股指元大11購05,0,0,0,0,0,0,0,0,0,-82000,0,0,0,0,82000,-82000,-82000,2021-06-09
8545,033384,義隆元大11購01,0,0,0,0,0,0,0,0,0,-82000,0,0,0,380000,462000,-82000,-82000,2021-06-09
8546,036015,矽創凱基11購01,0,0,0,0,0,0,0,0,0,-82000,0,0,0,384000,466000,-82000,-82000,2021-06-09
8547,035967,友達元大0C購13,0,0,0,0,0,0,0,0,0,-82000,0,0,0,3000,85000,-82000,-82000,2021-06-09
8548,035480,榮成群益0B購01,0,0,0,0,0,0,0,0,0,-82000,0,0,0,30000,112000,-82000,-82000,2021-06-09
8549,083306,聯詠元大07購07,0,0,0,0,0,0,0,0,0,-82000,0,0,0,0,82000,-82000,-82000,2021-06-09
8550,078292,華晶科國票07購01,0,0,0,0,0,0,0,0,0,-82000,0,0,0,0,82000,-82000,-82000,2021-06-09
8551,07255P,聯電元大0B售09,0,0,0,0,0,0,0,0,0,-82000,0,0,0,0,82000,-82000,-82000,2021-06-09
8552,2501,國建,50000,132000,-82000,0,0,0,0,0,0,0,0,0,0,0,0,0,-82000,2021-06-09
8553,089353,友達元大0C購06,0,0,0,0,0,0,0,0,0,-82000,0,0,0,0,82000,-82000,-82000,2021-06-09
8554,089332,聚陽元大09購04,0,0,0,0,0,0,0,0,0,-82000,0,0,0,10000,92000,-82000,-82000,2021-06-09
8555,6205,詮欣,9000,91000,-82000,0,0,0,0,0,0,0,0,0,0,0,0,0,-82000,2021-06-09
8556,00733,富邦臺灣中小,46000,27000,19000,0,0,0,0,0,0,-101187,0,0,0,359000,460187,-101187,-82187,2021-06-09
8557,085156,華邦電凱基0A購03,0,0,0,0,0,0,0,0,0,-83000,0,0,0,16000,99000,-83000,-83000,2021-06-09
8558,084084,順德元大07購08,0,0,0,0,0,0,0,0,0,-83000,0,0,0,17000,100000,-83000,-83000,2021-06-09
8559,084305,長興凱基08購01,0,0,0,0,0,0,0,0,0,-83000,0,0,0,5000,88000,-83000,-83000,2021-06-09
8560,088915,立積群益0C購02,0,0,0,0,0,0,0,0,0,-83000,0,0,0,51000,134000,-83000,-83000,2021-06-09
8561,033303,微星國泰11購01,0,0,0,0,0,0,0,0,0,-83000,0,0,0,1000,84000,-83000,-83000,2021-06-09
8562,034291,中鋼中信0B購04,0,0,0,0,0,0,0,0,0,-83000,0,0,0,30000,113000,-83000,-83000,2021-06-09
8563,034763,長榮統一11購07,0,0,0,0,0,0,0,0,0,-83000,0,0,0,9000,92000,-83000,-83000,2021-06-09
8564,034586,臺股指凱基0B購13,0,0,0,0,0,0,0,0,0,-83000,0,0,0,0,83000,-83000,-83000,2021-06-09
8565,3062,建漢,642000,725000,-83000,0,0,0,0,0,0,0,0,0,0,0,0,0,-83000,2021-06-09
8566,087754,松翰國票0A購01,0,0,0,0,0,0,0,0,0,-84000,0,0,0,38000,122000,-84000,-84000,2021-06-09
8567,086553,中信金元大09購01,0,0,0,0,0,0,0,0,0,-84000,0,0,0,468000,552000,-84000,-84000,2021-06-09
8568,086566,圓展元大09購01,0,0,0,0,0,0,0,0,0,-84000,0,0,0,6000,90000,-84000,-84000,2021-06-09
8569,085382,南電群益08購04,0,0,0,0,0,0,0,0,0,-84000,0,0,0,169000,253000,-84000,-84000,2021-06-09
8570,085500,聯詠凱基09購02,0,0,0,0,0,0,0,0,0,-84000,0,0,0,0,84000,-84000,-84000,2021-06-09
8571,036211,國喬國泰12購01,0,0,0,0,0,0,0,0,0,-84000,0,0,0,40000,124000,-84000,-84000,2021-06-09
8572,031129,聯詠統一0C購03,0,0,0,0,0,0,0,0,0,-84000,0,0,0,11000,95000,-84000,-84000,2021-06-09
8573,034469,新纖元大0B購03,0,0,0,0,0,0,0,0,0,-84000,0,0,0,9000,93000,-84000,-84000,2021-06-09
8574,081320,台郡元大07購01,0,0,0,0,0,0,0,0,0,-84000,0,0,0,0,84000,-84000,-84000,2021-06-09
8575,1316,上曜,14000,98000,-84000,0,0,0,0,0,0,0,0,0,0,0,0,0,-84000,2021-06-09
8576,089920,臺股指凱基0C購20,0,0,0,0,0,0,0,0,0,-84000,0,0,0,49000,133000,-84000,-84000,2021-06-09
8577,032628,燁輝統一0C購02,0,0,0,0,0,0,0,0,0,-85000,0,0,0,20000,105000,-85000,-85000,2021-06-09
8578,032625,臺股指元大0C購11,0,0,0,0,0,0,0,0,0,-85000,0,0,0,3000,88000,-85000,-85000,2021-06-09
8579,032172,台泥群益0C購01,0,0,0,0,0,0,0,0,0,-85000,0,0,0,11000,96000,-85000,-85000,2021-06-09
8580,032229,新唐統一0C購04,0,0,0,0,0,0,0,0,0,-85000,0,0,0,0,85000,-85000,-85000,2021-06-09
8581,032056,王品國票0B購01,0,0,0,0,0,0,0,0,0,-85000,0,0,0,15000,100000,-85000,-85000,2021-06-09
8582,034111,華邦電群益0B購08,0,0,0,0,0,0,0,0,0,-85000,0,0,0,15000,100000,-85000,-85000,2021-06-09
8583,035023,鴻海凱基0C購03,0,0,0,0,0,0,0,0,0,-85000,0,0,0,0,85000,-85000,-85000,2021-06-09
8584,06985P,瑞昱元大0A售04,0,0,0,0,0,0,0,0,0,-85000,0,0,0,8000,93000,-85000,-85000,2021-06-09
8585,089844,瑞昱元大09購01,0,0,0,0,0,0,0,0,0,-85000,0,0,0,17000,102000,-85000,-85000,2021-06-09
8586,1232,大統益,13000,97000,-84000,0,0,0,0,0,0,-1000,0,1000,-1000,0,0,0,-85000,2021-06-09
8587,8249,菱光,21000,106000,-85000,0,0,0,0,0,0,0,0,0,0,0,0,0,-85000,2021-06-09
8588,087747,力山國票0A購02,0,0,0,0,0,0,0,0,0,-86000,0,0,0,13000,99000,-86000,-86000,2021-06-09
8589,036322,GIS統一12購01,0,0,0,0,0,0,0,0,0,-86000,0,0,0,0,86000,-86000,-86000,2021-06-09
8590,033454,偉詮電群益12購01,0,0,0,0,0,0,0,0,0,-86000,0,0,0,35000,121000,-86000,-86000,2021-06-09
8591,030954,台泥元大0A購01,0,0,0,0,0,0,0,0,0,-86000,0,0,0,285000,371000,-86000,-86000,2021-06-09
8592,031207,東鋼凱基0B購04,0,0,0,0,0,0,0,0,0,-86000,0,0,0,99000,185000,-86000,-86000,2021-06-09
8593,035482,凌陽群益0B購02,0,0,0,0,0,0,0,0,0,-86000,0,0,0,86000,172000,-86000,-86000,2021-06-09
8594,033977,聯詠凱基0B購03,0,0,0,0,0,0,0,0,0,-86000,0,0,0,15000,101000,-86000,-86000,2021-06-09
8595,033787,京元電元大0B購03,0,0,0,0,0,0,0,0,0,-86000,0,0,0,317000,403000,-86000,-86000,2021-06-09
8596,078242,聯茂元富0C購01,0,0,0,0,0,0,0,0,0,-86000,0,0,0,0,86000,-86000,-86000,2021-06-09
8597,088407,正崴永豐09購01,0,0,0,0,0,0,0,0,0,-87000,0,0,0,0,87000,-87000,-87000,2021-06-09
8598,088629,達運永豐0A購01,0,0,0,0,0,0,0,0,0,-87000,0,0,0,0,87000,-87000,-87000,2021-06-09
8599,034701,愛普群益12購01,0,0,0,0,0,0,0,0,0,-87000,0,0,0,0,87000,-87000,-87000,2021-06-09
8600,036159,聯詠元大0C購07,0,0,0,0,0,0,0,0,0,-87000,0,0,0,18000,105000,-87000,-87000,2021-06-09
8601,033902,聯發科統一15購07,0,0,0,0,0,0,0,0,0,-87000,0,0,0,120000,207000,-87000,-87000,2021-06-09
8602,035052,國泰金富邦11購01,0,0,0,0,0,0,0,0,0,-87000,0,0,0,0,87000,-87000,-87000,2021-06-09
8603,035070,鴻海群益0C購07,0,0,0,0,0,0,0,0,0,-87000,0,0,0,33000,120000,-87000,-87000,2021-06-09
8604,073110,和桐元富08購01,0,0,0,0,0,0,0,0,0,-87000,0,0,0,32000,119000,-87000,-87000,2021-06-09
8605,06584P,亞德客凱基09售03,0,0,0,0,0,0,0,0,0,-87000,0,0,0,215000,302000,-87000,-87000,2021-06-09
8606,085209,惠特群益09購01,0,0,0,0,0,0,0,0,0,-88000,0,0,0,240000,328000,-88000,-88000,2021-06-09
8607,086353,緯創元大09購02,0,0,0,0,0,0,0,0,0,-88000,0,0,0,15000,103000,-88000,-88000,2021-06-09
8608,086229,晶技統一0A購02,0,0,0,0,0,0,0,0,0,-88000,0,0,0,45000,133000,-88000,-88000,2021-06-09
8609,030057,立積元大0A購04,0,0,0,0,0,0,0,0,0,-88000,0,0,0,100000,188000,-88000,-88000,2021-06-09
8610,036343,台表科元富12購03,0,0,0,0,0,0,0,0,0,-88000,0,0,0,132000,220000,-88000,-88000,2021-06-09
8611,081136,神隆凱基0A購01,0,0,0,0,0,0,0,0,0,-88000,0,0,0,0,88000,-88000,-88000,2021-06-09
8612,089840,光磊元大09購02,0,0,0,0,0,0,0,0,0,-88000,0,0,0,25000,113000,-88000,-88000,2021-06-09
8613,089223,瀚宇博群益0A購01,0,0,0,0,0,0,0,0,0,-88000,0,0,0,0,88000,-88000,-88000,2021-06-09
8614,089231,智邦永豐09購02,0,0,0,0,0,0,0,0,0,-88000,0,0,0,169000,257000,-88000,-88000,2021-06-09
8615,087356,臺股指麥證0C購02,0,0,0,20000,109000,-89000,0,0,0,-89000,0,0,0,20000,109000,-89000,-89000,2021-06-09
8616,034601,友達統一0B購09,0,0,0,0,0,0,0,0,0,-89000,0,0,0,207000,296000,-89000,-89000,2021-06-09
8617,06370P,友達元大08售08,0,0,0,0,0,0,0,0,0,-89000,0,0,0,89000,178000,-89000,-89000,2021-06-09
8618,081870,台積電麥證0B購01,0,0,0,0,89000,-89000,0,0,0,-89000,0,0,0,0,89000,-89000,-89000,2021-06-09
8619,1201,味全,109000,179000,-70000,0,0,0,0,0,0,-19000,0,0,0,0,19000,-19000,-89000,2021-06-09
8620,2033,佳大,48000,137000,-89000,0,0,0,0,0,0,0,0,0,0,0,0,0,-89000,2021-06-09
8621,2915,潤泰全,433000,317000,116000,0,0,0,0,295000,-295000,89444,46000,2556,43444,47000,1000,46000,-89556,2021-06-09
8622,087622,大立光麥證09購03,0,0,0,0,90000,-90000,0,0,0,-90000,0,0,0,0,90000,-90000,-90000,2021-06-09
8623,087908,聯電群益0A購05,0,0,0,0,0,0,0,0,0,-90000,0,0,0,0,90000,-90000,-90000,2021-06-09
8624,085482,上証2X凱基0B購01,0,0,0,0,0,0,0,0,0,-90000,0,0,0,20000,110000,-90000,-90000,2021-06-09
8625,084071,聯電元大07購18,0,0,0,0,0,0,0,0,0,-90000,0,0,0,0,90000,-90000,-90000,2021-06-09
8626,083646,緯穎康和07購01,0,0,0,0,0,0,0,0,0,-90000,0,0,0,0,90000,-90000,-90000,2021-06-09
8627,083805,大立光元富0A購03,0,0,0,0,0,0,0,0,0,-90000,0,0,0,0,90000,-90000,-90000,2021-06-09
8628,030113,嘉威永豐0A購01,0,0,0,0,0,0,0,0,0,-90000,0,0,0,10000,100000,-90000,-90000,2021-06-09
8629,033216,聯電元富0C購02,0,0,0,0,0,0,0,0,0,-90000,0,0,0,0,90000,-90000,-90000,2021-06-09
8630,033026,京元電國泰0C購01,0,0,0,0,0,0,0,0,0,-90000,0,0,0,133000,223000,-90000,-90000,2021-06-09
8631,032987,大成鋼元富0A購06,0,0,0,0,0,0,0,0,0,-90000,0,0,0,130000,220000,-90000,-90000,2021-06-09
8632,033080,聯電統一14購01,0,0,0,0,0,0,0,0,0,-90000,0,0,0,10000,100000,-90000,-90000,2021-06-09
8633,032270,台泥富邦0B購01,0,0,0,0,0,0,0,0,0,-90000,0,0,0,10000,100000,-90000,-90000,2021-06-09
8634,032141,聯發科凱基0A購09,0,0,0,0,0,0,0,0,0,-90000,0,0,0,0,90000,-90000,-90000,2021-06-09
8635,034643,臺股指元大0C購17,0,0,0,0,0,0,0,0,0,-90000,0,0,0,10000,100000,-90000,-90000,2021-06-09
8636,034107,國巨群益0B購02,0,0,0,0,0,0,0,0,0,-90000,0,0,0,436000,526000,-90000,-90000,2021-06-09
8637,034739,長榮元大0C購09,0,0,0,0,0,0,0,0,0,-90000,0,0,0,125000,215000,-90000,-90000,2021-06-09
8638,04474P,智易元富08售04,0,0,0,0,0,0,0,0,0,-90000,0,0,0,0,90000,-90000,-90000,2021-06-09
8639,033933,創意元大0C購01,0,0,0,0,0,0,0,0,0,-90000,0,0,0,88000,178000,-90000,-90000,2021-06-09
8640,082147,惠特元富08購01,0,0,0,0,0,0,0,0,0,-90000,0,0,0,10000,100000,-90000,-90000,2021-06-09
8641,083088,鴻海元大07購17,0,0,0,0,0,0,0,0,0,-90000,0,0,0,0,90000,-90000,-90000,2021-06-09
8642,082715,帆宣凱基09購01,0,0,0,0,0,0,0,0,0,-90000,0,0,0,0,90000,-90000,-90000,2021-06-09
8643,082473,緯穎元大09購01,0,0,0,0,0,0,0,0,0,-90000,0,0,0,146000,236000,-90000,-90000,2021-06-09
8644,081051,寶齡國票0A購01,0,0,0,0,0,0,0,0,0,-90000,0,0,0,124000,214000,-90000,-90000,2021-06-09
8645,079769,台積電富邦08購10,0,0,0,0,0,0,0,0,0,-90000,0,0,0,25000,115000,-90000,-90000,2021-06-09
8646,06447P,嘉澤凱基09售02,0,0,0,0,0,0,0,0,0,-90000,0,0,0,119000,209000,-90000,-90000,2021-06-09
8647,07245P,國巨國泰12售02,0,0,0,0,0,0,0,0,0,-90000,0,0,0,1000,91000,-90000,-90000,2021-06-09
8648,07216P,國喬國泰0C售01,0,0,0,0,0,0,0,0,0,-90000,0,0,0,0,90000,-90000,-90000,2021-06-09
8649,077945,同欣電統一08購02,0,0,0,0,0,0,0,0,0,-90000,0,0,0,110000,200000,-90000,-90000,2021-06-09
8650,4942,嘉彰,2000,92000,-90000,0,0,0,0,0,0,0,0,0,0,0,0,0,-90000,2021-06-09
8651,1517,利奇,286000,376000,-90000,0,0,0,0,0,0,0,0,0,0,0,0,0,-90000,2021-06-09
8652,085630,旺宏凱基08購06,0,0,0,0,0,0,0,0,0,-91000,0,0,0,0,91000,-91000,-91000,2021-06-09
8653,085296,日月光凱基09購03,0,0,0,0,0,0,0,0,0,-91000,0,0,0,9000,100000,-91000,-91000,2021-06-09
8654,088924,宏碁統一0B購01,0,0,0,0,0,0,0,0,0,-91000,0,0,0,5000,96000,-91000,-91000,2021-06-09
8655,033336,中纖永豐0B購01,0,0,0,0,0,0,0,0,0,-91000,0,0,0,0,91000,-91000,-91000,2021-06-09
8656,033521,智邦國票0C購01,0,0,0,0,0,0,0,0,0,-91000,0,0,0,16000,107000,-91000,-91000,2021-06-09
8657,032360,凌陽凱基0B購01,0,0,0,0,0,0,0,0,0,-91000,0,0,0,100000,191000,-91000,-91000,2021-06-09
8658,033164,矽統中信0B購01,0,0,0,0,0,0,0,0,0,-91000,0,0,0,0,91000,-91000,-91000,2021-06-09
8659,030351,華新科群益0A購01,0,0,0,0,0,0,0,0,0,-91000,0,0,0,0,91000,-91000,-91000,2021-06-09
8660,033901,聯發科統一15購06,0,0,0,0,0,0,0,0,0,-91000,0,0,0,15000,106000,-91000,-91000,2021-06-09
8661,034100,威鋒電元大0C購01,0,0,0,0,0,0,0,0,0,-91000,0,0,0,21000,112000,-91000,-91000,2021-06-09
8662,078112,致茂元富0C購01,0,0,0,0,0,0,0,0,0,-91000,0,0,0,0,91000,-91000,-91000,2021-06-09
8663,080406,健鼎元大09購02,0,0,0,0,0,0,0,0,0,-91000,0,0,0,9000,100000,-91000,-91000,2021-06-09
8664,083238,台達電群益08購02,0,0,0,0,0,0,0,0,0,-91000,0,0,0,5000,96000,-91000,-91000,2021-06-09
8665,089622,中纖凱基12購01,0,0,0,0,0,0,0,0,0,-91000,0,0,0,0,91000,-91000,-91000,2021-06-09
8666,1721,三晃,28000,119000,-91000,0,0,0,0,0,0,0,0,0,0,0,0,0,-91000,2021-06-09
8667,6592,和潤企業,312000,411000,-99000,0,0,0,0,0,0,8000,4000,2000,2000,6000,0,6000,-91000,2021-06-09
8668,088957,台積電國票11購02,0,0,0,0,0,0,0,0,0,-92000,0,0,0,3000,95000,-92000,-92000,2021-06-09
8669,087945,儒鴻元富0A購01,0,0,0,0,0,0,0,0,0,-92000,0,0,0,11000,103000,-92000,-92000,2021-06-09
8670,086814,聯發科元富09購08,0,0,0,0,0,0,0,0,0,-92000,0,0,0,0,92000,-92000,-92000,2021-06-09
8671,084546,大銀統一0B購01,0,0,0,0,0,0,0,0,0,-92000,0,0,0,0,92000,-92000,-92000,2021-06-09
8672,030770,創意康和0B購01,0,0,0,0,0,0,0,0,0,-92000,0,0,0,2000,94000,-92000,-92000,2021-06-09
8673,034481,國巨元大0B購12,0,0,0,0,0,0,0,0,0,-92000,0,0,0,212000,304000,-92000,-92000,2021-06-09
8674,033611,技嘉群益0C購02,0,0,0,0,0,0,0,0,0,-92000,0,0,0,0,92000,-92000,-92000,2021-06-09
8675,081462,順德元富0A購02,0,0,0,0,0,0,0,0,0,-92000,0,0,0,20000,112000,-92000,-92000,2021-06-09
8676,2820,華票,46000,138000,-92000,0,0,0,0,0,0,0,0,0,0,0,0,0,-92000,2021-06-09
8677,087520,聯發科凱基11購02,0,0,0,0,0,0,0,0,0,-93000,0,0,0,0,93000,-93000,-93000,2021-06-09
8678,033576,力鵬凱基13購01,0,0,0,0,0,0,0,0,0,-93000,0,0,0,15000,108000,-93000,-93000,2021-06-09
8679,031892,立積凱基0A購05,0,0,0,0,0,0,0,0,0,-93000,0,0,0,36000,129000,-93000,-93000,2021-06-09
8680,033490,友達統一11購03,0,0,0,0,0,0,0,0,0,-93000,0,0,0,105000,198000,-93000,-93000,2021-06-09
8681,034161,華碩永豐0B購01,0,0,0,0,0,0,0,0,0,-93000,0,0,0,15000,108000,-93000,-93000,2021-06-09
8682,035323,萬海元大0B購11,0,0,0,0,0,0,0,0,0,-93000,0,0,0,126000,219000,-93000,-93000,2021-06-09
8683,4426,利勤,12000,105000,-93000,0,0,0,0,0,0,0,0,0,0,0,0,0,-93000,2021-06-09
8684,089868,立積中信11購01,0,0,0,0,0,0,0,0,0,-93000,0,0,0,7000,100000,-93000,-93000,2021-06-09
8685,088870,立積永豐09購04,0,0,0,0,0,0,0,0,0,-94000,0,0,0,25000,119000,-94000,-94000,2021-06-09
8686,088851,永光永豐09購01,0,0,0,0,0,0,0,0,0,-94000,0,0,0,34000,128000,-94000,-94000,2021-06-09
8687,033141,聯詠元大0A購09,0,0,0,0,0,0,0,0,0,-94000,0,0,0,20000,114000,-94000,-94000,2021-06-09
8688,083193,精成科國票08購02,0,0,0,0,0,0,0,0,0,-94000,0,0,0,10000,104000,-94000,-94000,2021-06-09
8689,081844,聯電永豐07購02,0,0,0,0,0,0,0,0,0,-94000,0,0,0,0,94000,-94000,-94000,2021-06-09
8690,2440,太空梭,48000,142000,-94000,0,0,0,0,0,0,0,0,0,0,0,0,0,-94000,2021-06-09
8691,086483,義隆統一0B購03,0,0,0,0,0,0,0,0,0,-95000,0,0,0,134000,229000,-95000,-95000,2021-06-09
8692,084480,華邦電凱基0B購01,0,0,0,0,0,0,0,0,0,-95000,0,0,0,4000,99000,-95000,-95000,2021-06-09
8693,085365,聚鼎永豐08購01,0,0,0,0,0,0,0,0,0,-95000,0,0,0,40000,135000,-95000,-95000,2021-06-09
8694,033573,聯成凱基11購01,0,0,0,0,0,0,0,0,0,-95000,0,0,0,39000,134000,-95000,-95000,2021-06-09
8695,032026,台積電台新0B購01,0,0,0,0,0,0,0,0,0,-95000,0,0,0,0,95000,-95000,-95000,2021-06-09
8696,031924,美德醫永豐0A購01,0,0,0,0,0,0,0,0,0,-95000,0,0,0,0,95000,-95000,-95000,2021-06-09
8697,030601,聯電元大0A購03,0,0,0,0,0,0,0,0,0,-95000,0,0,0,0,95000,-95000,-95000,2021-06-09
8698,031347,精成科元大0A購01,0,0,0,0,0,0,0,0,0,-95000,0,0,0,116000,211000,-95000,-95000,2021-06-09
8699,030170,揚明光國泰0C購01,0,0,0,0,0,0,0,0,0,-95000,0,0,0,0,95000,-95000,-95000,2021-06-09
8700,031476,華邦電國票0B購01,0,0,0,0,0,0,0,0,0,-95000,0,0,0,50000,145000,-95000,-95000,2021-06-09
8701,035922,新唐統一11購01,0,0,0,0,0,0,0,0,0,-95000,0,0,0,36000,131000,-95000,-95000,2021-06-09
8702,035619,台玻國票0C購05,0,0,0,0,0,0,0,0,0,-95000,0,0,0,1000,96000,-95000,-95000,2021-06-09
8703,035633,臺股指國票0C購01,0,0,0,0,0,0,0,0,0,-95000,0,0,0,1000,96000,-95000,-95000,2021-06-09
8704,033807,友達麥證0B購04,0,0,0,5000,100000,-95000,0,0,0,-95000,0,0,0,5000,100000,-95000,-95000,2021-06-09
8705,034631,中石化元大0B購03,0,0,0,0,0,0,0,0,0,-95000,0,0,0,130000,225000,-95000,-95000,2021-06-09
8706,035562,愛普統一0C購02,0,0,0,0,0,0,0,0,0,-95000,0,0,0,0,95000,-95000,-95000,2021-06-09
8707,080710,聯詠凱基07購02,0,0,0,0,0,0,0,0,0,-95000,0,0,0,0,95000,-95000,-95000,2021-06-09
8708,085779,聯電元大08購09,0,0,0,0,0,0,0,0,0,-96000,0,0,0,343000,439000,-96000,-96000,2021-06-09
8709,083563,台達電群益08購03,0,0,0,0,0,0,0,0,0,-96000,0,0,0,0,96000,-96000,-96000,2021-06-09
8710,084200,華邦電元大07購16,0,0,0,0,0,0,0,0,0,-96000,0,0,0,5000,101000,-96000,-96000,2021-06-09
8711,088742,威健永豐09購02,0,0,0,0,0,0,0,0,0,-96000,0,0,0,0,96000,-96000,-96000,2021-06-09
8712,030392,鴻海元大0C購11,0,0,0,0,0,0,0,0,0,-96000,0,0,0,206000,302000,-96000,-96000,2021-06-09
8713,032178,永光群益0A購01,0,0,0,0,0,0,0,0,0,-96000,0,0,0,0,96000,-96000,-96000,2021-06-09
8714,036386,長榮航富邦12購01,0,0,0,0,0,0,0,0,0,-96000,0,0,0,144000,240000,-96000,-96000,2021-06-09
8715,034584,貿聯凱基0C購01,0,0,0,0,0,0,0,0,0,-96000,0,0,0,0,96000,-96000,-96000,2021-06-09
8716,035888,聯陽國票11購01,0,0,0,0,0,0,0,0,0,-96000,0,0,0,544000,640000,-96000,-96000,2021-06-09
8717,035423,聯電元大11購03,0,0,0,0,0,0,0,0,0,-96000,0,0,0,22000,118000,-96000,-96000,2021-06-09
8718,089932,義隆永豐0A購01,0,0,0,0,0,0,0,0,0,-96000,0,0,0,15000,111000,-96000,-96000,2021-06-09
8719,086879,鴻海富邦0B購01,0,0,0,0,0,0,0,0,0,-97000,0,0,0,0,97000,-97000,-97000,2021-06-09
8720,084880,緯穎元大08購02,0,0,0,0,0,0,0,0,0,-97000,0,0,0,20000,117000,-97000,-97000,2021-06-09
8721,033009,國喬麥證0A購01,0,0,0,37000,134000,-97000,0,0,0,-97000,0,0,0,37000,134000,-97000,-97000,2021-06-09
8722,080837,卜蜂元富07購01,0,0,0,0,0,0,0,0,0,-97000,0,0,0,20000,117000,-97000,-97000,2021-06-09
8723,07271P,臺股指凱基0C售32,0,0,0,0,0,0,0,0,0,-97000,0,0,0,14000,111000,-97000,-97000,2021-06-09
8724,07138P,日月光凱基0B售03,0,0,0,0,0,0,0,0,0,-97000,0,0,0,0,97000,-97000,-97000,2021-06-09
8725,089614,景碩群益0B購01,0,0,0,0,0,0,0,0,0,-97000,0,0,0,79000,176000,-97000,-97000,2021-06-09
8726,9925,新保,49000,146000,-97000,0,0,0,0,0,0,0,0,0,0,0,0,0,-97000,2021-06-09
8727,6505,台塑化,570000,680600,-110600,0,0,0,103000,0,103000,-89981,44019,134000,-89981,0,0,0,-97581,2021-06-09
8728,085480,日月光麥證08購01,0,0,0,0,98000,-98000,0,0,0,-98000,0,0,0,0,98000,-98000,-98000,2021-06-09
8729,088549,正文群益0A購01,0,0,0,0,0,0,0,0,0,-98000,0,0,0,0,98000,-98000,-98000,2021-06-09
8730,088102,京元電國票0A購01,0,0,0,0,0,0,0,0,0,-98000,0,0,0,1000,99000,-98000,-98000,2021-06-09
8731,030026,上銀統一0C購01,0,0,0,0,0,0,0,0,0,-98000,0,0,0,41000,139000,-98000,-98000,2021-06-09
8732,030147,界霖凱基12購01,0,0,0,0,0,0,0,0,0,-98000,0,0,0,2000,100000,-98000,-98000,2021-06-09
8733,035438,群創元大0B購14,0,0,0,0,0,0,0,0,0,-98000,0,0,0,2000,100000,-98000,-98000,2021-06-09
8734,035439,群創元大0B購15,0,0,0,0,0,0,0,0,0,-98000,0,0,0,72000,170000,-98000,-98000,2021-06-09
8735,035309,新光鋼元大0B購05,0,0,0,0,0,0,0,0,0,-98000,0,0,0,19000,117000,-98000,-98000,2021-06-09
8736,035312,國巨元大11購03,0,0,0,0,0,0,0,0,0,-98000,0,0,0,53000,151000,-98000,-98000,2021-06-09
8737,035975,緯穎元大13購01,0,0,0,0,0,0,0,0,0,-98000,0,0,0,15000,113000,-98000,-98000,2021-06-09
8738,081195,華邦電元大07購08,0,0,0,0,0,0,0,0,0,-98000,0,0,0,12000,110000,-98000,-98000,2021-06-09
8739,086447,南電永豐09購02,0,0,0,0,0,0,0,0,0,-99000,0,0,0,0,99000,-99000,-99000,2021-06-09
8740,085596,上証2X元大08購06,0,0,0,0,0,0,0,0,0,-99000,0,0,0,0,99000,-99000,-99000,2021-06-09
8741,085261,盛群國泰0A購01,0,0,0,0,0,0,0,0,0,-99000,0,0,0,47000,146000,-99000,-99000,2021-06-09
8742,084490,強茂凱基08購02,0,0,0,0,0,0,0,0,0,-99000,0,0,0,74000,173000,-99000,-99000,2021-06-09
8743,084615,台灣50凱基09購03,0,0,0,0,0,0,0,0,0,-99000,0,0,0,1000,100000,-99000,-99000,2021-06-09
8744,084251,緯穎統一09購02,0,0,0,0,0,0,0,0,0,-99000,0,0,0,0,99000,-99000,-99000,2021-06-09
8745,030198,鑫永銓凱基0A購01,0,0,0,0,0,0,0,0,0,-99000,0,0,0,58000,157000,-99000,-99000,2021-06-09
8746,031505,宏碁元大0A購02,0,0,0,0,0,0,0,0,0,-99000,0,0,0,21000,120000,-99000,-99000,2021-06-09
8747,05485P,榮成元富06售02,0,0,0,0,0,0,0,0,0,-99000,0,0,0,0,99000,-99000,-99000,2021-06-09
8748,035988,新唐國票11購02,0,0,0,0,0,0,0,0,0,-99000,0,0,0,113000,212000,-99000,-99000,2021-06-09
8749,06115P,A50正2元富07售03,0,0,0,0,0,0,0,0,0,-99000,0,0,0,29000,128000,-99000,-99000,2021-06-09
8750,082184,亞德客永豐07購01,0,0,0,0,0,0,0,0,0,-99000,0,0,0,0,99000,-99000,-99000,2021-06-09
8751,083061,凱美永豐07購02,0,0,0,0,0,0,0,0,0,-99000,0,0,0,0,99000,-99000,-99000,2021-06-09
8752,06623P,英業達元富09售03,0,0,0,0,0,0,0,0,0,-99000,0,0,0,5000,104000,-99000,-99000,2021-06-09
8753,1734,杏輝,153000,252000,-99000,0,0,0,0,0,0,0,0,0,0,0,0,0,-99000,2021-06-09
8754,2316,楠梓電,51000,150000,-99000,0,0,0,0,0,0,0,0,0,0,0,0,0,-99000,2021-06-09
8755,083762,敬鵬兆豐08購01,0,0,0,0,0,0,0,0,0,-100000,0,0,0,0,100000,-100000,-100000,2021-06-09
8756,083705,T50反1元大0A購07,0,0,0,0,0,0,0,0,0,-100000,0,0,0,190000,290000,-100000,-100000,2021-06-09
8757,083664,精成科群益07購01,0,0,0,0,0,0,0,0,0,-100000,0,0,0,0,100000,-100000,-100000,2021-06-09
8758,084373,鴻海統一09購18,0,0,0,0,0,0,0,0,0,-100000,0,0,0,0,100000,-100000,-100000,2021-06-09
8759,084445,智邦日盛08購01,0,0,0,0,0,0,0,0,0,-100000,0,0,0,0,100000,-100000,-100000,2021-06-09
8760,084939,和碩元大08購03,0,0,0,0,0,0,0,0,0,-100000,0,0,0,0,100000,-100000,-100000,2021-06-09
8761,085205,臻鼎群益08購01,0,0,0,0,0,0,0,0,0,-100000,0,0,0,0,100000,-100000,-100000,2021-06-09
8762,085087,滬深2X凱基0B購01,0,0,0,0,0,0,0,0,0,-100000,0,0,0,0,100000,-100000,-100000,2021-06-09
8763,085867,松翰統一0A購01,0,0,0,0,0,0,0,0,0,-100000,0,0,0,0,100000,-100000,-100000,2021-06-09
8764,085892,聯發科國票09購06,0,0,0,0,0,0,0,0,0,-100000,0,0,0,0,100000,-100000,-100000,2021-06-09
8765,086009,玉晶光元大0A購02,0,0,0,0,0,0,0,0,0,-100000,0,0,0,200000,300000,-100000,-100000,2021-06-09
8766,086226,亞光統一0A購07,0,0,0,0,0,0,0,0,0,-100000,0,0,0,0,100000,-100000,-100000,2021-06-09
8767,086335,旺宏元大09購02,0,0,0,0,0,0,0,0,0,-100000,0,0,0,0,100000,-100000,-100000,2021-06-09
8768,086708,微星元大09購01,0,0,0,0,0,0,0,0,0,-100000,0,0,0,45000,145000,-100000,-100000,2021-06-09
8769,086852,矽創元大0A購01,0,0,0,0,0,0,0,0,0,-100000,0,0,0,0,100000,-100000,-100000,2021-06-09
8770,086959,鴻海永豐09購04,0,0,0,0,0,0,0,0,0,-100000,0,0,0,0,100000,-100000,-100000,2021-06-09
8771,086968,南亞科統一0B購02,0,0,0,0,0,0,0,0,0,-100000,0,0,0,0,100000,-100000,-100000,2021-06-09
8772,087464,佳世達國票0A購02,0,0,0,0,0,0,0,0,0,-100000,0,0,0,0,100000,-100000,-100000,2021-06-09
8773,087263,GIS國票09購01,0,0,0,0,0,0,0,0,0,-100000,0,0,0,60000,160000,-100000,-100000,2021-06-09
8774,088063,瀚宇博元大09購01,0,0,0,0,0,0,0,0,0,-100000,0,0,0,0,100000,-100000,-100000,2021-06-09
8775,088307,微星凱基0A購01,0,0,0,0,0,0,0,0,0,-100000,0,0,0,0,100000,-100000,-100000,2021-06-09
8776,087723,T50反1元富13購01,0,0,0,0,0,0,0,0,0,-100000,0,0,0,0,100000,-100000,-100000,2021-06-09
8777,087764,精英國泰0B購01,0,0,0,0,0,0,0,0,0,-100000,0,0,0,0,100000,-100000,-100000,2021-06-09
8778,088495,國巨元大0A購01,0,0,0,0,0,0,0,0,0,-100000,0,0,0,0,100000,-100000,-100000,2021-06-09
8779,089064,為升凱基0B購01,0,0,0,0,0,0,0,0,0,-100000,0,0,0,0,100000,-100000,-100000,2021-06-09
8780,088989,惠特元富09購03,0,0,0,0,0,0,0,0,0,-100000,0,0,0,0,100000,-100000,-100000,2021-06-09
8781,036291,友達元大0C購16,0,0,0,0,0,0,0,0,0,-100000,0,0,0,0,100000,-100000,-100000,2021-06-09
8782,032207,台達化統一11購01,0,0,0,0,0,0,0,0,0,-100000,0,0,0,0,100000,-100000,-100000,2021-06-09
8783,032138,台船凱基0A購01,0,0,0,0,0,0,0,0,0,-100000,0,0,0,0,100000,-100000,-100000,2021-06-09
8784,032503,華邦電永豐0A購05,0,0,0,0,0,0,0,0,0,-100000,0,0,0,0,100000,-100000,-100000,2021-06-09
8785,033055,矽統永豐0A購03,0,0,0,0,0,0,0,0,0,-100000,0,0,0,0,100000,-100000,-100000,2021-06-09
8786,033282,聯發科統一15購01,0,0,0,0,0,0,0,0,0,-100000,0,0,0,0,100000,-100000,-100000,2021-06-09
8787,033240,旺宏元大11購04,0,0,0,0,0,0,0,0,0,-100000,0,0,0,0,100000,-100000,-100000,2021-06-09
8788,031839,上銀兆豐0B購01,0,0,0,0,0,0,0,0,0,-100000,0,0,0,0,100000,-100000,-100000,2021-06-09
8789,031857,新唐中信0A購02,0,0,0,0,0,0,0,0,0,-100000,0,0,0,189000,289000,-100000,-100000,2021-06-09
8790,031240,廣宇群益0C購02,0,0,0,0,0,0,0,0,0,-100000,0,0,0,0,100000,-100000,-100000,2021-06-09
8791,031413,永豐餘凱基0B購01,0,0,0,0,0,0,0,0,0,-100000,0,0,0,0,100000,-100000,-100000,2021-06-09
8792,030344,威盛群益0A購01,0,0,0,0,0,0,0,0,0,-100000,0,0,0,0,100000,-100000,-100000,2021-06-09
8793,030268,廣宇統一0C購01,0,0,0,0,0,0,0,0,0,-100000,0,0,0,0,100000,-100000,-100000,2021-06-09
8794,030852,惠特兆豐0A購01,0,0,0,0,0,0,0,0,0,-100000,0,0,0,0,100000,-100000,-100000,2021-06-09
8795,031551,致新中信0A購01,0,0,0,0,0,0,0,0,0,-100000,0,0,0,0,100000,-100000,-100000,2021-06-09
8796,031172,台達化永豐0A購01,0,0,0,0,0,0,0,0,0,-100000,0,0,0,0,100000,-100000,-100000,2021-06-09
8797,033203,華新群益0C購01,0,0,0,0,0,0,0,0,0,-100000,0,0,0,21000,121000,-100000,-100000,2021-06-09
8798,06134P,欣興凱基07售04,0,0,0,0,0,0,0,0,0,-100000,0,0,0,0,100000,-100000,-100000,2021-06-09
8799,06209P,T50正2群益09售02,0,0,0,0,0,0,0,0,0,-100000,0,0,0,0,100000,-100000,-100000,2021-06-09
8800,034967,強茂元大11購02,0,0,0,0,0,0,0,0,0,-100000,0,0,0,348000,448000,-100000,-100000,2021-06-09
8801,033729,群創國票11購01,0,0,0,0,0,0,0,0,0,-100000,0,0,0,0,100000,-100000,-100000,2021-06-09
8802,034661,愛普永豐0B購01,0,0,0,0,0,0,0,0,0,-100000,0,0,0,0,100000,-100000,-100000,2021-06-09
8803,034480,國巨元大0B購11,0,0,0,0,0,0,0,0,0,-100000,0,0,0,85000,185000,-100000,-100000,2021-06-09
8804,034514,遠東新元富0B購02,0,0,0,0,0,0,0,0,0,-100000,0,0,0,0,100000,-100000,-100000,2021-06-09
8805,034352,富邦金元富12購07,0,0,0,0,0,0,0,0,0,-100000,0,0,0,0,100000,-100000,-100000,2021-06-09
8806,033966,永冠凱基0B購01,0,0,0,0,0,0,0,0,0,-100000,0,0,0,0,100000,-100000,-100000,2021-06-09
8807,035953,儒鴻元大0C購02,0,0,0,0,0,0,0,0,0,-100000,0,0,0,8000,108000,-100000,-100000,2021-06-09
8808,035808,微星凱基0B購01,0,0,0,0,0,0,0,0,0,-100000,0,0,0,0,100000,-100000,-100000,2021-06-09
8809,035510,永豐金中信0B購01,0,0,0,0,0,0,0,0,0,-100000,0,0,0,0,100000,-100000,-100000,2021-06-09
8810,034857,長榮元大11購04,0,0,0,0,0,0,0,0,0,-100000,0,0,0,384000,484000,-100000,-100000,2021-06-09
8811,035370,臺指反凱基13購04,0,0,0,0,0,0,0,0,0,-100000,0,0,0,0,100000,-100000,-100000,2021-06-09
8812,035119,美時永豐0B購01,0,0,0,0,0,0,0,0,0,-100000,0,0,0,0,100000,-100000,-100000,2021-06-09
8813,036047,矽創元富13購01,0,0,0,0,0,0,0,0,0,-100000,0,0,0,224000,324000,-100000,-100000,2021-06-09
8814,036463,台玻元大11購01,0,0,0,0,0,0,0,0,0,-100000,0,0,0,0,100000,-100000,-100000,2021-06-09
8815,036556,榮運元大0C購02,0,0,0,0,0,0,0,0,0,-100000,0,0,0,0,100000,-100000,-100000,2021-06-09
8816,069701,致新元富08購01,0,0,0,0,0,0,0,0,0,-100000,0,0,0,182000,282000,-100000,-100000,2021-06-09
8817,072053,宏碁元富07購02,0,0,0,0,0,0,0,0,0,-100000,0,0,0,278000,378000,-100000,-100000,2021-06-09
8818,073021,眾達元大07購01,0,0,0,0,0,0,0,0,0,-100000,0,0,0,0,100000,-100000,-100000,2021-06-09
8819,076415,超眾統一07購03,0,0,0,0,0,0,0,0,0,-100000,0,0,0,0,100000,-100000,-100000,2021-06-09
8820,076939,燿華富邦07購01,0,0,0,0,0,0,0,0,0,-100000,0,0,0,0,100000,-100000,-100000,2021-06-09
8821,078619,道瓊反群益08購01,0,0,0,0,0,0,0,0,0,-100000,0,0,0,0,100000,-100000,-100000,2021-06-09
8822,078761,帆宣國票08購01,0,0,0,0,0,0,0,0,0,-100000,0,0,0,0,100000,-100000,-100000,2021-06-09
8823,082334,乙盛統一0B購01,0,0,0,0,0,0,0,0,0,-100000,0,0,0,0,100000,-100000,-100000,2021-06-09
8824,080473,滬深2X元大08購03,0,0,0,0,0,0,0,0,0,-100000,0,0,0,0,100000,-100000,-100000,2021-06-09
8825,079847,TPK元大06購02,0,0,0,0,0,0,0,0,0,-100000,0,0,0,0,100000,-100000,-100000,2021-06-09
8826,079766,為升富邦08購01,0,0,0,0,0,0,0,0,0,-100000,0,0,0,0,100000,-100000,-100000,2021-06-09
8827,1903,士紙,27000,127000,-100000,0,0,0,0,0,0,0,0,0,0,0,0,0,-100000,2021-06-09
8828,089097,立積統一0B購05,0,0,0,0,0,0,0,0,0,-100000,0,0,0,0,100000,-100000,-100000,2021-06-09
8829,089314,群創國票09購04,0,0,0,0,0,0,0,0,0,-100000,0,0,0,0,100000,-100000,-100000,2021-06-09
8830,084358,大立光元大07購13,0,0,0,0,0,0,0,0,0,-101000,0,0,0,0,101000,-101000,-101000,2021-06-09
8831,083754,廣宇國泰09購02,0,0,0,0,0,0,0,0,0,-101000,0,0,0,14000,115000,-101000,-101000,2021-06-09
8832,033182,矽創永豐0B購01,0,0,0,0,0,0,0,0,0,-101000,0,0,0,0,101000,-101000,-101000,2021-06-09
8833,032521,合勤控永豐0A購02,0,0,0,0,0,0,0,0,0,-101000,0,0,0,0,101000,-101000,-101000,2021-06-09
8834,034464,T50正2元大0B購03,0,0,0,0,0,0,0,0,0,-101000,0,0,0,0,101000,-101000,-101000,2021-06-09
8835,078118,強茂元富09購02,0,0,0,0,0,0,0,0,0,-101000,0,0,0,51000,152000,-101000,-101000,2021-06-09
8836,06462P,為升元大09售02,0,0,0,0,0,0,0,0,0,-101000,0,0,0,0,101000,-101000,-101000,2021-06-09
8837,083458,松翰麥證07購01,0,0,0,0,102000,-102000,0,0,0,-102000,0,0,0,0,102000,-102000,-102000,2021-06-09
8838,085325,T50反1群益0A購04,0,0,0,0,0,0,0,0,0,-102000,0,0,0,8000,110000,-102000,-102000,2021-06-09
8839,088707,松翰國泰0B購01,0,0,0,0,0,0,0,0,0,-102000,0,0,0,36000,138000,-102000,-102000,2021-06-09
8840,086880,佳世達富邦0B購01,0,0,0,0,0,0,0,0,0,-102000,0,0,0,0,102000,-102000,-102000,2021-06-09
8841,031597,矽統國票0B購01,0,0,0,0,0,0,0,0,0,-102000,0,0,0,41000,143000,-102000,-102000,2021-06-09
8842,034344,儒鴻元富0C購02,0,0,0,0,0,0,0,0,0,-102000,0,0,0,0,102000,-102000,-102000,2021-06-09
8843,05873P,台積電兆豐08售05,0,0,0,0,0,0,0,0,0,-102000,0,0,0,198000,300000,-102000,-102000,2021-06-09
8844,034431,大亞凱基0C購03,0,0,0,0,0,0,0,0,0,-102000,0,0,0,0,102000,-102000,-102000,2021-06-09
8845,06357P,南電國泰0A售01,0,0,0,0,0,0,0,0,0,-102000,0,0,0,31000,133000,-102000,-102000,2021-06-09
8846,06997P,欣興凱基0B售03,0,0,0,0,0,0,0,0,0,-102000,0,0,0,10000,112000,-102000,-102000,2021-06-09
8847,085767,鴻海凱基08購22,0,0,0,0,0,0,0,0,0,-103000,0,0,0,509000,612000,-103000,-103000,2021-06-09
8848,084668,聯發科國票08購11,0,0,0,0,0,0,0,0,0,-103000,0,0,0,2000,105000,-103000,-103000,2021-06-09
8849,089023,立積元大0A購01,0,0,0,0,0,0,0,0,0,-103000,0,0,0,16000,119000,-103000,-103000,2021-06-09
8850,030800,大立光凱基0A購08,0,0,0,0,0,0,0,0,0,-103000,0,0,0,4000,107000,-103000,-103000,2021-06-09
8851,030986,健和興元大0B購01,0,0,0,0,0,0,0,0,0,-103000,0,0,0,13000,116000,-103000,-103000,2021-06-09
8852,030311,國票金康和0A購01,0,0,0,0,0,0,0,0,0,-103000,0,0,0,10000,113000,-103000,-103000,2021-06-09
8853,032937,光罩富邦0C購01,0,0,0,0,0,0,0,0,0,-103000,0,0,0,89000,192000,-103000,-103000,2021-06-09
8854,033695,合勤控元大0C購01,0,0,0,0,0,0,0,0,0,-103000,0,0,0,35000,138000,-103000,-103000,2021-06-09
8855,034204,科嘉元大0B購01,0,0,0,0,0,0,0,0,0,-103000,0,0,0,0,103000,-103000,-103000,2021-06-09
8856,034694,長榮群益0B購10,0,0,0,0,0,0,0,0,0,-103000,0,0,0,166000,269000,-103000,-103000,2021-06-09
8857,034728,大成鋼元大0B購11,0,0,0,0,0,0,0,0,0,-103000,0,0,0,0,103000,-103000,-103000,2021-06-09
8858,035243,國巨群益0B購07,0,0,0,0,0,0,0,0,0,-103000,0,0,0,45000,148000,-103000,-103000,2021-06-09
8859,06915P,義隆元大0A售03,0,0,0,0,0,0,0,0,0,-103000,0,0,0,201000,304000,-103000,-103000,2021-06-09
8860,075942,致新國票08購01,0,0,0,0,0,0,0,0,0,-103000,0,0,0,10000,113000,-103000,-103000,2021-06-09
8861,080306,聯發科群益07購03,0,0,0,0,0,0,0,0,0,-103000,0,0,0,0,103000,-103000,-103000,2021-06-09
8862,083134,偉詮電凱基08購01,0,0,0,0,0,0,0,0,0,-103000,0,0,0,27000,130000,-103000,-103000,2021-06-09
8863,083295,奇力新元大07購05,0,0,0,0,0,0,0,0,0,-103000,0,0,0,0,103000,-103000,-103000,2021-06-09
8864,2535,達欣工,152000,256000,-104000,0,0,0,0,0,0,1000,0,0,0,1000,0,1000,-103000,2021-06-09
8865,4935,茂林-KY,118000,222000,-104000,0,0,0,0,0,0,1000,0,0,0,3000,2000,1000,-103000,2021-06-09
8866,4108,懷特,13000,116000,-103000,0,0,0,0,0,0,0,0,0,0,0,0,0,-103000,2021-06-09
8867,2027,大成鋼,11399995,9979000,1420995,0,0,0,34000,0,34000,-1558042,1182000,1657042,-475042,633000,1716000,-1083000,-103047,2021-06-09
8868,3443,創意,278000,471000,-193000,0,0,0,82000,0,82000,7924,7598,6898,700,28464,21240,7224,-103076,2021-06-09
8869,084144,凱美永豐07購04,0,0,0,0,0,0,0,0,0,-104000,0,0,0,0,104000,-104000,-104000,2021-06-09
8870,033314,欣興元富12購02,0,0,0,0,0,0,0,0,0,-104000,0,0,0,607000,711000,-104000,-104000,2021-06-09
8871,031446,立積麥證0A購01,0,0,0,33000,137000,-104000,0,0,0,-104000,0,0,0,33000,137000,-104000,-104000,2021-06-09
8872,031057,友達元大0A購06,0,0,0,0,0,0,0,0,0,-104000,0,0,0,0,104000,-104000,-104000,2021-06-09
8873,081743,裕隆元大08購01,0,0,0,0,0,0,0,0,0,-104000,0,0,0,0,104000,-104000,-104000,2021-06-09
8874,080560,大立光富邦08購04,0,0,0,0,0,0,0,0,0,-104000,0,0,0,0,104000,-104000,-104000,2021-06-09
8875,07000P,華新中信0B售03,0,0,0,0,0,0,0,0,0,-104000,0,0,0,0,104000,-104000,-104000,2021-06-09
8876,1471,首利,90000,194000,-104000,0,0,0,0,0,0,0,0,0,0,0,0,0,-104000,2021-06-09
8877,086217,台達電統一0A購03,0,0,0,0,0,0,0,0,0,-105000,0,0,0,10000,115000,-105000,-105000,2021-06-09
8878,085427,緯穎元大08購04,0,0,0,0,0,0,0,0,0,-105000,0,0,0,0,105000,-105000,-105000,2021-06-09
8879,086588,華碩國票09購01,0,0,0,0,0,0,0,0,0,-105000,0,0,0,0,105000,-105000,-105000,2021-06-09
8880,030396,廣宇元大0A購01,0,0,0,0,0,0,0,0,0,-105000,0,0,0,10000,115000,-105000,-105000,2021-06-09
8881,032316,玉晶光永豐0A購05,0,0,0,0,0,0,0,0,0,-105000,0,0,0,0,105000,-105000,-105000,2021-06-09
8882,035029,南電凱基0B購02,0,0,0,0,0,0,0,0,0,-105000,0,0,0,142000,247000,-105000,-105000,2021-06-09
8883,036436,長榮航凱基12購02,0,0,0,0,0,0,0,0,0,-105000,0,0,0,0,105000,-105000,-105000,2021-06-09
8884,034805,台表科凱基0B購03,0,0,0,0,0,0,0,0,0,-105000,0,0,0,0,105000,-105000,-105000,2021-06-09
8885,034095,和鑫元大0B購02,0,0,0,0,0,0,0,0,0,-105000,0,0,0,0,105000,-105000,-105000,2021-06-09
8886,034072,A50正2元大0B購01,0,0,0,0,0,0,0,0,0,-105000,0,0,0,130000,235000,-105000,-105000,2021-06-09
8887,074972,旺宏富邦07購01,0,0,0,0,0,0,0,0,0,-105000,0,0,0,0,105000,-105000,-105000,2021-06-09
8888,077284,力麗元富06購01,0,0,0,0,0,0,0,0,0,-105000,0,0,0,5000,110000,-105000,-105000,2021-06-09
8889,082949,台積電元富07購38,0,0,0,0,0,0,0,0,0,-105000,0,0,0,10000,115000,-105000,-105000,2021-06-09
8890,3057,喬鼎,29000,134000,-105000,0,0,0,0,0,0,0,0,0,0,0,0,0,-105000,2021-06-09
8891,5706,鳳凰,24000,134000,-110000,0,0,0,0,0,0,5000,6000,1000,5000,0,0,0,-105000,2021-06-09
8892,00752,中信中國50,25000,147000,-122000,0,0,0,0,0,0,16150,0,0,0,191000,174850,16150,-105850,2021-06-09
8893,030016,松翰元富0C購01,0,0,0,0,0,0,0,0,0,-106000,0,0,0,0,106000,-106000,-106000,2021-06-09
8894,030815,潤泰新富邦0C購01,0,0,0,0,0,0,0,0,0,-106000,0,0,0,0,106000,-106000,-106000,2021-06-09
8895,031550,矽格中信0B購01,0,0,0,0,0,0,0,0,0,-106000,0,0,0,18000,124000,-106000,-106000,2021-06-09
8896,033337,台玻永豐0B購02,0,0,0,0,0,0,0,0,0,-106000,0,0,0,10000,116000,-106000,-106000,2021-06-09
8897,6283,淳安,325000,431000,-106000,0,0,0,0,0,0,0,0,0,0,0,0,0,-106000,2021-06-09
8898,1730,花仙子,24000,130000,-106000,0,0,0,0,0,0,0,0,0,0,0,0,0,-106000,2021-06-09
8899,089943,立積永豐0A購01,0,0,0,0,0,0,0,0,0,-106000,0,0,0,0,106000,-106000,-106000,2021-06-09
8900,2505,國揚,97910,203000,-105090,0,0,0,0,0,0,-1000,0,0,0,1000,2000,-1000,-106090,2021-06-09
8901,086732,強茂中信0A購01,0,0,0,0,0,0,0,0,0,-107000,0,0,0,16000,123000,-107000,-107000,2021-06-09
8902,032607,華晶科元大11購01,0,0,0,0,0,0,0,0,0,-107000,0,0,0,34000,141000,-107000,-107000,2021-06-09
8903,033538,智原富邦0C購01,0,0,0,0,0,0,0,0,0,-107000,0,0,0,0,107000,-107000,-107000,2021-06-09
8904,034157,新光鋼永豐0B購01,0,0,0,0,0,0,0,0,0,-107000,0,0,0,0,107000,-107000,-107000,2021-06-09
8905,05843P,臺股指元大0A售05,0,0,0,0,0,0,0,0,0,-107000,0,0,0,0,107000,-107000,-107000,2021-06-09
8906,077671,台積電凱基0A購01,0,0,0,0,0,0,0,0,0,-107000,0,0,0,15000,122000,-107000,-107000,2021-06-09
8907,06877P,宏達電元富0A售02,0,0,0,0,0,0,0,0,0,-107000,0,0,0,2000,109000,-107000,-107000,2021-06-09
8908,07158P,南電國泰11售01,0,0,0,0,0,0,0,0,0,-107000,0,0,0,0,107000,-107000,-107000,2021-06-09
8909,087369,南亞元大09購01,0,0,0,0,0,0,0,0,0,-108000,0,0,0,62000,170000,-108000,-108000,2021-06-09
8910,088614,聯發科永豐09購05,0,0,0,0,0,0,0,0,0,-108000,0,0,0,1000,109000,-108000,-108000,2021-06-09
8911,033876,亞聚元富0B購01,0,0,0,0,0,0,0,0,0,-108000,0,0,0,10000,118000,-108000,-108000,2021-06-09
8912,034806,愛普凱基0B購02,0,0,0,0,0,0,0,0,0,-108000,0,0,0,0,108000,-108000,-108000,2021-06-09
8913,06887P,臺股指群益0A售17,0,0,0,0,0,0,0,0,0,-108000,0,0,0,10000,118000,-108000,-108000,2021-06-09
8914,07220P,萬海元大0B售12,0,0,0,0,0,0,0,0,0,-108000,0,0,0,220000,328000,-108000,-108000,2021-06-09
8915,081052,勝一國票08購01,0,0,0,0,0,0,0,0,0,-108000,0,0,0,39000,147000,-108000,-108000,2021-06-09
8916,3038,全台,331000,443000,-112000,0,0,0,0,0,0,4000,4000,0,4000,0,0,0,-108000,2021-06-09
8917,1451,年興,90000,198000,-108000,0,0,0,0,0,0,0,0,0,0,0,0,0,-108000,2021-06-09
8918,086535,南電凱基09購06,0,0,0,0,0,0,0,0,0,-109000,0,0,0,584000,693000,-109000,-109000,2021-06-09
8919,085292,聯詠凱基08購03,0,0,0,0,0,0,0,0,0,-109000,0,0,0,0,109000,-109000,-109000,2021-06-09
8920,085220,南電國票09購01,0,0,0,0,0,0,0,0,0,-109000,0,0,0,63000,172000,-109000,-109000,2021-06-09
8921,084510,台積電元大08購10,0,0,0,0,0,0,0,0,0,-109000,0,0,0,7000,116000,-109000,-109000,2021-06-09
8922,032840,台塑中信0A購01,0,0,0,0,0,0,0,0,0,-109000,0,0,0,1000,110000,-109000,-109000,2021-06-09
8923,032577,台苯元大0A購02,0,0,0,0,0,0,0,0,0,-109000,0,0,0,91000,200000,-109000,-109000,2021-06-09
8924,032155,惠特凱基0A購02,0,0,0,0,0,0,0,0,0,-109000,0,0,0,0,109000,-109000,-109000,2021-06-09
8925,030551,惠特凱基0A購01,0,0,0,0,0,0,0,0,0,-109000,0,0,0,0,109000,-109000,-109000,2021-06-09
8926,034425,開發金統一13購01,0,0,0,0,0,0,0,0,0,-109000,0,0,0,0,109000,-109000,-109000,2021-06-09
8927,034927,東鋼中信0B購03,0,0,0,0,0,0,0,0,0,-109000,0,0,0,0,109000,-109000,-109000,2021-06-09
8928,089625,聯電凱基13購01,0,0,0,0,0,0,0,0,0,-109000,0,0,0,165000,274000,-109000,-109000,2021-06-09
8929,086077,美指2X富邦0A購01,0,0,0,0,0,0,0,0,0,-110000,0,0,0,0,110000,-110000,-110000,2021-06-09
8930,087668,志超兆豐09購01,0,0,0,0,0,0,0,0,0,-110000,0,0,0,44000,154000,-110000,-110000,2021-06-09
8931,088484,新光金富邦0A購01,0,0,0,0,0,0,0,0,0,-110000,0,0,0,0,110000,-110000,-110000,2021-06-09
8932,031306,台積電富邦11購02,0,0,0,0,0,0,0,0,0,-110000,0,0,0,0,110000,-110000,-110000,2021-06-09
8933,030371,聯德群益0B購01,0,0,0,0,0,0,0,0,0,-110000,0,0,0,0,110000,-110000,-110000,2021-06-09
8934,030189,滬深2X凱基12購01,0,0,0,0,0,0,0,0,0,-110000,0,0,0,91000,201000,-110000,-110000,2021-06-09
8935,030176,威鋒電國泰0C購01,0,0,0,0,0,0,0,0,0,-110000,0,0,0,140000,250000,-110000,-110000,2021-06-09
8936,033139,健和興元大0A購01,0,0,0,0,0,0,0,0,0,-110000,0,0,0,79000,189000,-110000,-110000,2021-06-09
8937,034091,裕民元大11購02,0,0,0,0,0,0,0,0,0,-110000,0,0,0,0,110000,-110000,-110000,2021-06-09
8938,034058,T50反1國票11購02,0,0,0,0,0,0,0,0,0,-110000,0,0,0,2089000,2199000,-110000,-110000,2021-06-09
8939,034602,聯發科統一0B購06,0,0,0,0,0,0,0,0,0,-110000,0,0,0,0,110000,-110000,-110000,2021-06-09
8940,035705,東鋼元大0B購06,0,0,0,0,0,0,0,0,0,-110000,0,0,0,10000,120000,-110000,-110000,2021-06-09
8941,033992,中壽兆豐12購01,0,0,0,0,0,0,0,0,0,-110000,0,0,0,0,110000,-110000,-110000,2021-06-09
8942,033905,群創統一0B購11,0,0,0,0,0,0,0,0,0,-110000,0,0,0,0,110000,-110000,-110000,2021-06-09
8943,033900,友達統一15購05,0,0,0,0,0,0,0,0,0,-110000,0,0,0,0,110000,-110000,-110000,2021-06-09
8944,080414,茂林元大07購01,0,0,0,0,0,0,0,0,0,-110000,0,0,0,10000,120000,-110000,-110000,2021-06-09
8945,079582,上銀統一08購02,0,0,0,0,0,0,0,0,0,-110000,0,0,0,0,110000,-110000,-110000,2021-06-09
8946,079397,聯電國票08購03,0,0,0,0,0,0,0,0,0,-110000,0,0,0,0,110000,-110000,-110000,2021-06-09
8947,06627P,臺股指中信11售05,0,0,0,0,0,0,0,0,0,-110000,0,0,0,0,110000,-110000,-110000,2021-06-09
8948,06764P,臺股指麥證11售01,0,0,0,373000,183000,190000,0,0,0,-110000,0,0,0,373000,483000,-110000,-110000,2021-06-09
8949,089930,瑞昱永豐0A購01,0,0,0,0,0,0,0,0,0,-110000,0,0,0,0,110000,-110000,-110000,2021-06-09
8950,030119,恆大凱基12購01,0,0,0,0,0,0,0,0,0,-111000,0,0,0,0,111000,-111000,-111000,2021-06-09
8951,036477,東森元大0C購01,0,0,0,0,0,0,0,0,0,-111000,0,0,0,31000,142000,-111000,-111000,2021-06-09
8952,05281P,玉晶光中信09售01,0,0,0,0,0,0,0,0,0,-111000,0,0,0,56000,167000,-111000,-111000,2021-06-09
8953,034039,台積電元富12購09,0,0,0,0,0,0,0,0,0,-111000,0,0,0,0,111000,-111000,-111000,2021-06-09
8954,034156,力山永豐0B購01,0,0,0,0,0,0,0,0,0,-111000,0,0,0,100000,211000,-111000,-111000,2021-06-09
8955,033859,華擎凱基0B購01,0,0,0,0,0,0,0,0,0,-111000,0,0,0,35000,146000,-111000,-111000,2021-06-09
8956,06691P,國巨凱基0C售03,0,0,0,0,0,0,0,0,0,-111000,0,0,0,0,111000,-111000,-111000,2021-06-09
8957,07011P,臺股指凱基0B售08,0,0,0,0,0,0,0,0,0,-111000,0,0,0,210000,321000,-111000,-111000,2021-06-09
8958,082660,聚鼎永豐07購02,0,0,0,0,0,0,0,0,0,-111000,0,0,0,1000,112000,-111000,-111000,2021-06-09
8959,088810,微星元大11購01,0,0,0,0,0,0,0,0,0,-112000,0,0,0,13000,125000,-112000,-112000,2021-06-09
8960,030002,晶技中信0A購01,0,0,0,0,0,0,0,0,0,-112000,0,0,0,177000,289000,-112000,-112000,2021-06-09
8961,033455,偉詮電群益12購02,0,0,0,0,0,0,0,0,0,-112000,0,0,0,20000,132000,-112000,-112000,2021-06-09
8962,034055,新光金麥證0C購01,0,0,0,25000,137000,-112000,0,0,0,-112000,0,0,0,25000,137000,-112000,-112000,2021-06-09
8963,073045,嘉澤元富07購02,0,0,0,0,0,0,0,0,0,-112000,0,0,0,130000,242000,-112000,-112000,2021-06-09
8964,088450,廣宇統一09購08,0,0,0,0,0,0,0,0,0,-113000,0,0,0,0,113000,-113000,-113000,2021-06-09
8965,083835,緯穎凱基0A購01,0,0,0,0,0,0,0,0,0,-113000,0,0,0,0,113000,-113000,-113000,2021-06-09
8966,033421,智原永豐0B購02,0,0,0,0,0,0,0,0,0,-113000,0,0,0,1000,114000,-113000,-113000,2021-06-09
8967,032716,大成鋼群益0B購03,0,0,0,0,0,0,0,0,0,-113000,0,0,0,0,113000,-113000,-113000,2021-06-09
8968,034241,大成鋼統一17購01,0,0,0,0,0,0,0,0,0,-113000,0,0,0,109000,222000,-113000,-113000,2021-06-09
8969,033734,台表科國票0C購01,0,0,0,0,0,0,0,0,0,-113000,0,0,0,55000,168000,-113000,-113000,2021-06-09
8970,035871,健策元富0B購02,0,0,0,0,0,0,0,0,0,-113000,0,0,0,181000,294000,-113000,-113000,2021-06-09
8971,035505,宏達電凱基0B購02,0,0,0,0,0,0,0,0,0,-113000,0,0,0,139000,252000,-113000,-113000,2021-06-09
8972,083183,台光電國票08購02,0,0,0,0,0,0,0,0,0,-113000,0,0,0,152000,265000,-113000,-113000,2021-06-09
8973,6214,精誠,21000,134000,-113000,0,0,0,0,0,0,0,0,0,0,0,0,0,-113000,2021-06-09
8974,083695,廣宇元富07購04,0,0,0,0,0,0,0,0,0,-114000,0,0,0,0,114000,-114000,-114000,2021-06-09
8975,030073,台積電群益0A購12,0,0,0,0,0,0,0,0,0,-114000,0,0,0,19000,133000,-114000,-114000,2021-06-09
8976,036247,南亞科凱基11購02,0,0,0,0,0,0,0,0,0,-114000,0,0,0,0,114000,-114000,-114000,2021-06-09
8977,034385,順德元大11購01,0,0,0,0,0,0,0,0,0,-114000,0,0,0,330000,444000,-114000,-114000,2021-06-09
8978,06925P,群創群益0C售05,0,0,0,0,0,0,0,0,0,-114000,0,0,0,5000,119000,-114000,-114000,2021-06-09
8979,2107,厚生,59000,172000,-113000,0,0,0,0,0,0,-1000,0,0,0,0,1000,-1000,-114000,2021-06-09
8980,084580,臺股指國票08購05,0,0,0,0,0,0,0,0,0,-115000,0,0,0,8000,123000,-115000,-115000,2021-06-09
8981,087321,金像電永豐09購02,0,0,0,0,0,0,0,0,0,-115000,0,0,0,178000,293000,-115000,-115000,2021-06-09
8982,087334,國喬凱基0B購01,0,0,0,0,0,0,0,0,0,-115000,0,0,0,75000,190000,-115000,-115000,2021-06-09
8983,032092,聚陽永豐0A購01,0,0,0,0,0,0,0,0,0,-115000,0,0,0,50000,165000,-115000,-115000,2021-06-09
8984,035741,國光生國票0C購01,0,0,0,0,0,0,0,0,0,-115000,0,0,0,34000,149000,-115000,-115000,2021-06-09
8985,035313,智邦元大0B購01,0,0,0,0,0,0,0,0,0,-115000,0,0,0,27000,142000,-115000,-115000,2021-06-09
8986,1722,台肥,191920,298000,-106080,0,0,0,0,0,0,-9050,0,6050,-6050,0,3000,-3000,-115130,2021-06-09
8987,088320,國喬元大09購03,0,0,0,0,0,0,0,0,0,-116000,0,0,0,494000,610000,-116000,-116000,2021-06-09
8988,035077,緯穎群益0B購01,0,0,0,0,0,0,0,0,0,-116000,0,0,0,10000,126000,-116000,-116000,2021-06-09
8989,05898P,臺股指國票0B售06,0,0,0,0,0,0,0,0,0,-116000,0,0,0,0,116000,-116000,-116000,2021-06-09
8990,034168,亞光永豐0B購01,0,0,0,0,0,0,0,0,0,-116000,0,0,0,0,116000,-116000,-116000,2021-06-09
8991,033714,光罩國票0C購01,0,0,0,0,0,0,0,0,0,-116000,0,0,0,33000,149000,-116000,-116000,2021-06-09
8992,033631,亞光元富0B購02,0,0,0,0,0,0,0,0,0,-116000,0,0,0,30000,146000,-116000,-116000,2021-06-09
8993,082319,鴻海統一09購05,0,0,0,0,0,0,0,0,0,-116000,0,0,0,40000,156000,-116000,-116000,2021-06-09
8994,084484,凌陽凱基08購02,0,0,0,0,0,0,0,0,0,-117000,0,0,0,81000,198000,-117000,-117000,2021-06-09
8995,032812,國巨國票0B購03,0,0,0,0,0,0,0,0,0,-117000,0,0,0,0,117000,-117000,-117000,2021-06-09
8996,031226,寶成凱基0A購01,0,0,0,0,0,0,0,0,0,-117000,0,0,0,44000,161000,-117000,-117000,2021-06-09
8997,036367,友達國票12購01,0,0,0,0,0,0,0,0,0,-117000,0,0,0,0,117000,-117000,-117000,2021-06-09
8998,033648,中鋼統一15購01,0,0,0,0,0,0,0,0,0,-117000,0,0,0,18000,135000,-117000,-117000,2021-06-09
8999,035002,國巨元大0B購14,0,0,0,0,0,0,0,0,0,-117000,0,0,0,99000,216000,-117000,-117000,2021-06-09
9000,034488,裕民元大11購03,0,0,0,0,0,0,0,0,0,-117000,0,0,0,13000,130000,-117000,-117000,2021-06-09
9001,076652,台光電統一06購01,0,0,0,0,0,0,0,0,0,-117000,0,0,0,0,117000,-117000,-117000,2021-06-09
9002,089905,欣興凱基0A購02,0,0,0,0,0,0,0,0,0,-117000,0,0,0,7000,124000,-117000,-117000,2021-06-09
9003,1413,宏洲,4000,121000,-117000,0,0,0,0,0,0,0,0,0,0,0,0,0,-117000,2021-06-09
9004,087858,日月光國票0A購04,0,0,0,0,0,0,0,0,0,-118000,0,0,0,0,118000,-118000,-118000,2021-06-09
9005,087525,聯詠凱基11購01,0,0,0,0,0,0,0,0,0,-118000,0,0,0,35000,153000,-118000,-118000,2021-06-09
9006,032655,亞泥麥證0B購01,0,0,0,124000,242000,-118000,0,0,0,-118000,0,0,0,124000,242000,-118000,-118000,2021-06-09
9007,033013,微星麥證0A購01,0,0,0,0,118000,-118000,0,0,0,-118000,0,0,0,0,118000,-118000,-118000,2021-06-09
9008,033130,智邦元大0C購01,0,0,0,0,0,0,0,0,0,-118000,0,0,0,234000,352000,-118000,-118000,2021-06-09
9009,034042,光罩元富12購02,0,0,0,0,0,0,0,0,0,-118000,0,0,0,50000,168000,-118000,-118000,2021-06-09
9010,06911P,中鋼凱基0B售03,0,0,0,0,0,0,0,0,0,-118000,0,0,0,33000,151000,-118000,-118000,2021-06-09
9011,080705,宏達電凱基08購01,0,0,0,0,0,0,0,0,0,-118000,0,0,0,20000,138000,-118000,-118000,2021-06-09
9012,088150,惠特永豐09購01,0,0,0,0,0,0,0,0,0,-119000,0,0,0,1000,120000,-119000,-119000,2021-06-09
9013,086270,崇越永豐09購01,0,0,0,0,0,0,0,0,0,-119000,0,0,0,0,119000,-119000,-119000,2021-06-09
9014,085198,強茂群益08購01,0,0,0,0,0,0,0,0,0,-119000,0,0,0,57000,176000,-119000,-119000,2021-06-09
9015,034089,友達元大0C購10,0,0,0,0,0,0,0,0,0,-119000,0,0,0,452000,571000,-119000,-119000,2021-06-09
9016,035856,寶成統一0B購01,0,0,0,0,0,0,0,0,0,-119000,0,0,0,70000,189000,-119000,-119000,2021-06-09
9017,06472P,聯電台新09售01,0,0,0,0,0,0,0,0,0,-119000,0,0,0,1000,120000,-119000,-119000,2021-06-09
9018,1532,勤美,11000,130000,-119000,0,0,0,0,0,0,0,0,0,0,0,0,0,-119000,2021-06-09
9019,086095,華邦電永豐08購02,0,0,0,0,0,0,0,0,0,-120000,0,0,0,118000,238000,-120000,-120000,2021-06-09
9020,084762,致新元大08購03,0,0,0,0,0,0,0,0,0,-120000,0,0,0,0,120000,-120000,-120000,2021-06-09
9021,087129,中石化國票0A購02,0,0,0,0,0,0,0,0,0,-120000,0,0,0,0,120000,-120000,-120000,2021-06-09
9022,032307,友達永豐0A購05,0,0,0,0,0,0,0,0,0,-120000,0,0,0,5000,125000,-120000,-120000,2021-06-09
9023,036111,亞光國泰12購01,0,0,0,0,0,0,0,0,0,-120000,0,0,0,20000,140000,-120000,-120000,2021-06-09
9024,089596,鴻海群益0C購04,0,0,0,0,0,0,0,0,0,-120000,0,0,0,328000,448000,-120000,-120000,2021-06-09
9025,089568,景碩中信09購01,0,0,0,0,0,0,0,0,0,-120000,0,0,0,472000,592000,-120000,-120000,2021-06-09
9026,2514,龍邦,11000,131000,-120000,0,0,0,0,0,0,0,0,0,0,0,0,0,-120000,2021-06-09
9027,1440,南紡,2982000,3492000,-510000,0,0,0,0,0,0,389907,572000,34093,537907,21000,169000,-148000,-120093,2021-06-09
9028,086724,臺股指元大0A購15,0,0,0,0,0,0,0,0,0,-121000,0,0,0,21000,142000,-121000,-121000,2021-06-09
9029,033448,精成科元大0B購01,0,0,0,0,0,0,0,0,0,-121000,0,0,0,1000,122000,-121000,-121000,2021-06-09
9030,036204,矽創統一12購01,0,0,0,0,0,0,0,0,0,-121000,0,0,0,17000,138000,-121000,-121000,2021-06-09
9031,031802,長榮航國票0A購04,0,0,0,0,0,0,0,0,0,-121000,0,0,0,30000,151000,-121000,-121000,2021-06-09
9032,034295,永冠國泰11購01,0,0,0,0,0,0,0,0,0,-121000,0,0,0,29000,150000,-121000,-121000,2021-06-09
9033,036571,世紀鋼元大0C購06,0,0,0,0,0,0,0,0,0,-121000,0,0,0,0,121000,-121000,-121000,2021-06-09
9034,034094,國泰金元大13購01,0,0,0,0,0,0,0,0,0,-121000,0,0,0,0,121000,-121000,-121000,2021-06-09
9035,034106,國巨群益0B購01,0,0,0,0,0,0,0,0,0,-121000,0,0,0,52000,173000,-121000,-121000,2021-06-09
9036,075256,同欣電元富0B購01,0,0,0,0,0,0,0,0,0,-121000,0,0,0,2000,123000,-121000,-121000,2021-06-09
9037,081875,台灣50群益07購08,0,0,0,0,0,0,0,0,0,-121000,0,0,0,55000,176000,-121000,-121000,2021-06-09
9038,089786,彩晶凱基12購01,0,0,0,0,0,0,0,0,0,-121000,0,0,0,8000,129000,-121000,-121000,2021-06-09
9039,5607,遠雄港,323000,444000,-121000,0,0,0,0,0,0,0,0,0,0,0,0,0,-121000,2021-06-09
9040,086384,景碩國票0A購01,0,0,0,0,0,0,0,0,0,-122000,0,0,0,237000,359000,-122000,-122000,2021-06-09
9041,034497,智原元大0C購01,0,0,0,0,0,0,0,0,0,-122000,0,0,0,113000,235000,-122000,-122000,2021-06-09
9042,06339P,臺股指凱基09售16,0,0,0,0,0,0,0,0,0,-122000,0,0,0,39000,161000,-122000,-122000,2021-06-09
9043,080811,華擎凱基07購01,0,0,0,0,0,0,0,0,0,-122000,0,0,0,0,122000,-122000,-122000,2021-06-09
9044,076996,嘉澤國票07購01,0,0,0,0,0,0,0,0,0,-122000,0,0,0,11000,133000,-122000,-122000,2021-06-09
9045,087331,松翰永豐09購01,0,0,0,0,0,0,0,0,0,-123000,0,0,0,1000,124000,-123000,-123000,2021-06-09
9046,088139,燿華永豐09購01,0,0,0,0,0,0,0,0,0,-123000,0,0,0,0,123000,-123000,-123000,2021-06-09
9047,088082,緯穎統一0B購01,0,0,0,0,0,0,0,0,0,-123000,0,0,0,24000,147000,-123000,-123000,2021-06-09
9048,088895,立積凱基0A購01,0,0,0,0,0,0,0,0,0,-123000,0,0,0,0,123000,-123000,-123000,2021-06-09
9049,033257,晶技元大11購01,0,0,0,0,0,0,0,0,0,-123000,0,0,0,7000,130000,-123000,-123000,2021-06-09
9050,033050,正隆永豐0A購03,0,0,0,0,0,0,0,0,0,-123000,0,0,0,290000,413000,-123000,-123000,2021-06-09
9051,030706,華晶科群益0C購01,0,0,0,0,0,0,0,0,0,-123000,0,0,0,0,123000,-123000,-123000,2021-06-09
9052,033694,合勤控元大0B購01,0,0,0,0,0,0,0,0,0,-123000,0,0,0,0,123000,-123000,-123000,2021-06-09
9053,06926P,上銀元大0A售02,0,0,0,0,0,0,0,0,0,-123000,0,0,0,0,123000,-123000,-123000,2021-06-09
9054,083012,聯發科凱基07購05,0,0,0,0,0,0,0,0,0,-123000,0,0,0,90000,213000,-123000,-123000,2021-06-09
9055,086430,惠特富邦0B購01,0,0,0,0,0,0,0,0,0,-124000,0,0,0,0,124000,-124000,-124000,2021-06-09
9056,083906,立隆電元大07購03,0,0,0,0,0,0,0,0,0,-124000,0,0,0,0,124000,-124000,-124000,2021-06-09
9057,033516,智邦台新0B購01,0,0,0,0,0,0,0,0,0,-124000,0,0,0,0,124000,-124000,-124000,2021-06-09
9058,033386,宏達電元大11購03,0,0,0,0,0,0,0,0,0,-124000,0,0,0,85000,209000,-124000,-124000,2021-06-09
9059,034916,中鋼麥證0B購02,0,0,0,4000,128000,-124000,0,0,0,-124000,0,0,0,4000,128000,-124000,-124000,2021-06-09
9060,04480P,金像電元富0A售01,0,0,0,0,0,0,0,0,0,-124000,0,0,0,20000,144000,-124000,-124000,2021-06-09
9061,034283,永豐餘兆豐0C購01,0,0,0,0,0,0,0,0,0,-124000,0,0,0,12000,136000,-124000,-124000,2021-06-09
9062,083267,智原凱基08購01,0,0,0,0,0,0,0,0,0,-124000,0,0,0,106000,230000,-124000,-124000,2021-06-09
9063,085684,松翰元富08購01,0,0,0,0,0,0,0,0,0,-125000,0,0,0,0,125000,-125000,-125000,2021-06-09
9064,088293,廣宇麥證09購01,0,0,0,0,125000,-125000,0,0,0,-125000,0,0,0,0,125000,-125000,-125000,2021-06-09
9065,087375,遠東新元大09購01,0,0,0,0,0,0,0,0,0,-125000,0,0,0,30000,155000,-125000,-125000,2021-06-09
9066,032845,光罩永豐0A購01,0,0,0,0,0,0,0,0,0,-125000,0,0,0,0,125000,-125000,-125000,2021-06-09
9067,031014,聯陽永豐0A購02,0,0,0,0,0,0,0,0,0,-125000,0,0,0,541000,666000,-125000,-125000,2021-06-09
9068,030319,台積電麥證11購02,0,0,0,0,125000,-125000,0,0,0,-125000,0,0,0,0,125000,-125000,-125000,2021-06-09
9069,03753C,臺股指元大11牛10,0,0,0,0,0,0,0,0,0,-125000,0,0,0,36000,161000,-125000,-125000,2021-06-09
9070,05787P,聯電凱基08售04,0,0,0,0,0,0,0,0,0,-125000,0,0,0,10000,135000,-125000,-125000,2021-06-09
9071,033817,聯電統一15購04,0,0,0,0,0,0,0,0,0,-125000,0,0,0,65000,190000,-125000,-125000,2021-06-09
9072,082538,凌陽凱基08購01,0,0,0,0,0,0,0,0,0,-125000,0,0,0,3000,128000,-125000,-125000,2021-06-09
9073,083653,廣宇群益09購01,0,0,0,0,0,0,0,0,0,-126000,0,0,0,0,126000,-126000,-126000,2021-06-09
9074,084782,嘉澤凱基09購01,0,0,0,0,0,0,0,0,0,-126000,0,0,0,24000,150000,-126000,-126000,2021-06-09
9075,031923,緯穎永豐0A購01,0,0,0,0,0,0,0,0,0,-126000,0,0,0,0,126000,-126000,-126000,2021-06-09
9076,035376,廣宇凱基0B購03,0,0,0,0,0,0,0,0,0,-126000,0,0,0,0,126000,-126000,-126000,2021-06-09
9077,035258,萬海凱基13購01,0,0,0,0,0,0,0,0,0,-126000,0,0,0,37000,163000,-126000,-126000,2021-06-09
9078,035911,上銀永豐0C購01,0,0,0,0,0,0,0,0,0,-126000,0,0,0,0,126000,-126000,-126000,2021-06-09
9079,081218,南亞科統一09購01,0,0,0,0,0,0,0,0,0,-126000,0,0,0,0,126000,-126000,-126000,2021-06-09
9080,080081,強茂元大07購03,0,0,0,0,0,0,0,0,0,-126000,0,0,0,24000,150000,-126000,-126000,2021-06-09
9081,06656P,奇力新元大09售05,0,0,0,0,0,0,0,0,0,-126000,0,0,0,60000,186000,-126000,-126000,2021-06-09
9082,2464,盟立,99000,206000,-107000,0,0,0,0,0,0,-19122,0,122,-122,2000,21000,-19000,-126122,2021-06-09
9083,084665,台光電國票09購01,0,0,0,0,0,0,0,0,0,-127000,0,0,0,106000,233000,-127000,-127000,2021-06-09
9084,084538,凌陽統一09購04,0,0,0,0,0,0,0,0,0,-127000,0,0,0,0,127000,-127000,-127000,2021-06-09
9085,083858,緯穎群益08購01,0,0,0,0,0,0,0,0,0,-127000,0,0,0,0,127000,-127000,-127000,2021-06-09
9086,032703,新光金兆豐0A購02,0,0,0,0,0,0,0,0,0,-127000,0,0,0,7000,134000,-127000,-127000,2021-06-09
9087,033660,聯發科統一15購05,0,0,0,0,0,0,0,0,0,-127000,0,0,0,0,127000,-127000,-127000,2021-06-09
9088,036182,聯陽永豐0C購01,0,0,0,0,0,0,0,0,0,-127000,0,0,0,180000,307000,-127000,-127000,2021-06-09
9089,079226,欣興凱基08購01,0,0,0,0,0,0,0,0,0,-127000,0,0,0,20000,147000,-127000,-127000,2021-06-09
9090,079587,上銀元富06購02,0,0,0,0,0,0,0,0,0,-127000,0,0,0,0,127000,-127000,-127000,2021-06-09
9091,088575,群創凱基0B購04,0,0,0,0,0,0,0,0,0,-128000,0,0,0,43000,171000,-128000,-128000,2021-06-09
9092,033293,日月光統一15購02,0,0,0,0,0,0,0,0,0,-128000,0,0,0,0,128000,-128000,-128000,2021-06-09
9093,036189,技嘉統一12購01,0,0,0,0,0,0,0,0,0,-128000,0,0,0,0,128000,-128000,-128000,2021-06-09
9094,034569,新唐國泰11購01,0,0,0,0,0,0,0,0,0,-128000,0,0,0,70000,198000,-128000,-128000,2021-06-09
9095,035205,緯穎元富0B購01,0,0,0,0,0,0,0,0,0,-128000,0,0,0,2000,130000,-128000,-128000,2021-06-09
9096,036013,健策凱基0C購01,0,0,0,0,0,0,0,0,0,-128000,0,0,0,17000,145000,-128000,-128000,2021-06-09
9097,084686,上銀統一0A購01,0,0,0,0,0,0,0,0,0,-129000,0,0,0,0,129000,-129000,-129000,2021-06-09
9098,085991,技嘉元大08購02,0,0,0,0,0,0,0,0,0,-129000,0,0,0,0,129000,-129000,-129000,2021-06-09
9099,032842,中纖兆豐0A購01,0,0,0,0,0,0,0,0,0,-129000,0,0,0,169000,298000,-129000,-129000,2021-06-09
9100,030928,全新群益0C購01,0,0,0,0,0,0,0,0,0,-129000,0,0,0,69000,198000,-129000,-129000,2021-06-09
9101,036020,中鋼統一12購04,0,0,0,0,0,0,0,0,0,-129000,0,0,0,21000,150000,-129000,-129000,2021-06-09
9102,034301,中鋼永豐0B購01,0,0,0,0,0,0,0,0,0,-129000,0,0,0,3000,132000,-129000,-129000,2021-06-09
9103,1305,華夏,1614000,1600000,14000,0,0,0,0,0,0,-143000,0,18000,-18000,2000,127000,-125000,-129000,2021-06-09
9104,1210,大成,97330,210317,-112987,0,0,0,0,0,0,-16175,7000,3175,3825,3000,23000,-20000,-129162,2021-06-09
9105,085332,智伸科群益08購01,0,0,0,0,0,0,0,0,0,-130000,0,0,0,0,130000,-130000,-130000,2021-06-09
9106,083490,台積電元富07購42,0,0,0,0,0,0,0,0,0,-130000,0,0,0,0,130000,-130000,-130000,2021-06-09
9107,088334,華新科元大09購13,0,0,0,0,0,0,0,0,0,-130000,0,0,0,0,130000,-130000,-130000,2021-06-09
9108,030870,盛群永豐0A購02,0,0,0,0,0,0,0,0,0,-130000,0,0,0,60000,190000,-130000,-130000,2021-06-09
9109,032750,臺股指凱基0A購23,0,0,0,0,0,0,0,0,0,-130000,0,0,0,0,130000,-130000,-130000,2021-06-09
9110,031229,深中小群益0B購01,0,0,0,0,0,0,0,0,0,-130000,0,0,0,370000,500000,-130000,-130000,2021-06-09
9111,032883,盛群凱基0A購02,0,0,0,0,0,0,0,0,0,-130000,0,0,0,20000,150000,-130000,-130000,2021-06-09
9112,031749,宏達電凱基0C購01,0,0,0,0,0,0,0,0,0,-130000,0,0,0,177000,307000,-130000,-130000,2021-06-09
9113,05603P,玉晶光國票0A售04,0,0,0,0,0,0,0,0,0,-130000,0,0,0,0,130000,-130000,-130000,2021-06-09
9114,036255,南電凱基12購02,0,0,0,0,0,0,0,0,0,-130000,0,0,0,18000,148000,-130000,-130000,2021-06-09
9115,035388,聯成永豐0B購02,0,0,0,0,0,0,0,0,0,-130000,0,0,0,38000,168000,-130000,-130000,2021-06-09
9116,035223,微星國泰11購02,0,0,0,0,0,0,0,0,0,-130000,0,0,0,120000,250000,-130000,-130000,2021-06-09
9117,078210,聯電國泰08購02,0,0,0,0,0,0,0,0,0,-130000,0,0,0,0,130000,-130000,-130000,2021-06-09
9118,089923,永冠永豐0A購01,0,0,0,0,0,0,0,0,0,-130000,0,0,0,10000,140000,-130000,-130000,2021-06-09
9119,089918,南電凱基11購01,0,0,0,0,0,0,0,0,0,-130000,0,0,0,66000,196000,-130000,-130000,2021-06-09
9120,089529,立積元大0C購02,0,0,0,0,0,0,0,0,0,-130000,0,0,0,0,130000,-130000,-130000,2021-06-09
9121,030739,全新元大0A購02,0,0,0,0,0,0,0,0,0,-131000,0,0,0,0,131000,-131000,-131000,2021-06-09
9122,035775,上銀富邦0C購01,0,0,0,0,0,0,0,0,0,-131000,0,0,0,0,131000,-131000,-131000,2021-06-09
9123,035899,晶技國泰12購01,0,0,0,0,0,0,0,0,0,-131000,0,0,0,100000,231000,-131000,-131000,2021-06-09
9124,06771P,景碩群益0A售01,0,0,0,0,0,0,0,0,0,-131000,0,0,0,239000,370000,-131000,-131000,2021-06-09
9125,080648,強茂元大08購01,0,0,0,0,0,0,0,0,0,-131000,0,0,0,383000,514000,-131000,-131000,2021-06-09
9126,082329,嘉澤統一09購02,0,0,0,0,0,0,0,0,0,-131000,0,0,0,0,131000,-131000,-131000,2021-06-09
9127,087812,創意兆豐09購04,0,0,0,0,0,0,0,0,0,-132000,0,0,0,26000,158000,-132000,-132000,2021-06-09
9128,031538,東鋼永豐0A購03,0,0,0,0,0,0,0,0,0,-132000,0,0,0,5000,137000,-132000,-132000,2021-06-09
9129,035022,鴻海凱基0B購11,0,0,0,0,0,0,0,0,0,-132000,0,0,0,147000,279000,-132000,-132000,2021-06-09
9130,04684P,嘉聯益元富0B售01,0,0,0,0,0,0,0,0,0,-132000,0,0,0,0,132000,-132000,-132000,2021-06-09
9131,034442,智原凱基11購01,0,0,0,0,0,0,0,0,0,-132000,0,0,0,164000,296000,-132000,-132000,2021-06-09
9132,033892,中鋼統一15購02,0,0,0,0,0,0,0,0,0,-132000,0,0,0,0,132000,-132000,-132000,2021-06-09
9133,068920,台積電元富08購10,0,0,0,0,0,0,0,0,0,-132000,0,0,0,16000,148000,-132000,-132000,2021-06-09
9134,089170,智邦國泰0B購01,0,0,0,0,0,0,0,0,0,-132000,0,0,0,6000,138000,-132000,-132000,2021-06-09
9135,2460,建通,165000,297000,-132000,0,0,0,0,0,0,0,0,0,0,0,0,0,-132000,2021-06-09
9136,088202,惠特群益0A購01,0,0,0,0,0,0,0,0,0,-133000,0,0,0,315000,448000,-133000,-133000,2021-06-09
9137,086860,力山國票0A購01,0,0,0,0,0,0,0,0,0,-133000,0,0,0,92000,225000,-133000,-133000,2021-06-09
9138,085277,聯電凱基0C購02,0,0,0,0,0,0,0,0,0,-133000,0,0,0,0,133000,-133000,-133000,2021-06-09
9139,034969,裕民元大0C購02,0,0,0,0,0,0,0,0,0,-133000,0,0,0,143000,276000,-133000,-133000,2021-06-09
9140,034174,台郡永豐0B購01,0,0,0,0,0,0,0,0,0,-133000,0,0,0,0,133000,-133000,-133000,2021-06-09
9141,080496,金像電元大07購05,0,0,0,0,0,0,0,0,0,-133000,0,0,0,444000,577000,-133000,-133000,2021-06-09
9142,8103,瀚荃,774000,907000,-133000,0,0,0,0,0,0,0,0,0,0,0,0,0,-133000,2021-06-09
9143,086203,嘉澤凱基08購01,0,0,0,0,0,0,0,0,0,-134000,0,0,0,18000,152000,-134000,-134000,2021-06-09
9144,031603,新光金富邦0C購01,0,0,0,0,0,0,0,0,0,-134000,0,0,0,30000,164000,-134000,-134000,2021-06-09
9145,06269P,國巨凱基09售06,0,0,0,0,0,0,0,0,0,-134000,0,0,0,11000,145000,-134000,-134000,2021-06-09
9146,035896,京元電國泰12購01,0,0,0,0,0,0,0,0,0,-134000,0,0,0,6000,140000,-134000,-134000,2021-06-09
9147,082359,聯發科中信0A購03,0,0,0,0,0,0,0,0,0,-134000,0,0,0,49000,183000,-134000,-134000,2021-06-09
9148,083010,南亞科凱基0C購01,0,0,0,0,0,0,0,0,0,-134000,0,0,0,0,134000,-134000,-134000,2021-06-09
9149,1460,宏遠,42000,176000,-134000,0,0,0,0,0,0,0,0,0,0,0,0,0,-134000,2021-06-09
9150,086248,聯詠麥證09購01,0,0,0,0,135000,-135000,0,0,0,-135000,0,0,0,0,135000,-135000,-135000,2021-06-09
9151,085976,臺股指凱基0B購03,0,0,0,0,0,0,0,0,0,-135000,0,0,0,0,135000,-135000,-135000,2021-06-09
9152,032046,旺宏國票0B購03,0,0,0,0,0,0,0,0,0,-135000,0,0,0,1000,136000,-135000,-135000,2021-06-09
9153,035840,台驊控元大0B購02,0,0,0,0,0,0,0,0,0,-135000,0,0,0,180000,315000,-135000,-135000,2021-06-09
9154,03752C,大立光富邦14牛01,0,0,0,0,0,0,0,0,0,-135000,0,0,0,0,135000,-135000,-135000,2021-06-09
9155,06217P,華通元大08售02,0,0,0,0,0,0,0,0,0,-135000,0,0,0,25000,160000,-135000,-135000,2021-06-09
9156,081553,王品永豐07購01,0,0,0,0,0,0,0,0,0,-135000,0,0,0,10000,145000,-135000,-135000,2021-06-09
9157,06644P,景碩元大09售03,0,0,0,0,0,0,0,0,0,-135000,0,0,0,158000,293000,-135000,-135000,2021-06-09
9158,085331,華擎群益08購01,0,0,0,0,0,0,0,0,0,-136000,0,0,0,20000,156000,-136000,-136000,2021-06-09
9159,031569,中鋼凱基14購02,0,0,0,0,0,0,0,0,0,-136000,0,0,0,217000,353000,-136000,-136000,2021-06-09
9160,030939,群創群益0C購02,0,0,0,0,0,0,0,0,0,-136000,0,0,0,10000,146000,-136000,-136000,2021-06-09
9161,034940,技嘉群益0C購04,0,0,0,0,0,0,0,0,0,-136000,0,0,0,187000,323000,-136000,-136000,2021-06-09
9162,2365,昆盈,65000,201000,-136000,0,0,0,0,0,0,0,0,0,0,0,0,0,-136000,2021-06-09
9163,4915,致伸,318000,519000,-201000,0,0,0,0,2000,-2000,67000,65000,0,65000,7000,5000,2000,-136000,2021-06-09
9164,087259,強茂國票0A購01,0,0,0,0,0,0,0,0,0,-137000,0,0,0,186000,323000,-137000,-137000,2021-06-09
9165,030807,臺股指凱基0C購22,0,0,0,0,0,0,0,0,0,-137000,0,0,0,3000,140000,-137000,-137000,2021-06-09
9166,032671,群創富邦0A購04,0,0,0,0,0,0,0,0,0,-137000,0,0,0,0,137000,-137000,-137000,2021-06-09
9167,032386,友達統一12購01,0,0,0,0,0,0,0,0,0,-137000,0,0,0,0,137000,-137000,-137000,2021-06-09
9168,036038,長榮航統一0C購07,0,0,0,0,0,0,0,0,0,-137000,0,0,0,17000,154000,-137000,-137000,2021-06-09
9169,035669,祥碩統一0C購04,0,0,0,0,0,0,0,0,0,-137000,0,0,0,36000,173000,-137000,-137000,2021-06-09
9170,06694P,南電凱基09售09,0,0,0,0,0,0,0,0,0,-137000,0,0,0,225000,362000,-137000,-137000,2021-06-09
9171,3679,新至陞,3000,140000,-137000,0,0,0,0,0,0,0,0,0,0,0,0,0,-137000,2021-06-09
9172,3029,零壹,46000,221000,-175000,0,0,0,0,0,0,38000,38000,0,38000,0,0,0,-137000,2021-06-09
9173,9802,鈺齊-KY,287000,510000,-223000,0,0,0,0,0,0,86000,80000,0,80000,10000,4000,6000,-137000,2021-06-09
9174,2377,微星,3195399,3310041,-114642,0,0,0,0,93000,-93000,70000,14000,12000,2000,82000,14000,68000,-137642,2021-06-09
9175,031313,SGBR2X元大0A購02,0,0,0,0,0,0,0,0,0,-138000,0,0,0,27000,165000,-138000,-138000,2021-06-09
9176,035058,南亞科國泰11購02,0,0,0,0,0,0,0,0,0,-138000,0,0,0,134000,272000,-138000,-138000,2021-06-09
9177,07008P,中鋼凱基0B售04,0,0,0,0,0,0,0,0,0,-138000,0,0,0,88000,226000,-138000,-138000,2021-06-09
9178,081258,亞光國泰09購01,0,0,0,0,0,0,0,0,0,-138000,0,0,0,12000,150000,-138000,-138000,2021-06-09
9179,083390,台積電第一17購01,0,0,0,0,0,0,0,0,0,-138000,0,0,0,60000,198000,-138000,-138000,2021-06-09
9180,083367,聯電國票09購01,0,0,0,0,0,0,0,0,0,-138000,0,0,0,90000,228000,-138000,-138000,2021-06-09
9181,089313,聯詠國票0A購04,0,0,0,0,0,0,0,0,0,-138000,0,0,0,12000,150000,-138000,-138000,2021-06-09
9182,6209,今國光,214000,352000,-138000,0,0,0,0,0,0,0,0,0,0,0,0,0,-138000,2021-06-09
9183,030078,嘉晶群益0A購01,0,0,0,0,0,0,0,0,0,-139000,0,0,0,143000,282000,-139000,-139000,2021-06-09
9184,03500B,臺股指凱基0C熊10,0,0,0,0,0,0,0,0,0,-139000,0,0,0,89000,228000,-139000,-139000,2021-06-09
9185,035934,鴻海凱基0C購07,0,0,0,0,0,0,0,0,0,-139000,0,0,0,5000,144000,-139000,-139000,2021-06-09
9186,087665,神達兆豐09購01,0,0,0,0,0,0,0,0,0,-140000,0,0,0,160000,300000,-140000,-140000,2021-06-09
9187,087997,聯發科群益0B購01,0,0,0,0,0,0,0,0,0,-140000,0,0,0,2000,142000,-140000,-140000,2021-06-09
9188,088185,國喬群益0A購01,0,0,0,0,0,0,0,0,0,-140000,0,0,0,10000,150000,-140000,-140000,2021-06-09
9189,087931,國泰金統一0B購03,0,0,0,0,0,0,0,0,0,-140000,0,0,0,5000,145000,-140000,-140000,2021-06-09
9190,030388,直得元大0B購01,0,0,0,0,0,0,0,0,0,-140000,0,0,0,0,140000,-140000,-140000,2021-06-09
9191,031227,臺股指凱基0B購06,0,0,0,0,0,0,0,0,0,-140000,0,0,0,135000,275000,-140000,-140000,2021-06-09
9192,033551,中石化中信0B購01,0,0,0,0,0,0,0,0,0,-140000,0,0,0,0,140000,-140000,-140000,2021-06-09
9193,036479,長榮航元大13購01,0,0,0,0,0,0,0,0,0,-140000,0,0,0,20000,160000,-140000,-140000,2021-06-09
9194,035282,聯電國票0C購04,0,0,0,0,0,0,0,0,0,-140000,0,0,0,1000,141000,-140000,-140000,2021-06-09
9195,035339,國巨元富12購12,0,0,0,0,0,0,0,0,0,-140000,0,0,0,0,140000,-140000,-140000,2021-06-09
9196,078698,台積電富邦08購07,0,0,0,0,0,0,0,0,0,-140000,0,0,0,0,140000,-140000,-140000,2021-06-09
9197,9934,成霖,7000,147000,-140000,0,0,0,0,0,0,0,0,0,0,0,0,0,-140000,2021-06-09
9198,089447,鴻海統一13購05,0,0,0,0,0,0,0,0,0,-140000,0,0,0,40000,180000,-140000,-140000,2021-06-09
9199,089656,上銀富邦0B購01,0,0,0,0,0,0,0,0,0,-140000,0,0,0,10000,150000,-140000,-140000,2021-06-09
9200,2101,南港,198000,333000,-135000,0,0,0,0,0,0,-5000,0,3000,-3000,0,2000,-2000,-140000,2021-06-09
9201,3346,麗清,57000,197000,-140000,0,0,0,0,0,0,0,0,0,0,0,0,0,-140000,2021-06-09
9202,2892,第一金,3601330,3703800,-102470,0,0,0,0,2000,-2000,-36000,0,36000,-36000,0,0,0,-140470,2021-06-09
9203,086321,南電凱基0B購01,0,0,0,0,0,0,0,0,0,-141000,0,0,0,0,141000,-141000,-141000,2021-06-09
9204,031970,新唐元大0A購01,0,0,0,0,0,0,0,0,0,-141000,0,0,0,243000,384000,-141000,-141000,2021-06-09
9205,036007,上銀凱基11購01,0,0,0,0,0,0,0,0,0,-141000,0,0,0,40000,181000,-141000,-141000,2021-06-09
9206,035821,儒鴻元大0B購03,0,0,0,0,0,0,0,0,0,-141000,0,0,0,13000,154000,-141000,-141000,2021-06-09
9207,035869,長榮航元富13購01,0,0,0,0,0,0,0,0,0,-141000,0,0,0,11000,152000,-141000,-141000,2021-06-09
9208,088264,瑞軒永豐09購01,0,0,0,0,0,0,0,0,0,-142000,0,0,0,40000,182000,-142000,-142000,2021-06-09
9209,086600,圓展國泰0B購02,0,0,0,0,0,0,0,0,0,-142000,0,0,0,28000,170000,-142000,-142000,2021-06-09
9210,033042,富邦金兆豐0B購01,0,0,0,0,0,0,0,0,0,-142000,0,0,0,107000,249000,-142000,-142000,2021-06-09
9211,035092,長榮凱基11購04,0,0,0,0,0,0,0,0,0,-142000,0,0,0,350000,492000,-142000,-142000,2021-06-09
9212,035540,台玻統一0C購04,0,0,0,0,0,0,0,0,0,-142000,0,0,0,33000,175000,-142000,-142000,2021-06-09
9213,1731,美吾華,77000,219000,-142000,0,0,0,0,0,0,0,0,0,0,0,0,0,-142000,2021-06-09
9214,1536,和大,319068,430000,-110932,0,0,0,0,0,0,-31232,61,16293,-16232,0,15000,-15000,-142164,2021-06-09
9215,088316,南電凱基0A購03,10000,0,10000,0,0,0,0,0,0,-153000,0,0,0,459000,612000,-153000,-143000,2021-06-09
9216,083879,T50反1國泰09購04,0,0,0,0,0,0,0,0,0,-143000,0,0,0,6645000,6788000,-143000,-143000,2021-06-09
9217,030088,長興永豐0A購01,0,0,0,0,0,0,0,0,0,-143000,0,0,0,15000,158000,-143000,-143000,2021-06-09
9218,032705,台表科兆豐0B購01,0,0,0,0,0,0,0,0,0,-143000,0,0,0,296000,439000,-143000,-143000,2021-06-09
9219,05419P,臺股指國票0B售04,0,0,0,0,0,0,0,0,0,-143000,0,0,0,80000,223000,-143000,-143000,2021-06-09
9220,06806P,聯電元大0A售07,0,0,0,0,0,0,0,0,0,-143000,0,0,0,95000,238000,-143000,-143000,2021-06-09
9221,030988,麗豐元大0A購02,0,0,0,0,0,0,0,0,0,-144000,0,0,0,0,144000,-144000,-144000,2021-06-09
9222,089047,立積群益0A購02,0,0,0,0,0,0,0,0,0,-145000,0,0,0,24000,169000,-145000,-145000,2021-06-09
9223,030542,健和興凱基0B購01,0,0,0,0,0,0,0,0,0,-145000,0,0,0,10000,155000,-145000,-145000,2021-06-09
9224,033107,聯詠元富0A購05,0,0,0,0,0,0,0,0,0,-145000,0,0,0,0,145000,-145000,-145000,2021-06-09
9225,035194,聯發科元富0C購05,0,0,0,0,0,0,0,0,0,-145000,0,0,0,0,145000,-145000,-145000,2021-06-09
9226,034228,中鋼康和12購01,0,0,0,0,0,0,0,0,0,-145000,0,0,0,1300000,1445000,-145000,-145000,2021-06-09
9227,079961,臺股指凱基0C購04,0,0,0,0,0,0,0,0,0,-145000,0,0,0,212000,357000,-145000,-145000,2021-06-09
9228,1109,信大,49000,183000,-134000,0,0,0,0,0,0,-11000,0,11000,-11000,0,0,0,-145000,2021-06-09
9229,089935,興富發永豐0A購01,0,0,0,0,0,0,0,0,0,-145000,0,0,0,0,145000,-145000,-145000,2021-06-09
9230,089138,華碩元大0C購02,0,0,0,0,0,0,0,0,0,-145000,0,0,0,40000,185000,-145000,-145000,2021-06-09
9231,088220,上銀元富11購01,0,0,0,0,0,0,0,0,0,-146000,0,0,0,5000,151000,-146000,-146000,2021-06-09
9232,033278,聯電統一15購02,0,0,0,0,0,0,0,0,0,-146000,0,0,0,30000,176000,-146000,-146000,2021-06-09
9233,035168,宏達電國票0B購02,0,0,0,0,0,0,0,0,0,-146000,0,0,0,97000,243000,-146000,-146000,2021-06-09
9234,06970P,台灣50凱基0B售04,0,0,0,0,0,0,0,0,0,-146000,0,0,0,4000,150000,-146000,-146000,2021-06-09
9235,085533,力山永豐08購01,0,0,0,0,0,0,0,0,0,-147000,0,0,0,38000,185000,-147000,-147000,2021-06-09
9236,033288,聯詠統一15購01,0,0,0,0,0,0,0,0,0,-147000,0,0,0,60000,207000,-147000,-147000,2021-06-09
9237,035207,長榮麥證0B購03,0,0,0,55000,202000,-147000,0,0,0,-147000,0,0,0,55000,202000,-147000,-147000,2021-06-09
9238,033934,貿聯元大0B購01,0,0,0,0,0,0,0,0,0,-147000,0,0,0,10000,157000,-147000,-147000,2021-06-09
9239,035662,愛普國泰12購02,0,0,0,0,0,0,0,0,0,-147000,0,0,0,0,147000,-147000,-147000,2021-06-09
9240,078946,全新統一09購01,0,0,0,0,0,0,0,0,0,-147000,0,0,0,0,147000,-147000,-147000,2021-06-09
9241,081151,大立光凱基0A購01,0,0,0,0,0,0,0,0,0,-147000,0,0,0,65000,212000,-147000,-147000,2021-06-09
9242,083250,滬深2X凱基0A購02,0,0,0,0,0,0,0,0,0,-147000,0,0,0,609000,756000,-147000,-147000,2021-06-09
9243,089373,立積元大09購09,0,0,0,0,0,0,0,0,0,-147000,0,0,0,232000,379000,-147000,-147000,2021-06-09
9244,2014,中鴻,1808070,1098000,710070,0,0,0,0,690000,-690000,-168000,0,103000,-103000,5000,70000,-65000,-147930,2021-06-09
9245,088516,矽創元大09購04,0,0,0,0,0,0,0,0,0,-148000,0,0,0,108000,256000,-148000,-148000,2021-06-09
9246,086777,矽創凱基09購03,0,0,0,0,0,0,0,0,0,-148000,0,0,0,487000,635000,-148000,-148000,2021-06-09
9247,033415,智邦永豐0B購01,0,0,0,0,0,0,0,0,0,-148000,0,0,0,20000,168000,-148000,-148000,2021-06-09
9248,031972,新唐元大0B購01,0,0,0,0,0,0,0,0,0,-148000,0,0,0,30000,178000,-148000,-148000,2021-06-09
9249,035463,景碩國票0C購01,0,0,0,0,0,0,0,0,0,-148000,0,0,0,86000,234000,-148000,-148000,2021-06-09
9250,036140,矽創兆豐11購01,0,0,0,0,0,0,0,0,0,-148000,0,0,0,55000,203000,-148000,-148000,2021-06-09
9251,081971,廣宇元大07購03,0,0,0,0,0,0,0,0,0,-148000,0,0,0,0,148000,-148000,-148000,2021-06-09
9252,086898,滬深2X凱基09購03,0,0,0,0,0,0,0,0,0,-149000,0,0,0,10000,159000,-149000,-149000,2021-06-09
9253,085354,禾伸堂永豐08購01,0,0,0,0,0,0,0,0,0,-149000,0,0,0,50000,199000,-149000,-149000,2021-06-09
9254,05502P,聯電元富07售07,0,0,0,0,0,0,0,0,0,-149000,0,0,0,1000,150000,-149000,-149000,2021-06-09
9255,033767,中鋼群益0B購09,0,0,0,0,0,0,0,0,0,-149000,0,0,0,53000,202000,-149000,-149000,2021-06-09
9256,030180,智邦兆豐0B購01,0,0,0,0,0,0,0,0,0,-149000,0,0,0,98000,247000,-149000,-149000,2021-06-09
9257,030483,凌陽永豐0A購01,0,0,0,0,0,0,0,0,0,-149000,0,0,0,151000,300000,-149000,-149000,2021-06-09
9258,034226,矽創元富0C購04,0,0,0,0,0,0,0,0,0,-149000,0,0,0,114000,263000,-149000,-149000,2021-06-09
9259,081747,廣宇元大08購01,0,0,0,0,0,0,0,0,0,-149000,0,0,0,0,149000,-149000,-149000,2021-06-09
9260,2355,敬鵬,165000,314000,-149000,0,0,0,0,0,0,-686,0,2686,-2686,2000,0,2000,-149686,2021-06-09
9261,085422,日月光元大0A購01,0,0,0,0,0,0,0,0,0,-150000,0,0,0,0,150000,-150000,-150000,2021-06-09
9262,085721,廣宇中信0A購01,0,0,0,0,0,0,0,0,0,-150000,0,0,0,0,150000,-150000,-150000,2021-06-09
9263,085764,上証2X凱基0A購04,0,0,0,0,0,0,0,0,0,-150000,0,0,0,5000,155000,-150000,-150000,2021-06-09
9264,083501,滬深2X元大07購10,0,0,0,0,0,0,0,0,0,-150000,0,0,0,0,150000,-150000,-150000,2021-06-09
9265,084963,鴻海國票12購02,0,0,0,0,0,0,0,0,0,-150000,0,0,0,0,150000,-150000,-150000,2021-06-09
9266,085033,T50反1元富0B購03,0,0,0,0,0,0,0,0,0,-150000,0,0,0,0,150000,-150000,-150000,2021-06-09
9267,087008,台積電富邦0B購04,0,0,0,0,0,0,0,0,0,-150000,0,0,0,0,150000,-150000,-150000,2021-06-09
9268,087496,聯詠群益0A購01,0,0,0,0,0,0,0,0,0,-150000,0,0,0,0,150000,-150000,-150000,2021-06-09
9269,087110,友達元大09購12,0,0,0,0,0,0,0,0,0,-150000,0,0,0,50000,200000,-150000,-150000,2021-06-09
9270,087135,聯電國票0B購01,0,0,0,0,0,0,0,0,0,-150000,0,0,0,131000,281000,-150000,-150000,2021-06-09
9271,030791,台積電凱基0B購08,0,0,0,0,0,0,0,0,0,-150000,0,0,0,194000,344000,-150000,-150000,2021-06-09
9272,033328,瑞祺凱基11購01,0,0,0,0,0,0,0,0,0,-150000,0,0,0,0,150000,-150000,-150000,2021-06-09
9273,033292,日月光統一15購01,0,0,0,0,0,0,0,0,0,-150000,0,0,0,120000,270000,-150000,-150000,2021-06-09
9274,033064,聯電凱基0A購12,0,0,0,0,0,0,0,0,0,-150000,0,0,0,0,150000,-150000,-150000,2021-06-09
9275,036460,恆大元大0C購01,0,0,0,0,0,0,0,0,0,-150000,0,0,0,0,150000,-150000,-150000,2021-06-09
9276,081729,T50反1元大0A購04,0,0,0,0,0,0,0,0,0,-150000,0,0,0,0,150000,-150000,-150000,2021-06-09
9277,083207,台積電統一0A購04,0,0,0,0,0,0,0,0,0,-150000,0,0,0,0,150000,-150000,-150000,2021-06-09
9278,077989,惠特元大07購01,0,0,0,0,0,0,0,0,0,-150000,0,0,0,0,150000,-150000,-150000,2021-06-09
9279,078107,喬山元富0C購01,0,0,0,0,0,0,0,0,0,-150000,0,0,0,0,150000,-150000,-150000,2021-06-09
9280,089711,台積電中信09購14,0,0,0,0,0,0,0,0,0,-150000,0,0,0,0,150000,-150000,-150000,2021-06-09
9281,088499,微星元大09購03,0,0,0,0,0,0,0,0,0,-151000,0,0,0,19000,170000,-151000,-151000,2021-06-09
9282,088058,聯陽元大09購02,0,0,0,0,0,0,0,0,0,-151000,0,0,0,7000,158000,-151000,-151000,2021-06-09
9283,085714,聯發科第一12購01,0,0,0,0,0,0,0,0,0,-151000,0,0,0,0,151000,-151000,-151000,2021-06-09
9284,032384,台光電統一0C購01,0,0,0,0,0,0,0,0,0,-151000,0,0,0,0,151000,-151000,-151000,2021-06-09
9285,030271,華晶科統一0B購01,0,0,0,0,0,0,0,0,0,-151000,0,0,0,0,151000,-151000,-151000,2021-06-09
9286,034470,南紡元大11購02,0,0,0,0,0,0,0,0,0,-151000,0,0,0,84000,235000,-151000,-151000,2021-06-09
9287,07282P,長榮航凱基11售02,0,0,0,0,0,0,0,0,0,-151000,0,0,0,31000,182000,-151000,-151000,2021-06-09
9288,1618,合機,126000,277000,-151000,0,0,0,0,0,0,0,0,0,0,0,0,0,-151000,2021-06-09
9289,085683,嘉澤元富09購01,0,0,0,0,0,0,0,0,0,-152000,0,0,0,0,152000,-152000,-152000,2021-06-09
9290,083545,精成科元大07購03,0,0,0,0,0,0,0,0,0,-152000,0,0,0,2000,154000,-152000,-152000,2021-06-09
9291,030574,仁寶富邦0C購01,0,0,0,0,0,0,0,0,0,-152000,0,0,0,0,152000,-152000,-152000,2021-06-09
9292,033478,臺股指凱基0C購25,0,0,0,0,0,0,0,0,0,-152000,0,0,0,0,152000,-152000,-152000,2021-06-09
9293,036316,強茂統一11購01,0,0,0,0,0,0,0,0,0,-152000,0,0,0,42000,194000,-152000,-152000,2021-06-09
9294,034376,台玻元大0B購06,0,0,0,0,0,0,0,0,0,-152000,0,0,0,40000,192000,-152000,-152000,2021-06-09
9295,034656,南電中信12購01,0,0,0,0,0,0,0,0,0,-152000,0,0,0,435000,587000,-152000,-152000,2021-06-09
9296,034651,鴻海中信0B購06,0,0,0,0,0,0,0,0,0,-152000,0,0,0,1000,153000,-152000,-152000,2021-06-09
9297,033775,國喬元大0B購03,0,0,0,0,0,0,0,0,0,-152000,0,0,0,44000,196000,-152000,-152000,2021-06-09
9298,034289,禾伸堂兆豐0C購01,0,0,0,0,0,0,0,0,0,-152000,0,0,0,19000,171000,-152000,-152000,2021-06-09
9299,035798,聯電第一15購04,0,0,0,0,0,0,0,0,0,-152000,0,0,0,0,152000,-152000,-152000,2021-06-09
9300,06922P,友達凱基0A售07,0,0,0,0,0,0,0,0,0,-152000,0,0,0,130000,282000,-152000,-152000,2021-06-09
9301,1616,億泰,133000,285000,-152000,0,0,0,0,0,0,0,0,0,0,0,0,0,-152000,2021-06-09
9302,086599,圓展國泰0B購01,0,0,0,0,0,0,0,0,0,-153000,0,0,0,5000,158000,-153000,-153000,2021-06-09
9303,033469,喬山凱基0B購01,0,0,0,0,0,0,0,0,0,-153000,0,0,0,105000,258000,-153000,-153000,2021-06-09
9304,034229,國泰金康和0B購01,0,0,0,0,0,0,0,0,0,-153000,0,0,0,82000,235000,-153000,-153000,2021-06-09
9305,034131,亞光兆豐0B購01,0,0,0,0,0,0,0,0,0,-153000,0,0,0,0,153000,-153000,-153000,2021-06-09
9306,082059,同欣電凱基08購02,0,0,0,0,0,0,0,0,0,-153000,0,0,0,27000,180000,-153000,-153000,2021-06-09
9307,087593,樺漢元大09購01,0,0,0,0,0,0,0,0,0,-154000,0,0,0,80000,234000,-154000,-154000,2021-06-09
9308,086023,友達永豐08購06,0,0,0,0,0,0,0,0,0,-154000,0,0,0,13000,167000,-154000,-154000,2021-06-09
9309,030236,佳格永豐0A購01,0,0,0,0,0,0,0,0,0,-154000,0,0,0,0,154000,-154000,-154000,2021-06-09
9310,00648R,元大S&P500反1,0,2000,-2000,0,0,0,0,0,0,-152000,0,0,0,0,152000,-152000,-154000,2021-06-09
9311,031232,國喬群益0B購01,0,0,0,0,0,0,0,0,0,-154000,0,0,0,10000,164000,-154000,-154000,2021-06-09
9312,034231,聯電麥證0B購02,0,0,0,1000,154000,-153000,0,0,0,-154000,0,0,0,1000,155000,-154000,-154000,2021-06-09
9313,074354,創意統一07購01,0,0,0,0,0,0,0,0,0,-154000,0,0,0,108000,262000,-154000,-154000,2021-06-09
9314,078744,訊芯元富0C購01,0,0,0,0,0,0,0,0,0,-154000,0,0,0,0,154000,-154000,-154000,2021-06-09
9315,089367,聯詠元大09購15,0,0,0,0,0,0,0,0,0,-154000,0,0,0,101000,255000,-154000,-154000,2021-06-09
9316,031182,萬海永豐0A購02,0,0,0,0,0,0,0,0,0,-155000,0,0,0,0,155000,-155000,-155000,2021-06-09
9317,033344,智原永豐0B購01,0,0,0,0,0,0,0,0,0,-155000,0,0,0,0,155000,-155000,-155000,2021-06-09
9318,031697,新纖永豐0A購01,0,0,0,0,0,0,0,0,0,-155000,0,0,0,20000,175000,-155000,-155000,2021-06-09
9319,8105,凌巨,194000,369000,-175000,0,0,0,0,0,0,20000,20000,0,20000,0,0,0,-155000,2021-06-09
9320,032797,南茂元大0A購02,0,0,0,0,0,0,0,0,0,-156000,0,0,0,47000,203000,-156000,-156000,2021-06-09
9321,035546,光罩統一0C購04,0,0,0,0,0,0,0,0,0,-156000,0,0,0,454000,610000,-156000,-156000,2021-06-09
9322,086272,南電永豐09購01,0,0,0,0,0,0,0,0,0,-157000,0,0,0,86000,243000,-157000,-157000,2021-06-09
9323,083871,智邦國票08購02,0,0,0,0,0,0,0,0,0,-157000,0,0,0,13000,170000,-157000,-157000,2021-06-09
9324,033376,中纖元大0B購01,0,40000,-40000,0,0,0,0,0,0,-117000,0,0,0,1023000,1140000,-117000,-157000,2021-06-09
9325,035656,廣宇國泰12購01,0,0,0,0,0,0,0,0,0,-157000,0,0,0,107000,264000,-157000,-157000,2021-06-09
9326,080704,強茂凱基08購01,0,0,0,0,0,0,0,0,0,-157000,0,0,0,342000,499000,-157000,-157000,2021-06-09
9327,087005,瀚宇博國泰0B購01,0,0,0,0,0,0,0,0,0,-158000,0,0,0,30000,188000,-158000,-158000,2021-06-09
9328,086746,華擎永豐09購01,0,0,0,0,0,0,0,0,0,-158000,0,0,0,40000,198000,-158000,-158000,2021-06-09
9329,088088,宏碁元富0C購06,0,0,0,0,0,0,0,0,0,-158000,0,0,0,0,158000,-158000,-158000,2021-06-09
9330,031748,威盛凱基12購01,0,0,0,0,0,0,0,0,0,-158000,0,0,0,20000,178000,-158000,-158000,2021-06-09
9331,031371,聯發科永豐0A購02,0,0,0,0,0,0,0,0,0,-158000,0,0,0,0,158000,-158000,-158000,2021-06-09
9332,089708,南電元富09購08,0,0,0,0,0,0,0,0,0,-158000,0,0,0,1000,159000,-158000,-158000,2021-06-09
9333,089645,松翰凱基09購02,0,0,0,0,0,0,0,0,0,-158000,0,0,0,386000,544000,-158000,-158000,2021-06-09
9334,088245,松翰國票09購01,0,0,0,0,0,0,0,0,0,-159000,0,0,0,0,159000,-159000,-159000,2021-06-09
9335,033471,偉詮電凱基0C購01,0,0,0,0,0,0,0,0,0,-159000,0,0,0,185000,344000,-159000,-159000,2021-06-09
9336,032891,光罩統一0C購02,0,0,0,0,0,0,0,0,0,-159000,0,0,0,5000,164000,-159000,-159000,2021-06-09
9337,07268P,台驊控凱基0C售02,0,0,0,0,0,0,0,0,0,-159000,0,0,0,10000,169000,-159000,-159000,2021-06-09
9338,06449P,南電凱基09售07,0,0,0,0,0,0,0,0,0,-159000,0,0,0,0,159000,-159000,-159000,2021-06-09
9339,089226,聚陽永豐09購03,0,0,0,0,0,0,0,0,0,-159000,0,0,0,0,159000,-159000,-159000,2021-06-09
9340,1795,美時,140000,295000,-155000,0,0,0,0,0,0,-4000,0,0,0,0,4000,-4000,-159000,2021-06-09
9341,086150,華邦電元大08購07,0,0,0,0,0,0,0,0,0,-160000,0,0,0,128000,288000,-160000,-160000,2021-06-09
9342,032317,群創永豐0A購08,0,0,0,0,0,0,0,0,0,-160000,0,0,0,0,160000,-160000,-160000,2021-06-09
9343,032118,台聚凱基12購02,0,0,0,0,0,0,0,0,0,-160000,0,0,0,0,160000,-160000,-160000,2021-06-09
9344,030462,明基材富邦0C購01,0,0,0,0,0,0,0,0,0,-160000,0,0,0,0,160000,-160000,-160000,2021-06-09
9345,030491,力成永豐0A購01,0,0,0,0,0,0,0,0,0,-160000,0,0,0,0,160000,-160000,-160000,2021-06-09
9346,030865,聯陽永豐0A購01,0,0,0,0,0,0,0,0,0,-160000,0,0,0,70000,230000,-160000,-160000,2021-06-09
9347,035680,惠特永豐0B購01,0,0,0,0,0,0,0,0,0,-160000,0,0,0,27000,187000,-160000,-160000,2021-06-09
9348,035766,精成科元富13購01,0,0,0,0,0,0,0,0,0,-160000,0,0,0,0,160000,-160000,-160000,2021-06-09
9349,035719,欣興元大0B購07,0,0,0,0,0,0,0,0,0,-160000,0,0,0,99000,259000,-160000,-160000,2021-06-09
9350,036073,矽創群益0C購01,0,0,0,0,0,0,0,0,0,-160000,0,0,0,40000,200000,-160000,-160000,2021-06-09
9351,034362,開發金麥證11購01,0,0,0,119000,179000,-60000,0,0,0,-160000,0,0,0,119000,279000,-160000,-160000,2021-06-09
9352,089244,精成科永豐09購01,0,0,0,0,0,0,0,0,0,-160000,0,0,0,20000,180000,-160000,-160000,2021-06-09
9353,084872,華晶科元大08購01,0,0,0,0,0,0,0,0,0,-161000,0,0,0,0,161000,-161000,-161000,2021-06-09
9354,087791,合勤控永豐09購01,0,0,0,0,0,0,0,0,0,-161000,0,0,0,0,161000,-161000,-161000,2021-06-09
9355,030155,玉晶光富邦0C購01,0,0,0,0,0,0,0,0,0,-161000,0,0,0,47000,208000,-161000,-161000,2021-06-09
9356,088987,立積元富09購04,0,0,0,0,0,0,0,0,0,-162000,0,0,0,10000,172000,-162000,-162000,2021-06-09
9357,086370,T50反1國票0B購03,0,0,0,0,0,0,0,0,0,-162000,0,0,0,2281000,2443000,-162000,-162000,2021-06-09
9358,085676,南電統一0A購07,0,0,0,0,0,0,0,0,0,-162000,0,0,0,937000,1099000,-162000,-162000,2021-06-09
9359,033970,聯電凱基0B購04,0,0,0,0,0,0,0,0,0,-162000,0,0,0,1000,163000,-162000,-162000,2021-06-09
9360,033995,奇鋐兆豐0B購01,0,0,0,0,0,0,0,0,0,-162000,0,0,0,390000,552000,-162000,-162000,2021-06-09
9361,06403P,T50正2凱基0A售02,0,0,0,0,0,0,0,0,0,-162000,0,0,0,63000,225000,-162000,-162000,2021-06-09
9362,3437,榮創,398000,560000,-162000,0,0,0,0,0,0,0,0,0,0,0,0,0,-162000,2021-06-09
9363,2485,兆赫,387000,549000,-162000,0,0,0,0,0,0,-232,2002,4000,-1998,4000,2234,1766,-162232,2021-06-09
9364,085930,景碩日盛08購01,0,0,0,0,0,0,0,0,0,-163000,0,0,0,30000,193000,-163000,-163000,2021-06-09
9365,086602,南電富邦0B購01,0,0,0,0,0,0,0,0,0,-163000,0,0,0,344000,507000,-163000,-163000,2021-06-09
9366,032779,義隆元大0B購01,0,0,0,0,0,0,0,0,0,-163000,0,0,0,379000,542000,-163000,-163000,2021-06-09
9367,032687,中鋼永豐0A購08,0,0,0,0,0,0,0,0,0,-163000,0,0,0,100000,263000,-163000,-163000,2021-06-09
9368,06395P,南電元大08售10,0,0,0,0,0,0,0,0,0,-163000,0,0,0,0,163000,-163000,-163000,2021-06-09
9369,075710,台表科元富0B購02,0,0,0,0,0,0,0,0,0,-163000,0,0,0,179000,342000,-163000,-163000,2021-06-09
9370,081939,光磊富邦09購01,0,0,0,0,0,0,0,0,0,-163000,0,0,0,7000,170000,-163000,-163000,2021-06-09
9371,089246,和潤永豐09購01,0,0,0,0,0,0,0,0,0,-163000,0,0,0,0,163000,-163000,-163000,2021-06-09
9372,086878,精成科國泰0B購01,0,0,0,0,0,0,0,0,0,-164000,0,0,0,62000,226000,-164000,-164000,2021-06-09
9373,083973,南電凱基08購04,0,0,0,0,0,0,0,0,0,-164000,0,0,0,171000,335000,-164000,-164000,2021-06-09
9374,030556,威盛統一0C購01,0,0,0,0,0,0,0,0,0,-164000,0,0,0,0,164000,-164000,-164000,2021-06-09
9375,036248,聯發科凱基0C購08,0,0,0,0,0,0,0,0,0,-164000,0,0,0,0,164000,-164000,-164000,2021-06-09
9376,034535,台玻統一11購04,0,0,0,0,0,0,0,0,0,-164000,0,0,0,46000,210000,-164000,-164000,2021-06-09
9377,087880,台積電元大11購06,0,0,0,0,0,0,0,0,0,-165000,0,0,0,25000,190000,-165000,-165000,2021-06-09
9378,030904,台積電凱基14購01,0,0,0,0,0,0,0,0,0,-165000,0,0,0,0,165000,-165000,-165000,2021-06-09
9379,07203P,聯電凱基0C售06,0,0,0,0,0,0,0,0,0,-165000,0,0,0,0,165000,-165000,-165000,2021-06-09
9380,073990,喬山元富08購01,0,0,0,0,0,0,0,0,0,-165000,0,0,0,0,165000,-165000,-165000,2021-06-09
9381,2838,聯邦銀,39000,194000,-155000,0,0,0,0,0,0,-10000,0,10000,-10000,0,0,0,-165000,2021-06-09
9382,030840,光磊兆豐0A購01,0,0,0,0,0,0,0,0,0,-166000,0,0,0,0,166000,-166000,-166000,2021-06-09
9383,033636,南電康和0B購01,0,0,0,0,0,0,0,0,0,-166000,0,0,0,72000,238000,-166000,-166000,2021-06-09
9384,088181,松翰麥證0B購01,0,0,0,0,197000,-197000,0,0,0,-167000,0,0,0,30000,197000,-167000,-167000,2021-06-09
9385,031900,中纖永豐0A購01,0,0,0,0,0,0,0,0,0,-167000,0,0,0,37000,204000,-167000,-167000,2021-06-09
9386,07068P,華邦電元大0B售04,0,0,0,0,0,0,0,0,0,-167000,0,0,0,120000,287000,-167000,-167000,2021-06-09
9387,082414,聯電永豐07購03,0,0,0,0,0,0,0,0,0,-167000,0,0,0,0,167000,-167000,-167000,2021-06-09
9388,087806,高鐵兆豐0A購01,0,0,0,0,0,0,0,0,0,-168000,0,0,0,0,168000,-168000,-168000,2021-06-09
9389,087745,SGBR2X國票0A購02,0,0,0,0,0,0,0,0,0,-168000,0,0,0,0,168000,-168000,-168000,2021-06-09
9390,032558,友達群益0A購06,0,0,0,0,0,0,0,0,0,-168000,0,0,0,0,168000,-168000,-168000,2021-06-09
9391,030622,華晶科元大0A購02,0,0,0,0,0,0,0,0,0,-168000,0,0,0,0,168000,-168000,-168000,2021-06-09
9392,034971,新唐元大0C購01,0,0,0,0,0,0,0,0,0,-168000,0,0,0,26000,194000,-168000,-168000,2021-06-09
9393,086970,聯詠統一0B購03,0,0,0,0,0,0,0,0,0,-169000,0,0,0,0,169000,-169000,-169000,2021-06-09
9394,030917,臺股指凱基0C購23,0,0,0,0,0,0,0,0,0,-169000,0,0,0,1000,170000,-169000,-169000,2021-06-09
9395,030727,聯電元大0A購04,0,0,0,0,0,0,0,0,0,-169000,0,0,0,12000,181000,-169000,-169000,2021-06-09
9396,034837,世紀鋼康和0C購01,0,0,0,0,0,0,0,0,0,-169000,0,0,0,8000,177000,-169000,-169000,2021-06-09
9397,075062,智伸科元富0B購01,0,0,0,0,0,0,0,0,0,-169000,0,0,0,30000,199000,-169000,-169000,2021-06-09
9398,1762,中化生,148000,377000,-229000,0,0,0,0,0,0,60000,60000,0,60000,0,0,0,-169000,2021-06-09
9399,089425,農林永豐09購01,0,0,0,0,0,0,0,0,0,-169000,0,0,0,62000,231000,-169000,-169000,2021-06-09
9400,9103,美德醫療-DR,707300,830000,-122700,0,0,0,0,0,0,-47000,0,0,0,0,47000,-47000,-169700,2021-06-09
9401,087211,鴻海凱基13購02,0,0,0,0,0,0,0,0,0,-170000,0,0,0,0,170000,-170000,-170000,2021-06-09
9402,032642,華晶科統一0C購04,0,0,0,0,0,0,0,0,0,-170000,0,0,0,0,170000,-170000,-170000,2021-06-09
9403,030117,安集永豐0A購01,0,0,0,0,0,0,0,0,0,-170000,0,0,0,0,170000,-170000,-170000,2021-06-09
9404,033549,智原元富12購01,0,0,0,0,0,0,0,0,0,-170000,0,0,0,0,170000,-170000,-170000,2021-06-09
9405,035758,聯詠元富0C購03,0,0,0,0,0,0,0,0,0,-170000,0,0,0,5000,175000,-170000,-170000,2021-06-09
9406,035974,緯穎元大0C購01,0,0,0,0,0,0,0,0,0,-170000,0,0,0,0,170000,-170000,-170000,2021-06-09
9407,035947,松翰凱基0C購02,0,0,0,0,0,0,0,0,0,-170000,0,0,0,63000,233000,-170000,-170000,2021-06-09
9408,035404,開發金元富13購01,0,0,0,0,0,0,0,0,0,-170000,0,0,0,0,170000,-170000,-170000,2021-06-09
9409,04078P,世紀鋼元富09售03,0,0,0,0,0,0,0,0,0,-170000,0,0,0,20000,190000,-170000,-170000,2021-06-09
9410,034234,台聚統一0C購01,0,0,0,0,0,0,0,0,0,-170000,0,0,0,92000,262000,-170000,-170000,2021-06-09
9411,079049,禾伸堂元大07購01,0,0,0,0,0,0,0,0,0,-170000,0,0,0,5000,175000,-170000,-170000,2021-06-09
9412,1337,再生-KY,62000,232000,-170000,0,0,0,0,0,0,0,0,0,0,0,0,0,-170000,2021-06-09
9413,087681,台積電元大09購22,0,0,0,0,0,0,0,0,0,-171000,0,0,0,280000,451000,-171000,-171000,2021-06-09
9414,087841,台表科凱基11購01,0,0,0,0,0,0,0,0,0,-171000,0,0,0,0,171000,-171000,-171000,2021-06-09
9415,088689,廣宇元富0C購03,0,0,0,0,0,0,0,0,0,-171000,0,0,0,0,171000,-171000,-171000,2021-06-09
9416,031801,長榮航國票0A購03,0,0,0,0,0,0,0,0,0,-171000,0,0,0,14000,185000,-171000,-171000,2021-06-09
9417,035903,友達群益0C購01,0,0,0,0,0,0,0,0,0,-171000,0,0,0,0,171000,-171000,-171000,2021-06-09
9418,06830P,華邦電統一0A售06,0,0,0,0,0,0,0,0,0,-171000,0,0,0,40000,211000,-171000,-171000,2021-06-09
9419,088628,松翰永豐09購03,0,0,0,0,0,0,0,0,0,-172000,0,0,0,0,172000,-172000,-172000,2021-06-09
9420,084773,南亞科凱基08購03,0,0,0,0,0,0,0,0,0,-172000,0,0,0,50000,222000,-172000,-172000,2021-06-09
9421,085501,景碩凱基08購02,0,0,0,0,0,0,0,0,0,-172000,0,0,0,15000,187000,-172000,-172000,2021-06-09
9422,036421,直得凱基0C購01,0,0,0,0,0,0,0,0,0,-172000,0,0,0,0,172000,-172000,-172000,2021-06-09
9423,06982P,東鋼元大0A售09,0,0,0,0,0,0,0,0,0,-172000,0,0,0,17000,189000,-172000,-172000,2021-06-09
9424,3028,增你強,11000,183000,-172000,0,0,0,0,0,0,0,0,0,0,0,0,0,-172000,2021-06-09
9425,2404,漢唐,125021,275056,-150035,0,0,0,0,25000,-25000,2398,7000,5602,1398,17000,16000,1000,-172637,2021-06-09
9426,085807,南電元大0C購01,0,0,0,0,0,0,0,0,0,-173000,0,0,0,65000,238000,-173000,-173000,2021-06-09
9427,086206,盛群凱基08購01,0,0,0,0,0,0,0,0,0,-173000,0,0,0,0,173000,-173000,-173000,2021-06-09
9428,083966,欣興凱基0C購01,0,0,0,0,0,0,0,0,0,-173000,0,0,0,243000,416000,-173000,-173000,2021-06-09
9429,033052,聯電永豐0A購06,0,0,0,0,0,0,0,0,0,-173000,0,0,0,0,173000,-173000,-173000,2021-06-09
9430,036338,智原元富12購02,0,0,0,0,0,0,0,0,0,-173000,0,0,0,111000,284000,-173000,-173000,2021-06-09
9431,034463,元翎群益0B購01,0,0,0,0,0,0,0,0,0,-173000,0,0,0,433000,606000,-173000,-173000,2021-06-09
9432,081931,愛普凱基09購01,0,0,0,0,0,0,0,0,0,-173000,0,0,0,0,173000,-173000,-173000,2021-06-09
9433,088570,長榮航凱基0A購02,0,0,0,0,0,0,0,0,0,-174000,0,0,0,19000,193000,-174000,-174000,2021-06-09
9434,033434,偉詮電元大0C購01,0,0,0,0,0,0,0,0,0,-174000,0,0,0,360000,534000,-174000,-174000,2021-06-09
9435,030749,華晶科元大0A購03,0,0,0,0,0,0,0,0,0,-174000,0,0,0,0,174000,-174000,-174000,2021-06-09
9436,030775,友達麥證0A購02,0,0,0,1000,175000,-174000,0,0,0,-174000,0,0,0,1000,175000,-174000,-174000,2021-06-09
9437,035514,燿華永豐0B購01,0,0,0,0,0,0,0,0,0,-174000,0,0,0,0,174000,-174000,-174000,2021-06-09
9438,082193,奇鋐永豐07購01,0,0,0,0,0,0,0,0,0,-174000,0,0,0,81000,255000,-174000,-174000,2021-06-09
9439,084451,英業達永豐08購01,0,0,0,0,0,0,0,0,0,-175000,0,0,0,91000,266000,-175000,-175000,2021-06-09
9440,084324,松翰凱基07購01,0,0,0,0,0,0,0,0,0,-175000,0,0,0,32000,207000,-175000,-175000,2021-06-09
9441,085160,奇力新凱基08購03,0,0,0,0,0,0,0,0,0,-175000,0,0,0,10000,185000,-175000,-175000,2021-06-09
9442,030536,威盛凱基0A購01,0,0,0,0,0,0,0,0,0,-175000,0,0,0,35000,210000,-175000,-175000,2021-06-09
9443,036489,創意富邦13購01,0,0,0,0,0,0,0,0,0,-175000,0,0,0,2000,177000,-175000,-175000,2021-06-09
9444,035820,力鵬元大0B購02,0,0,0,0,0,0,0,0,0,-175000,0,0,0,0,175000,-175000,-175000,2021-06-09
9445,07196P,長榮富邦12售04,0,0,0,0,0,0,0,0,0,-175000,0,0,0,560000,735000,-175000,-175000,2021-06-09
9446,1459,聯發,67000,242000,-175000,0,0,0,0,0,0,0,0,0,0,0,0,0,-175000,2021-06-09
9447,089238,大立光永豐0C購01,0,0,0,0,0,0,0,0,0,-175000,0,0,0,0,175000,-175000,-175000,2021-06-09
9448,031759,臺股指凱基11購07,0,0,0,0,0,0,0,0,0,-176000,0,0,0,445000,621000,-176000,-176000,2021-06-09
9449,034977,智邦富邦0B購01,0,0,0,0,0,0,0,0,0,-176000,0,0,0,58000,234000,-176000,-176000,2021-06-09
9450,034596,鴻海統一0B購04,0,0,0,0,0,0,0,0,0,-176000,0,0,0,0,176000,-176000,-176000,2021-06-09
9451,089793,友達麥證0B購03,0,0,0,177000,353000,-176000,0,0,0,-176000,0,0,0,177000,353000,-176000,-176000,2021-06-09
9452,2637,慧洋-KY,6102000,6272000,-170000,0,0,0,0,0,0,-6441,405011,407452,-2441,0,4000,-4000,-176441,2021-06-09
9453,036048,矽創元富13購02,0,0,0,0,0,0,0,0,0,-177000,0,0,0,105000,282000,-177000,-177000,2021-06-09
9454,07097P,國巨凱基0B售07,0,0,0,0,0,0,0,0,0,-177000,0,0,0,60000,237000,-177000,-177000,2021-06-09
9455,086254,欣興中信0A購01,0,0,0,0,0,0,0,0,0,-178000,0,0,0,179000,357000,-178000,-178000,2021-06-09
9456,087981,聯詠凱基09購04,0,0,0,0,0,0,0,0,0,-178000,0,0,0,10000,188000,-178000,-178000,2021-06-09
9457,031228,臺股指凱基0C購24,0,0,0,0,0,0,0,0,0,-178000,0,0,0,3000,181000,-178000,-178000,2021-06-09
9458,035651,亞光兆豐12購01,0,0,0,0,0,0,0,0,0,-178000,0,0,0,0,178000,-178000,-178000,2021-06-09
9459,06071P,臺股指凱基09售10,0,0,0,0,0,0,0,0,0,-178000,0,0,0,0,178000,-178000,-178000,2021-06-09
9460,033654,台積電統一15購02,20000,0,20000,0,0,0,0,0,0,-198000,0,0,0,0,198000,-198000,-178000,2021-06-09
9461,081095,緯穎中信0A購01,0,0,0,0,0,0,0,0,0,-178000,0,0,0,1000,179000,-178000,-178000,2021-06-09
9462,1463,強盛,375000,553000,-178000,0,0,0,0,0,0,-100,0,100,-100,0,0,0,-178100,2021-06-09
9463,087985,松翰凱基0A購01,0,0,0,0,0,0,0,0,0,-179000,0,0,0,0,179000,-179000,-179000,2021-06-09
9464,033350,精成科永豐0B購01,0,0,0,0,0,0,0,0,0,-179000,0,0,0,0,179000,-179000,-179000,2021-06-09
9465,06991P,友達元大0B售06,0,0,0,0,0,0,0,0,0,-179000,0,0,0,11000,190000,-179000,-179000,2021-06-09
9466,087441,精成科元富0C購02,0,0,0,0,0,0,0,0,0,-180000,0,0,0,0,180000,-180000,-180000,2021-06-09
9467,086540,滬深2X元大09購04,0,0,0,0,0,0,0,0,0,-180000,0,0,0,20000,200000,-180000,-180000,2021-06-09
9468,085750,亞光永豐08購03,0,0,0,0,0,0,0,0,0,-180000,0,0,0,0,180000,-180000,-180000,2021-06-09
9469,031920,景碩永豐0A購02,0,0,0,0,0,0,0,0,0,-180000,0,0,0,47000,227000,-180000,-180000,2021-06-09
9470,035529,宏達電群益0C購05,0,0,0,0,0,0,0,0,0,-180000,0,0,0,5000,185000,-180000,-180000,2021-06-09
9471,034027,開發金中信0B購01,0,0,0,0,0,0,0,0,0,-180000,0,0,0,0,180000,-180000,-180000,2021-06-09
9472,1310,台苯,755000,852000,-97000,0,0,0,0,0,0,-83000,0,0,0,5000,88000,-83000,-180000,2021-06-09
9473,088871,立積永豐09購05,0,0,0,0,0,0,0,0,0,-181000,0,0,0,40000,221000,-181000,-181000,2021-06-09
9474,033449,矽創元大0B購03,0,0,0,0,0,0,0,0,0,-181000,0,0,0,25000,206000,-181000,-181000,2021-06-09
9475,06732P,亞德客元大09售01,0,0,0,0,0,0,0,0,0,-181000,0,0,0,8000,189000,-181000,-181000,2021-06-09
9476,077292,南亞科元富0B購01,0,0,0,0,0,0,0,0,0,-181000,0,0,0,59000,240000,-181000,-181000,2021-06-09
9477,084772,凌陽凱基09購01,0,0,0,0,0,0,0,0,0,-182000,0,0,0,124000,306000,-182000,-182000,2021-06-09
9478,030911,聯陽凱基0B購01,0,0,0,0,0,0,0,0,0,-182000,0,0,0,62000,244000,-182000,-182000,2021-06-09
9479,033833,聯發科國泰11購01,0,0,0,0,0,0,0,0,0,-182000,0,0,0,35000,217000,-182000,-182000,2021-06-09
9480,035751,和桐元富13購01,0,0,0,0,0,0,0,0,0,-182000,0,0,0,0,182000,-182000,-182000,2021-06-09
9481,087592,精成科元大09購02,0,0,0,0,0,0,0,0,0,-183000,0,0,0,59000,242000,-183000,-183000,2021-06-09
9482,032989,台積電元富12購04,0,0,0,0,0,0,0,0,0,-183000,0,0,0,0,183000,-183000,-183000,2021-06-09
9483,035171,長榮國票12購03,0,0,0,0,0,0,0,0,0,-183000,0,0,0,47000,230000,-183000,-183000,2021-06-09
9484,035056,聯電國泰11購04,0,1000,-1000,0,0,0,0,0,0,-182000,0,0,0,117000,299000,-182000,-183000,2021-06-09
9485,034202,合勤控元大0B購02,0,0,0,0,0,0,0,0,0,-183000,0,0,0,0,183000,-183000,-183000,2021-06-09
9486,086078,智邦富邦0A購01,0,0,0,0,0,0,0,0,0,-184000,0,0,0,14000,198000,-184000,-184000,2021-06-09
9487,085970,欣興凱基09購01,0,0,0,0,0,0,0,0,0,-184000,0,0,0,13000,197000,-184000,-184000,2021-06-09
9488,089619,鴻海第一13購02,0,0,0,0,0,0,0,0,0,-184000,0,0,0,57000,241000,-184000,-184000,2021-06-09
9489,084017,台積電統一0A購06,0,0,0,0,0,0,0,0,0,-185000,0,0,0,0,185000,-185000,-185000,2021-06-09
9490,033589,台驊控凱基13購01,0,0,0,0,0,0,0,0,0,-185000,0,0,0,1000,186000,-185000,-185000,2021-06-09
9491,030294,立積元富0A購05,0,0,0,0,0,0,0,0,0,-185000,0,0,0,0,185000,-185000,-185000,2021-06-09
9492,083029,滬深2X中信09購01,0,0,0,0,0,0,0,0,0,-185000,0,0,0,15000,200000,-185000,-185000,2021-06-09
9493,034953,欣興凱基12購01,0,0,0,0,0,0,0,0,0,-186000,0,0,0,42000,228000,-186000,-186000,2021-06-09
9494,1907,永豐餘,8286000,8179010,106990,0,0,0,0,0,0,-293149,16000,79149,-63149,226000,456000,-230000,-186159,2021-06-09
9495,033045,華晶科兆豐0A購01,0,0,0,0,0,0,0,0,0,-187000,0,0,0,13000,200000,-187000,-187000,2021-06-09
9496,032460,群創富邦0A購03,0,0,0,0,0,0,0,0,0,-187000,0,0,0,0,187000,-187000,-187000,2021-06-09
9497,030043,台積電元大0A購06,0,0,0,0,0,0,0,0,0,-188000,0,0,0,65000,253000,-188000,-188000,2021-06-09
9498,034270,矽創國票0C購01,0,0,0,0,0,0,0,0,0,-188000,0,0,0,82000,270000,-188000,-188000,2021-06-09
9499,034493,新光金元大13購02,0,0,0,0,0,0,0,0,0,-188000,0,0,0,12000,200000,-188000,-188000,2021-06-09
9500,032096,中鋼永豐0A購05,0,0,0,0,0,0,0,0,0,-189000,0,0,0,0,189000,-189000,-189000,2021-06-09
9501,035594,國巨元大0C購12,0,0,0,0,0,0,0,0,0,-189000,0,0,0,11000,200000,-189000,-189000,2021-06-09
9502,6456,GIS-KY,226000,444000,-218000,0,0,0,54000,0,54000,-25000,0,0,0,15000,40000,-25000,-189000,2021-06-09
9503,088312,松翰凱基0A購02,0,0,0,0,0,0,0,0,0,-190000,0,0,0,0,190000,-190000,-190000,2021-06-09
9504,032468,友達中信0B購02,0,0,0,0,0,0,0,0,0,-190000,0,0,0,0,190000,-190000,-190000,2021-06-09
9505,033075,嘉澤凱基0A購01,0,0,0,0,0,0,0,0,0,-190000,0,0,0,23000,213000,-190000,-190000,2021-06-09
9506,035691,泰鼎凱基0C購01,0,0,0,0,0,0,0,0,0,-190000,0,0,0,0,190000,-190000,-190000,2021-06-09
9507,080416,惠特元大07購02,0,0,0,0,0,0,0,0,0,-190000,0,0,0,20000,210000,-190000,-190000,2021-06-09
9508,06695P,南電凱基0A售04,0,0,0,0,0,0,0,0,0,-190000,0,0,0,91000,281000,-190000,-190000,2021-06-09
9509,083394,大立光中信09購04,0,0,0,0,0,0,0,0,0,-190000,0,0,0,10000,200000,-190000,-190000,2021-06-09
9510,05927P,臺股指麥證09售01,0,0,0,20000,211000,-191000,0,0,0,-191000,0,0,0,20000,211000,-191000,-191000,2021-06-09
9511,088260,訊芯兆豐09購01,0,0,0,0,0,0,0,0,0,-192000,0,0,0,128000,320000,-192000,-192000,2021-06-09
9512,086793,台郡兆豐0A購01,0,0,0,0,0,0,0,0,0,-193000,0,0,0,0,193000,-193000,-193000,2021-06-09
9513,032012,儒鴻統一0C購01,0,0,0,0,0,0,0,0,0,-193000,0,0,0,7000,200000,-193000,-193000,2021-06-09
9514,077595,台表科統一08購01,0,0,0,0,0,0,0,0,0,-193000,0,0,0,147000,340000,-193000,-193000,2021-06-09
9515,080385,南港元大09購01,0,0,0,0,0,0,0,0,0,-193000,0,0,0,67000,260000,-193000,-193000,2021-06-09
9516,089067,凌陽凱基0A購01,0,0,0,0,0,0,0,0,0,-194000,0,0,0,275000,469000,-194000,-194000,2021-06-09
9517,033254,威健元大0C購01,0,0,0,0,0,0,0,0,0,-194000,0,0,0,10000,204000,-194000,-194000,2021-06-09
9518,034815,南亞科群益0B購07,0,0,0,0,0,0,0,0,0,-194000,0,0,0,26000,220000,-194000,-194000,2021-06-09
9519,04287P,同欣電元富0A售01,0,0,0,0,0,0,0,0,0,-194000,0,0,0,0,194000,-194000,-194000,2021-06-09
9520,088555,滬深2X凱基0C購01,0,0,0,0,0,0,0,0,0,-195000,0,0,0,50000,245000,-195000,-195000,2021-06-09
9521,085622,元石油凱基0A購01,0,0,0,0,0,0,0,0,0,-195000,0,0,0,20000,215000,-195000,-195000,2021-06-09
9522,032017,景碩統一0C購01,0,0,0,0,0,0,0,0,0,-195000,0,0,0,153000,348000,-195000,-195000,2021-06-09
9523,035361,臻鼎兆豐0C購01,0,0,0,0,0,0,0,0,0,-195000,0,0,0,0,195000,-195000,-195000,2021-06-09
9524,082578,愛普統一09購04,0,0,0,0,0,0,0,0,0,-195000,0,0,0,10000,205000,-195000,-195000,2021-06-09
9525,1229,聯華,113000,305000,-192000,0,0,0,0,0,0,-3996,1000,4996,-3996,0,0,0,-195996,2021-06-09
9526,033335,和桐永豐0B購01,0,0,0,0,0,0,0,0,0,-196000,0,0,0,99000,295000,-196000,-196000,2021-06-09
9527,081259,訊芯國泰09購01,0,0,0,0,0,0,0,0,0,-196000,0,0,0,100000,296000,-196000,-196000,2021-06-09
9528,06682P,聯電富邦0A售01,2000,0,2000,0,0,0,0,0,0,-198000,0,0,0,502000,700000,-198000,-196000,2021-06-09
9529,089966,台積電元大0A購04,0,0,0,0,0,0,0,0,0,-196000,0,0,0,11000,207000,-196000,-196000,2021-06-09
9530,06892P,中鋼統一0A售01,0,0,0,0,0,0,0,0,0,-197000,0,0,0,24000,221000,-197000,-197000,2021-06-09
9531,080883,聯發科中信09購02,0,0,0,0,0,0,0,0,0,-197000,0,0,0,0,197000,-197000,-197000,2021-06-09
9532,084004,致新永豐07購02,0,0,0,0,0,0,0,0,0,-198000,0,0,0,25000,223000,-198000,-198000,2021-06-09
9533,086889,統一群益0C購01,0,0,0,0,0,0,0,0,0,-198000,0,0,0,0,198000,-198000,-198000,2021-06-09
9534,031470,鈺齊群益0B購01,0,0,0,0,0,0,0,0,0,-198000,0,0,0,45000,243000,-198000,-198000,2021-06-09
9535,030631,台郡元大0C購01,0,0,0,0,0,0,0,0,0,-198000,0,0,0,147000,345000,-198000,-198000,2021-06-09
9536,083841,鴻海群益08購09,0,0,0,0,0,0,0,0,0,-199000,0,0,0,0,199000,-199000,-199000,2021-06-09
9537,085345,聯電永豐08購07,0,0,0,0,0,0,0,0,0,-199000,0,0,0,0,199000,-199000,-199000,2021-06-09
9538,031180,友達永豐0A購03,0,0,0,0,0,0,0,0,0,-199000,0,0,0,272000,471000,-199000,-199000,2021-06-09
9539,035159,新光鋼國票0C購01,0,0,0,0,0,0,0,0,0,-199000,0,0,0,12000,211000,-199000,-199000,2021-06-09
9540,06886P,臺股指群益0A售16,0,0,0,0,0,0,0,0,0,-199000,0,0,0,16000,215000,-199000,-199000,2021-06-09
9541,06811P,臺股指元大0A售26,0,0,0,0,0,0,0,0,0,-199000,0,0,0,1000,200000,-199000,-199000,2021-06-09
9542,1434,福懋,386000,500000,-114000,0,0,0,0,219000,-219000,134000,0,6000,-6000,140000,0,140000,-199000,2021-06-09
9543,089225,南電群益0B購01,0,0,0,0,0,0,0,0,0,-199000,0,0,0,20000,219000,-199000,-199000,2021-06-09
9544,2477,美隆電,146000,345000,-199000,0,0,0,0,0,0,0,0,0,0,0,0,0,-199000,2021-06-09
9545,6477,安集,93000,290000,-197000,0,0,0,0,0,0,-2000,0,0,0,0,2000,-2000,-199000,2021-06-09
9546,085753,松翰永豐08購02,0,0,0,0,0,0,0,0,0,-200000,0,0,0,0,200000,-200000,-200000,2021-06-09
9547,086390,臺股指國票09購17,0,0,0,0,0,0,0,0,0,-200000,0,0,0,0,200000,-200000,-200000,2021-06-09
9548,086328,中興電元大09購02,0,0,0,0,0,0,0,0,0,-200000,0,0,0,2000,202000,-200000,-200000,2021-06-09
9549,083530,可成元大07購04,0,0,0,0,0,0,0,0,0,-200000,0,0,0,0,200000,-200000,-200000,2021-06-09
9550,084904,喬山永豐08購01,0,0,0,0,0,0,0,0,0,-200000,0,0,0,0,200000,-200000,-200000,2021-06-09
9551,084590,新日興富邦08購01,0,0,0,0,0,0,0,0,0,-200000,0,0,0,0,200000,-200000,-200000,2021-06-09
9552,087968,台積電日盛13購01,0,0,0,0,0,0,0,0,0,-200000,0,0,0,0,200000,-200000,-200000,2021-06-09
9553,031055,凌陽元大0A購03,0,0,0,0,0,0,0,0,0,-200000,0,0,0,38000,238000,-200000,-200000,2021-06-09
9554,030352,國揚群益0B購01,0,0,0,0,0,0,0,0,0,-200000,0,0,0,0,200000,-200000,-200000,2021-06-09
9555,030403,鼎元元大0A購01,0,0,0,0,0,0,0,0,0,-200000,0,0,0,0,200000,-200000,-200000,2021-06-09
9556,030417,潤泰全元大0A購01,0,0,0,0,0,0,0,0,0,-200000,0,0,0,0,200000,-200000,-200000,2021-06-09
9557,05506P,玉晶光元富0C售02,0,0,0,0,0,0,0,0,0,-200000,0,0,0,0,200000,-200000,-200000,2021-06-09
9558,035311,國巨元大0B購15,0,0,0,0,0,0,0,0,0,-200000,0,0,0,0,200000,-200000,-200000,2021-06-09
9559,036149,國巨元大0C購13,0,0,0,0,0,0,0,0,0,-200000,0,0,0,0,200000,-200000,-200000,2021-06-09
9560,036150,國巨元大0C購14,0,0,0,0,0,0,0,0,0,-200000,0,0,0,0,200000,-200000,-200000,2021-06-09
9561,035593,國巨元大0B購17,0,0,0,0,0,0,0,0,0,-200000,0,0,0,0,200000,-200000,-200000,2021-06-09
9562,068405,玉晶光元富07購01,0,0,0,0,0,0,0,0,0,-200000,0,0,0,0,200000,-200000,-200000,2021-06-09
9563,07232P,臺股指群益0B售10,0,0,0,0,0,0,0,0,0,-200000,0,0,0,0,200000,-200000,-200000,2021-06-09
9564,080716,達方凱基07購01,0,0,0,0,0,0,0,0,0,-200000,0,0,0,0,200000,-200000,-200000,2021-06-09
9565,081182,T50反1元大0A購02,0,0,0,0,0,0,0,0,0,-200000,0,0,0,0,200000,-200000,-200000,2021-06-09
9566,083036,台積電中信0B購07,0,0,0,0,0,0,0,0,0,-200000,0,0,0,0,200000,-200000,-200000,2021-06-09
9567,082037,亞德客凱基08購01,0,0,0,0,0,0,0,0,0,-200000,0,0,0,0,200000,-200000,-200000,2021-06-09
9568,081578,台達化元大07購02,0,0,0,0,0,0,0,0,0,-200000,0,0,0,0,200000,-200000,-200000,2021-06-09
9569,1617,榮星,18000,213000,-195000,0,0,0,0,0,0,-5000,0,5000,-5000,0,0,0,-200000,2021-06-09
9570,089994,潤泰新元大0A購01,0,0,0,0,0,0,0,0,0,-200000,0,0,0,0,200000,-200000,-200000,2021-06-09
9571,036087,威盛元大0C購01,0,0,0,0,0,0,0,0,0,-201000,0,0,0,0,201000,-201000,-201000,2021-06-09
9572,035661,愛普國泰12購01,0,0,0,0,0,0,0,0,0,-201000,0,0,0,0,201000,-201000,-201000,2021-06-09
9573,07127P,長榮國票0C售06,0,0,0,0,0,0,0,0,0,-201000,0,0,0,0,201000,-201000,-201000,2021-06-09
9574,1906,寶隆,138000,339000,-201000,0,0,0,0,0,0,0,0,0,0,0,0,0,-201000,2021-06-09
9575,2491,吉祥全,1000,202000,-201000,0,0,0,0,0,0,-7,0,7,-7,0,0,0,-201007,2021-06-09
9576,087355,松翰麥證09購01,0,0,0,0,209000,-209000,0,0,0,-202000,0,0,0,7000,209000,-202000,-202000,2021-06-09
9577,030398,台積電元大0A購08,0,0,0,0,0,0,0,0,0,-202000,0,0,0,240000,442000,-202000,-202000,2021-06-09
9578,036388,精成科富邦11購01,0,0,0,0,0,0,0,0,0,-202000,0,0,0,10000,212000,-202000,-202000,2021-06-09
9579,079345,深中小凱基08購01,0,0,0,0,0,0,0,0,0,-202000,0,0,0,0,202000,-202000,-202000,2021-06-09
9580,085415,華晶科元大09購01,0,0,0,0,0,0,0,0,0,-203000,0,0,0,5000,208000,-203000,-203000,2021-06-09
9581,033198,矽創凱基0C購01,0,0,0,0,0,0,0,0,0,-203000,0,0,0,471000,674000,-203000,-203000,2021-06-09
9582,030828,國巨中信0B購03,0,0,0,0,0,0,0,0,0,-203000,0,0,0,45000,248000,-203000,-203000,2021-06-09
9583,033362,大毅群益0B購01,0,0,0,0,0,0,0,0,0,-203000,0,0,0,0,203000,-203000,-203000,2021-06-09
9584,035763,正文元富13購01,0,0,0,0,0,0,0,0,0,-203000,0,0,0,0,203000,-203000,-203000,2021-06-09
9585,034818,開發金群益11購02,0,0,0,0,0,0,0,0,0,-203000,0,0,0,23000,226000,-203000,-203000,2021-06-09
9586,035854,欣興統一11購04,0,0,0,0,0,0,0,0,0,-203000,0,0,0,1259000,1462000,-203000,-203000,2021-06-09
9587,082130,台積電統一0A購02,0,0,0,0,0,0,0,0,0,-203000,0,0,0,0,203000,-203000,-203000,2021-06-09
9588,035795,全新永豐0B購01,0,0,0,0,0,0,0,0,0,-204000,0,0,0,5000,209000,-204000,-204000,2021-06-09
9589,033929,興勤元大11購01,0,0,0,0,0,0,0,0,0,-204000,0,0,0,20000,224000,-204000,-204000,2021-06-09
9590,2008,高興昌,39000,243000,-204000,0,0,0,0,0,0,0,0,0,0,0,0,0,-204000,2021-06-09
9591,088400,喬山永豐09購01,0,0,0,0,0,0,0,0,0,-205000,0,0,0,0,205000,-205000,-205000,2021-06-09
9592,036285,國巨元大13購02,0,0,0,0,0,0,0,0,0,-205000,0,0,0,0,205000,-205000,-205000,2021-06-09
9593,033908,群創統一15購04,0,0,0,0,0,0,0,0,0,-205000,0,0,0,0,205000,-205000,-205000,2021-06-09
9594,2723,美食-KY,70000,284000,-214000,0,0,0,20000,0,20000,-11000,0,0,0,0,11000,-11000,-205000,2021-06-09
9595,088280,廣宇群益09購02,0,0,0,0,0,0,0,0,0,-206000,0,0,0,0,206000,-206000,-206000,2021-06-09
9596,033073,嘉晶凱基0B購01,0,0,0,0,0,0,0,0,0,-206000,0,0,0,60000,266000,-206000,-206000,2021-06-09
9597,034560,鴻海國泰11購03,0,0,0,0,0,0,0,0,0,-206000,0,0,0,0,206000,-206000,-206000,2021-06-09
9598,083074,臺股指麥證07購06,0,0,0,106000,312000,-206000,0,0,0,-206000,0,0,0,106000,312000,-206000,-206000,2021-06-09
9599,084525,緯穎元大08購01,0,0,0,0,0,0,0,0,0,-207000,0,0,0,33000,240000,-207000,-207000,2021-06-09
9600,083432,聯電凱基08購06,0,0,0,0,0,0,0,0,0,-207000,0,0,0,50000,257000,-207000,-207000,2021-06-09
9601,033370,新光金富邦13購02,0,0,0,0,0,0,0,0,0,-207000,0,0,0,0,207000,-207000,-207000,2021-06-09
9602,032175,中石化群益0B購04,0,0,0,0,0,0,0,0,0,-207000,0,0,0,0,207000,-207000,-207000,2021-06-09
9603,036145,台玻元大0C購03,0,0,0,0,0,0,0,0,0,-207000,0,0,0,20000,227000,-207000,-207000,2021-06-09
9604,2032,新鋼,191000,398000,-207000,0,0,0,0,0,0,0,0,0,0,0,0,0,-207000,2021-06-09
9605,089250,聚陽統一0B購03,0,0,0,0,0,0,0,0,0,-207000,0,0,0,180000,387000,-207000,-207000,2021-06-09
9606,033041,聯發科兆豐0A購08,0,0,0,0,0,0,0,0,0,-208000,0,0,0,0,208000,-208000,-208000,2021-06-09
9607,03748C,台積電富邦0C牛01,0,0,0,0,0,0,0,0,0,-208000,0,0,0,8000,216000,-208000,-208000,2021-06-09
9608,089674,鴻海元大0C購09,0,0,0,0,0,0,0,0,0,-208000,0,0,0,20000,228000,-208000,-208000,2021-06-09
9609,087448,松翰群益09購01,0,0,0,0,0,0,0,0,0,-209000,0,0,0,20000,229000,-209000,-209000,2021-06-09
9610,033227,聯電康和0B購02,0,0,0,0,0,0,0,0,0,-209000,0,0,0,201000,410000,-209000,-209000,2021-06-09
9611,032153,長榮航凱基0A購05,0,0,0,0,0,0,0,0,0,-209000,0,0,0,91000,300000,-209000,-209000,2021-06-09
9612,033881,凌陽元富0B購01,0,0,0,0,0,0,0,0,0,-209000,0,0,0,370000,579000,-209000,-209000,2021-06-09
9613,087744,SGBR2X國票09購01,0,0,0,0,0,0,0,0,0,-210000,0,0,0,20000,230000,-210000,-210000,2021-06-09
9614,085527,南電富邦09購01,0,0,0,0,0,0,0,0,0,-210000,0,0,0,453000,663000,-210000,-210000,2021-06-09
9615,031757,鈺齊凱基12購01,0,0,0,0,0,0,0,0,0,-210000,0,0,0,0,210000,-210000,-210000,2021-06-09
9616,033063,聚鼎永豐0A購01,0,0,0,0,0,0,0,0,0,-210000,0,0,0,0,210000,-210000,-210000,2021-06-09
9617,033518,台聚國票0C購01,0,0,0,0,0,0,0,0,0,-210000,0,0,0,0,210000,-210000,-210000,2021-06-09
9618,032408,遠東新元大0C購01,0,0,0,0,0,0,0,0,0,-210000,0,0,0,0,210000,-210000,-210000,2021-06-09
9619,031376,合勤控永豐0A購01,0,0,0,0,0,0,0,0,0,-210000,0,0,0,15000,225000,-210000,-210000,2021-06-09
9620,07056P,新光鋼元大0B售02,0,0,0,0,0,0,0,0,0,-210000,0,0,0,35000,245000,-210000,-210000,2021-06-09
9621,06548P,臺股指元大09售10,0,0,0,0,0,0,0,0,0,-210000,0,0,0,50000,260000,-210000,-210000,2021-06-09
9622,089548,立積國泰0B購01,0,0,0,0,0,0,0,0,0,-210000,0,0,0,0,210000,-210000,-210000,2021-06-09
9623,089119,台積電富邦0B購05,0,0,0,0,0,0,0,0,0,-210000,0,0,0,10000,220000,-210000,-210000,2021-06-09
9624,1528,恩德,98000,308000,-210000,0,0,0,0,0,0,0,0,0,0,0,0,0,-210000,2021-06-09
9625,3008,大立光,141142,354943,-213801,0,0,0,0,2000,-2000,5615,8000,5000,3000,6000,3385,2615,-210186,2021-06-09
9626,085672,南電統一0A購03,0,0,0,0,0,0,0,0,0,-211000,0,0,0,46000,257000,-211000,-211000,2021-06-09
9627,085250,南電永豐08購02,0,0,0,0,0,0,0,0,0,-211000,0,0,0,185000,396000,-211000,-211000,2021-06-09
9628,088127,全新凱基0A購01,0,0,0,0,0,0,0,0,0,-211000,0,0,0,99000,310000,-211000,-211000,2021-06-09
9629,031713,國泰金永豐0A購01,0,0,0,0,0,0,0,0,0,-211000,0,0,0,0,211000,-211000,-211000,2021-06-09
9630,036135,康控凱基0C購01,0,0,0,0,0,0,0,0,0,-211000,0,0,0,8000,219000,-211000,-211000,2021-06-09
9631,084827,台積電統一0C購03,0,0,0,0,0,0,0,0,0,-212000,0,0,0,0,212000,-212000,-212000,2021-06-09
9632,031723,宏達電群益0C購04,0,0,0,0,0,0,0,0,0,-212000,0,0,0,129000,341000,-212000,-212000,2021-06-09
9633,034899,道瓊反元大12購01,0,0,0,0,0,0,0,0,0,-212000,0,0,0,8000,220000,-212000,-212000,2021-06-09
9634,036001,南電永豐0C購01,0,0,0,0,0,0,0,0,0,-212000,0,0,0,12000,224000,-212000,-212000,2021-06-09
9635,078271,旺宏國票08購02,0,0,0,0,0,0,0,0,0,-212000,0,0,0,10000,222000,-212000,-212000,2021-06-09
9636,1219,福壽,60000,264000,-204000,0,0,0,0,0,0,-8000,0,8000,-8000,0,0,0,-212000,2021-06-09
9637,089909,圓展凱基11購01,0,0,0,0,0,0,0,0,0,-212000,0,0,0,0,212000,-212000,-212000,2021-06-09
9638,6224,聚鼎,192000,427000,-235000,0,0,0,0,65000,-65000,88000,4000,0,4000,101000,17000,84000,-212000,2021-06-09
9639,2328,廣宇,1204000,1496000,-292000,0,0,0,0,0,0,79833,160002,148169,11833,77000,9000,68000,-212167,2021-06-09
9640,033987,旺宏兆豐0B購01,0,0,0,0,0,0,0,0,0,-213000,0,0,0,30000,243000,-213000,-213000,2021-06-09
9641,036572,世紀鋼元大12購02,0,0,0,0,0,0,0,0,0,-213000,0,0,0,0,213000,-213000,-213000,2021-06-09
9642,083130,凱美凱基08購01,0,0,0,0,0,0,0,0,0,-213000,0,0,0,25000,238000,-213000,-213000,2021-06-09
9643,087381,聯電元大11購02,0,0,0,0,0,0,0,0,0,-214000,0,0,0,151000,365000,-214000,-214000,2021-06-09
9644,030089,喬山永豐0A購01,0,0,0,0,0,0,0,0,0,-214000,0,0,0,0,214000,-214000,-214000,2021-06-09
9645,035375,泰豐凱基0B購02,0,0,0,0,0,0,0,0,0,-214000,0,0,0,116000,330000,-214000,-214000,2021-06-09
9646,034590,台玻統一0C購03,0,0,0,0,0,0,0,0,0,-214000,0,0,0,51000,265000,-214000,-214000,2021-06-09
9647,089212,凌陽群益0A購02,0,0,0,0,0,0,0,0,0,-214000,0,0,0,0,214000,-214000,-214000,2021-06-09
9648,033580,中纖凱基12購02,0,0,0,0,0,0,0,0,0,-215000,0,0,0,38000,253000,-215000,-215000,2021-06-09
9649,06949P,長榮凱基0A售20,0,0,0,0,0,0,0,0,0,-215000,0,0,0,150000,365000,-215000,-215000,2021-06-09
9650,6024,群益期,62000,277000,-215000,0,0,0,0,0,0,0,0,0,0,0,0,0,-215000,2021-06-09
9651,033051,泰豐永豐0A購03,0,0,0,0,0,0,0,0,0,-216000,0,0,0,78000,294000,-216000,-216000,2021-06-09
9652,032010,電子類群益0A購01,0,0,0,0,0,0,0,0,0,-216000,0,0,0,38000,254000,-216000,-216000,2021-06-09
9653,030447,臺股指元大11購04,0,0,0,0,0,0,0,0,0,-216000,0,0,0,0,216000,-216000,-216000,2021-06-09
9654,036414,創意群益12購01,0,0,0,0,0,0,0,0,0,-216000,0,0,0,2000,218000,-216000,-216000,2021-06-09
9655,035684,光罩凱基0C購01,0,0,0,0,0,0,0,0,0,-216000,0,0,0,248000,464000,-216000,-216000,2021-06-09
9656,030526,臺股指群益0A購03,0,0,0,0,0,0,0,0,0,-217000,0,0,0,45000,262000,-217000,-217000,2021-06-09
9657,033932,禾伸堂元大0B購01,30000,0,30000,0,0,0,0,0,0,-247000,0,0,0,285000,532000,-247000,-217000,2021-06-09
9658,033771,群創群益11購04,0,0,0,0,0,0,0,0,0,-217000,0,0,0,270000,487000,-217000,-217000,2021-06-09
9659,033677,聯電元大0B購01,0,0,0,0,0,0,0,0,0,-217000,0,0,0,2000,219000,-217000,-217000,2021-06-09
9660,07183P,長榮群益0B售14,0,0,0,0,0,0,0,0,0,-218000,0,0,0,10000,228000,-218000,-218000,2021-06-09
9661,086609,T50正2群益09購06,0,0,0,0,0,0,0,0,0,-219000,0,0,0,40000,259000,-219000,-219000,2021-06-09
9662,033664,晶技統一15購01,0,0,0,0,0,0,0,0,0,-219000,0,0,0,120000,339000,-219000,-219000,2021-06-09
9663,1513,中興電,884000,1038000,-154000,0,0,0,0,0,0,-65659,0,0,0,19000,84659,-65659,-219659,2021-06-09
9664,087552,聯詠元富0A購02,0,0,0,0,0,0,0,0,0,-220000,0,0,0,0,220000,-220000,-220000,2021-06-09
9665,088262,廣宇永豐09購01,0,0,0,0,0,0,0,0,0,-220000,0,0,0,0,220000,-220000,-220000,2021-06-09
9666,033574,中石化凱基15購01,0,0,0,0,0,0,0,0,0,-220000,0,0,0,33000,253000,-220000,-220000,2021-06-09
9667,036563,欣興元大11購03,0,0,0,0,0,0,0,0,0,-220000,0,0,0,0,220000,-220000,-220000,2021-06-09
9668,035408,友達康和0C購01,0,0,0,0,0,0,0,0,0,-220000,0,0,0,68000,288000,-220000,-220000,2021-06-09
9669,080774,嘉澤元大06購01,0,0,0,0,0,0,0,0,0,-220000,0,0,0,0,220000,-220000,-220000,2021-06-09
9670,035328,聯詠元大0B購04,0,0,0,0,0,0,0,0,0,-221000,0,0,0,18000,239000,-221000,-221000,2021-06-09
9671,080201,台光電元富09購01,0,0,0,0,0,0,0,0,0,-221000,0,0,0,128000,349000,-221000,-221000,2021-06-09
9672,033134,宏達電元大0A購06,0,0,0,0,0,0,0,0,0,-222000,0,0,0,0,222000,-222000,-222000,2021-06-09
9673,032103,友達永豐0A購04,0,0,0,0,0,0,0,0,0,-222000,0,0,0,138000,360000,-222000,-222000,2021-06-09
9674,2511,太子,54418,277000,-222582,0,0,0,0,0,0,-7,0,7,-7,0,0,0,-222589,2021-06-09
9675,086577,南電元大09購02,0,0,0,0,0,0,0,0,0,-223000,0,0,0,70000,293000,-223000,-223000,2021-06-09
9676,032335,凌陽群益0B購01,0,0,0,0,0,0,0,0,0,-223000,0,0,0,3000,226000,-223000,-223000,2021-06-09
9677,036412,欣興群益12購02,0,0,0,0,0,0,0,0,0,-223000,0,0,0,88000,311000,-223000,-223000,2021-06-09
9678,034716,長榮康和11購01,0,0,0,0,0,0,0,0,0,-223000,0,0,0,141000,364000,-223000,-223000,2021-06-09
9679,034717,新光金康和0C購01,0,0,0,0,0,0,0,0,0,-223000,0,0,0,300000,523000,-223000,-223000,2021-06-09
9680,4414,如興,576000,799000,-223000,0,0,0,0,0,0,0,0,0,0,0,0,0,-223000,2021-06-09
9681,089392,精成科兆豐0A購01,0,0,0,0,0,0,0,0,0,-223000,0,0,0,0,223000,-223000,-223000,2021-06-09
9682,2436,偉詮電,3111000,3204050,-93050,0,0,0,0,0,0,-130642,405859,506501,-100642,20000,50000,-30000,-223692,2021-06-09
9683,088300,鴻海凱基13購03,0,0,0,0,0,0,0,0,0,-224000,0,0,0,50000,274000,-224000,-224000,2021-06-09
9684,032633,聯發科統一14購01,0,0,0,0,0,0,0,0,0,-224000,0,0,0,0,224000,-224000,-224000,2021-06-09
9685,036194,長榮航統一12購01,0,0,0,0,0,0,0,0,0,-224000,0,0,0,550000,774000,-224000,-224000,2021-06-09
9686,034733,聯發科元大0B購09,0,0,0,0,0,0,0,0,0,-224000,0,0,0,0,224000,-224000,-224000,2021-06-09
9687,034038,廣宇元富12購01,0,0,0,0,0,0,0,0,0,-224000,0,0,0,0,224000,-224000,-224000,2021-06-09
9688,088774,矽創兆豐0A購02,0,0,0,0,0,0,0,0,0,-225000,0,0,0,64000,289000,-225000,-225000,2021-06-09
9689,030146,眾達凱基12購01,0,0,0,0,0,0,0,0,0,-225000,0,0,0,113000,338000,-225000,-225000,2021-06-09
9690,034445,世紀鋼凱基0B購01,0,0,0,0,0,0,0,0,0,-225000,0,0,0,0,225000,-225000,-225000,2021-06-09
9691,035590,泰豐元大0B購02,0,0,0,0,0,0,0,0,0,-225000,0,0,0,184000,409000,-225000,-225000,2021-06-09
9692,035528,華通群益0C購01,0,0,0,0,0,0,0,0,0,-226000,0,0,0,20000,246000,-226000,-226000,2021-06-09
9693,4943,康控-KY,128000,344000,-216000,0,0,0,0,0,0,-10000,0,0,0,6000,16000,-10000,-226000,2021-06-09
9694,076473,全新中信07購01,0,0,0,0,0,0,0,0,0,-227000,0,0,0,13000,240000,-227000,-227000,2021-06-09
9695,089263,南電統一0A購09,0,0,0,0,0,0,0,0,0,-227000,0,0,0,4000,231000,-227000,-227000,2021-06-09
9696,1590,亞德客-KY,240784,359145,-118361,0,0,0,0,106000,-106000,-2677,21000,21677,-677,2000,4000,-2000,-227038,2021-06-09
9697,030320,光磊麥證0B購01,0,0,0,10000,238000,-228000,0,0,0,-228000,0,0,0,10000,238000,-228000,-228000,2021-06-09
9698,032219,微星統一0B購06,0,0,0,0,0,0,0,0,0,-228000,0,0,0,0,228000,-228000,-228000,2021-06-09
9699,033886,瀚宇博元富0B購01,0,0,0,0,0,0,0,0,0,-228000,0,0,0,0,228000,-228000,-228000,2021-06-09
9700,032867,矽創群益0B購04,0,0,0,0,0,0,0,0,0,-229000,0,0,0,27000,256000,-229000,-229000,2021-06-09
9701,082443,T50反1元大0A購05,0,0,0,0,0,0,0,0,0,-229000,0,0,0,1000,230000,-229000,-229000,2021-06-09
9702,084381,台積電統一0A購07,0,0,0,0,0,0,0,0,0,-230000,0,0,0,0,230000,-230000,-230000,2021-06-09
9703,032127,中鋼凱基14購03,0,0,0,0,0,0,0,0,0,-230000,0,0,0,17000,247000,-230000,-230000,2021-06-09
9704,034398,昇陽半元大11購01,0,0,0,0,0,0,0,0,0,-230000,0,0,0,8000,238000,-230000,-230000,2021-06-09
9705,035962,國巨元大11購05,0,0,0,0,0,0,0,0,0,-230000,0,0,0,0,230000,-230000,-230000,2021-06-09
9706,078951,全新元富0C購02,0,0,0,0,0,0,0,0,0,-230000,0,0,0,10000,240000,-230000,-230000,2021-06-09
9707,07076P,臺股指元大0C售15,0,0,0,0,0,0,0,0,0,-230000,0,0,0,98000,328000,-230000,-230000,2021-06-09
9708,034564,友達國泰11購01,0,0,0,0,0,0,0,0,0,-231000,0,0,0,80000,311000,-231000,-231000,2021-06-09
9709,9939,宏全,18000,247000,-229000,0,0,0,0,0,0,-2000,0,2000,-2000,0,0,0,-231000,2021-06-09
9710,078996,國巨凱基0C購01,0,0,0,0,0,0,0,0,0,-232000,0,0,0,0,232000,-232000,-232000,2021-06-09
9711,074516,台積電國票07購01,0,0,0,0,0,0,0,0,0,-232000,0,0,0,123000,355000,-232000,-232000,2021-06-09
9712,6412,群電,55000,242000,-187000,0,0,0,0,45000,-45000,0,0,0,0,0,0,0,-232000,2021-06-09
9713,083551,緯穎元大07購05,0,0,0,0,0,0,0,0,0,-233000,0,0,0,0,233000,-233000,-233000,2021-06-09
9714,031921,華擎永豐0A購01,0,0,0,0,0,0,0,0,0,-233000,0,0,0,4000,237000,-233000,-233000,2021-06-09
9715,06441P,台灣50台新09售01,0,0,0,0,0,0,0,0,0,-233000,0,0,0,31000,264000,-233000,-233000,2021-06-09
9716,032091,儒鴻永豐0A購01,0,0,0,0,0,0,0,0,0,-234000,0,0,0,5000,239000,-234000,-234000,2021-06-09
9717,032664,致新麥證0A購01,0,0,0,203000,437000,-234000,0,0,0,-234000,0,0,0,203000,437000,-234000,-234000,2021-06-09
9718,034508,長榮航凱基0C購01,0,0,0,0,0,0,0,0,0,-234000,0,0,0,141000,375000,-234000,-234000,2021-06-09
9719,083626,旺宏凱基07購05,0,0,0,0,0,0,0,0,0,-235000,0,0,0,5000,240000,-235000,-235000,2021-06-09
9720,032992,光罩元富12購01,0,0,0,0,0,0,0,0,0,-235000,0,0,0,185000,420000,-235000,-235000,2021-06-09
9721,034688,聯電群益0C購01,0,0,0,0,0,0,0,0,0,-235000,0,0,0,28000,263000,-235000,-235000,2021-06-09
9722,033869,華碩群益0C購01,0,0,0,0,0,0,0,0,0,-235000,0,0,0,20000,255000,-235000,-235000,2021-06-09
9723,06628P,英業達凱基09售02,0,0,0,0,0,0,0,0,0,-235000,0,0,0,0,235000,-235000,-235000,2021-06-09
9724,080765,華邦電元大07購06,0,0,0,0,0,0,0,0,0,-235000,0,0,0,22000,257000,-235000,-235000,2021-06-09
9725,085145,盛群中信08購01,0,0,0,0,0,0,0,0,0,-236000,0,0,0,0,236000,-236000,-236000,2021-06-09
9726,085429,南電元大08購06,0,0,0,0,0,0,0,0,0,-236000,0,0,0,144000,380000,-236000,-236000,2021-06-09
9727,088313,鄉林凱基09購01,0,0,0,0,0,0,0,0,0,-237000,0,0,0,50000,287000,-237000,-237000,2021-06-09
9728,031755,彩晶凱基0C購01,0,2000,-2000,0,0,0,0,0,0,-235000,0,0,0,126000,361000,-235000,-237000,2021-06-09
9729,035522,國喬群益0B購02,0,0,0,0,0,0,0,0,0,-237000,0,0,0,24000,261000,-237000,-237000,2021-06-09
9730,07160P,旺宏凱基0B售06,0,0,0,0,0,0,0,0,0,-237000,0,0,0,0,237000,-237000,-237000,2021-06-09
9731,032902,矽創統一0C購02,0,0,0,0,0,0,0,0,0,-238000,0,0,0,356000,594000,-238000,-238000,2021-06-09
9732,031868,東鋼凱基12購01,0,0,0,0,0,0,0,0,0,-238000,0,0,0,112000,350000,-238000,-238000,2021-06-09
9733,034203,合勤控元大11購01,0,0,0,0,0,0,0,0,0,-238000,0,0,0,8000,246000,-238000,-238000,2021-06-09
9734,078743,樺漢元富0C購01,0,0,0,0,0,0,0,0,0,-239000,0,0,0,0,239000,-239000,-239000,2021-06-09
9735,081833,新興凱基09購01,0,0,0,0,0,0,0,0,0,-239000,0,0,0,72000,311000,-239000,-239000,2021-06-09
9736,086319,盛群凱基0A購01,0,0,0,0,0,0,0,0,0,-240000,0,0,0,5000,245000,-240000,-240000,2021-06-09
9737,030159,強茂中信0A購02,0,0,0,0,0,0,0,0,0,-240000,0,0,0,110000,350000,-240000,-240000,2021-06-09
9738,030046,興富發元大12購01,0,0,0,0,0,0,0,0,0,-240000,0,0,0,0,240000,-240000,-240000,2021-06-09
9739,082670,強茂兆豐08購01,0,0,0,0,0,0,0,0,0,-240000,0,0,0,0,240000,-240000,-240000,2021-06-09
9740,087819,國喬凱基09購01,0,0,0,0,0,0,0,0,0,-241000,0,0,0,20000,261000,-241000,-241000,2021-06-09
9741,030438,松翰元大0A購03,0,0,0,0,0,0,0,0,0,-241000,0,0,0,0,241000,-241000,-241000,2021-06-09
9742,034006,友達群益0B購05,0,0,0,0,0,0,0,0,0,-241000,0,0,0,10000,251000,-241000,-241000,2021-06-09
9743,086643,華擎凱基09購01,0,0,0,0,0,0,0,0,0,-242000,0,0,0,30000,272000,-242000,-242000,2021-06-09
9744,034170,禾伸堂永豐0B購02,0,0,0,0,0,0,0,0,0,-242000,0,0,0,9000,251000,-242000,-242000,2021-06-09
9745,081197,華邦電元大08購03,0,0,0,0,0,0,0,0,0,-242000,0,0,0,10000,252000,-242000,-242000,2021-06-09
9746,087296,松翰元大0B購01,0,0,0,0,0,0,0,0,0,-243000,0,0,0,31000,274000,-243000,-243000,2021-06-09
9747,3712,永崴投控,38000,281000,-243000,0,0,0,0,0,0,0,0,0,0,0,0,0,-243000,2021-06-09
9748,3048,益登,397000,555000,-158000,0,0,0,0,0,0,-86000,0,90000,-90000,4000,0,4000,-244000,2021-06-09
9749,2395,研華,292451,535500,-243049,0,0,0,0,1798,-1798,0,0,0,0,0,0,0,-244847,2021-06-09
9750,033036,盛群群益0A購01,0,0,0,0,0,0,0,0,0,-245000,0,0,0,0,245000,-245000,-245000,2021-06-09
9751,033962,開發金國泰11購01,0,0,0,0,0,0,0,0,0,-245000,0,0,0,7000,252000,-245000,-245000,2021-06-09
9752,036521,晶相光群益12購01,0,0,0,0,0,0,0,0,0,-245000,0,0,0,0,245000,-245000,-245000,2021-06-09
9753,067651,漢唐元富07購01,0,0,0,0,0,0,0,0,0,-245000,0,0,0,5000,250000,-245000,-245000,2021-06-09
9754,00692,富邦公司治理,28300,29000,-700,0,0,0,0,0,0,-244421,0,0,0,858000,1102421,-244421,-245121,2021-06-09
9755,087787,奇鋐永豐09購01,0,0,0,0,0,0,0,0,0,-246000,0,0,0,172000,418000,-246000,-246000,2021-06-09
9756,032057,聯詠國票0A購05,0,0,0,0,0,0,0,0,0,-246000,0,0,0,10000,256000,-246000,-246000,2021-06-09
9757,035324,萬海元大0C購08,0,0,0,0,0,0,0,0,0,-246000,0,0,0,236000,482000,-246000,-246000,2021-06-09
9758,034071,S&P反1元大12購01,0,0,0,0,0,0,0,0,0,-246000,0,0,0,0,246000,-246000,-246000,2021-06-09
9759,087354,聯發科麥證09購05,0,0,0,0,247000,-247000,0,0,0,-247000,0,0,0,0,247000,-247000,-247000,2021-06-09
9760,033982,新唐凱基0B購02,0,0,0,0,0,0,0,0,0,-247000,0,0,0,159000,406000,-247000,-247000,2021-06-09
9761,035724,華擎元大0B購03,0,0,0,0,0,0,0,0,0,-247000,0,0,0,175000,422000,-247000,-247000,2021-06-09
9762,089621,台灣50凱基0B購03,0,0,0,0,0,0,0,0,0,-247000,0,0,0,0,247000,-247000,-247000,2021-06-09
9763,031822,智伸科元大0A購02,0,0,0,0,0,0,0,0,0,-248000,0,0,0,0,248000,-248000,-248000,2021-06-09
9764,033385,宏達電元大0B購05,0,0,0,0,0,0,0,0,0,-248000,0,0,0,0,248000,-248000,-248000,2021-06-09
9765,034249,新光鋼統一17購01,0,0,0,0,0,0,0,0,0,-248000,0,0,0,62000,310000,-248000,-248000,2021-06-09
9766,032113,惠特永豐0A購03,0,0,0,0,0,0,0,0,0,-249000,0,0,0,0,249000,-249000,-249000,2021-06-09
9767,085973,健策凱基08購02,0,0,0,0,0,0,0,0,0,-250000,0,0,0,33000,283000,-250000,-250000,2021-06-09
9768,085984,國巨元大0C購03,0,0,0,0,0,0,0,0,0,-250000,0,0,0,0,250000,-250000,-250000,2021-06-09
9769,036311,中鋼統一12購05,0,0,0,0,0,0,0,0,0,-250000,0,0,0,0,250000,-250000,-250000,2021-06-09
9770,031374,晶技永豐0A購01,0,0,0,0,0,0,0,0,0,-250000,0,0,0,0,250000,-250000,-250000,2021-06-09
9771,030573,滬深2X富邦0C購01,0,0,0,0,0,0,0,0,0,-250000,0,0,0,10000,260000,-250000,-250000,2021-06-09
9772,036554,圓剛元大0C購01,0,0,0,0,0,0,0,0,0,-250000,0,0,0,67000,317000,-250000,-250000,2021-06-09
9773,073044,嘉澤元富07購01,0,0,0,0,0,0,0,0,0,-250000,0,0,0,0,250000,-250000,-250000,2021-06-09
9774,081181,T50反1元大0A購01,0,0,0,0,0,0,0,0,0,-250000,0,0,0,0,250000,-250000,-250000,2021-06-09
9775,1519,華城,113000,361000,-248000,0,0,0,0,0,0,-2000,0,0,0,0,2000,-2000,-250000,2021-06-09
9776,031795,台揚國票0B購01,0,0,0,0,0,0,0,0,0,-251000,0,0,0,40000,291000,-251000,-251000,2021-06-09
9777,036097,新唐元大0C購02,0,0,0,0,0,0,0,0,0,-251000,0,0,0,0,251000,-251000,-251000,2021-06-09
9778,080229,聯電元大08購04,0,0,0,0,0,0,0,0,0,-251000,0,0,0,108000,359000,-251000,-251000,2021-06-09
9779,3653,健策,290000,518060,-228060,0,0,0,258000,295000,-37000,13350,103000,44000,59000,18000,63650,-45650,-251710,2021-06-09
9780,031894,臺股指凱基0A購18,0,0,0,0,0,0,0,0,0,-252000,0,0,0,86000,338000,-252000,-252000,2021-06-09
9781,8429,金麗-KY,159000,411000,-252000,0,0,0,0,0,0,0,0,0,0,0,0,0,-252000,2021-06-09
9782,086844,華晶科元大09購02,0,0,0,0,0,0,0,0,0,-253000,0,0,0,40000,293000,-253000,-253000,2021-06-09
9783,035557,創意統一0B購06,0,0,0,0,0,0,0,0,0,-253000,0,0,0,71000,324000,-253000,-253000,2021-06-09
9784,086933,台光電元大09購02,0,0,0,0,0,0,0,0,0,-254000,0,0,0,508000,762000,-254000,-254000,2021-06-09
9785,034738,長榮元大0B購13,0,0,0,0,0,0,0,0,0,-255000,0,0,0,245000,500000,-255000,-255000,2021-06-09
9786,081316,華擎元大07購01,0,0,0,0,0,0,0,0,0,-255000,0,0,0,10000,265000,-255000,-255000,2021-06-09
9787,086026,強茂永豐08購01,0,0,0,0,0,0,0,0,0,-256000,0,0,0,0,256000,-256000,-256000,2021-06-09
9788,1615,大山,54000,309000,-255000,0,0,0,0,0,0,-1000,0,1000,-1000,0,0,0,-256000,2021-06-09
9789,089845,凌陽元大09購01,0,0,0,0,0,0,0,0,0,-256000,0,0,0,235000,491000,-256000,-256000,2021-06-09
9790,083881,大立光國泰0B購01,0,0,0,0,0,0,0,0,0,-257000,0,0,0,193000,450000,-257000,-257000,2021-06-09
9791,030787,南帝凱基12購01,0,0,0,0,0,0,0,0,0,-257000,0,0,0,229000,486000,-257000,-257000,2021-06-09
9792,034390,禾伸堂元大11購01,0,0,0,0,0,0,0,0,0,-257000,0,0,0,108000,365000,-257000,-257000,2021-06-09
9793,036144,台玻元大0C購02,0,0,0,0,0,0,0,0,0,-257000,0,0,0,27000,284000,-257000,-257000,2021-06-09
9794,2905,三商,77000,400000,-323000,0,0,0,0,0,0,66000,66000,0,66000,0,0,0,-257000,2021-06-09
9795,2349,錸德,115000,372883,-257883,0,0,0,0,0,0,0,0,0,0,0,0,0,-257883,2021-06-09
9796,030116,盛群永豐0A購01,0,0,0,0,0,0,0,0,0,-258000,0,0,0,14000,272000,-258000,-258000,2021-06-09
9797,032593,宏達電元大0B購04,0,0,0,0,0,0,0,0,0,-258000,0,0,0,26000,284000,-258000,-258000,2021-06-09
9798,035925,華通元富13購01,0,0,0,0,0,0,0,0,0,-258000,0,0,0,0,258000,-258000,-258000,2021-06-09
9799,082315,亞德客統一09購02,0,0,0,0,0,0,0,0,0,-258000,0,0,0,55000,313000,-258000,-258000,2021-06-09
9800,032500,台船永豐0A購03,0,0,0,0,0,0,0,0,0,-259000,0,0,0,0,259000,-259000,-259000,2021-06-09
9801,031522,宏全元大0B購01,0,0,0,0,0,0,0,0,0,-259000,0,0,0,4000,263000,-259000,-259000,2021-06-09
9802,084974,聯發科凱基0C購05,0,0,0,0,0,0,0,0,0,-260000,0,0,0,0,260000,-260000,-260000,2021-06-09
9803,086413,健策統一0B購01,0,0,0,0,0,0,0,0,0,-260000,0,0,0,785000,1045000,-260000,-260000,2021-06-09
9804,086151,華邦電元大09購01,0,0,0,0,0,0,0,0,0,-261000,0,0,0,9000,270000,-261000,-261000,2021-06-09
9805,034991,長榮航群益0C購01,0,0,0,0,0,0,0,0,0,-261000,0,0,0,32000,293000,-261000,-261000,2021-06-09
9806,06399P,嘉澤元大08售03,0,0,0,0,0,0,0,0,0,-261000,0,0,0,0,261000,-261000,-261000,2021-06-09
9807,089201,群創凱基09購14,0,0,0,0,0,0,0,0,0,-261000,0,0,0,79000,340000,-261000,-261000,2021-06-09
9808,085829,亞光群益08購02,0,0,0,0,0,0,0,0,0,-262000,0,0,0,0,262000,-262000,-262000,2021-06-09
9809,088395,亞德客中信09購01,0,0,0,0,0,0,0,0,0,-262000,0,0,0,0,262000,-262000,-262000,2021-06-09
9810,030127,台積電凱基0B購07,0,0,0,0,0,0,0,0,0,-262000,0,0,0,5000,267000,-262000,-262000,2021-06-09
9811,031910,華碩永豐0A購01,0,0,0,0,0,0,0,0,0,-263000,0,0,0,0,263000,-263000,-263000,2021-06-09
9812,034382,台揚元大0C購02,0,0,0,0,0,0,0,0,0,-264000,0,0,0,187000,451000,-264000,-264000,2021-06-09
9813,035099,元翎凱基11購01,0,0,0,0,0,0,0,0,0,-264000,0,0,0,120000,384000,-264000,-264000,2021-06-09
9814,087913,全新群益0B購01,0,0,0,0,0,0,0,0,0,-265000,0,0,0,10000,275000,-265000,-265000,2021-06-09
9815,086137,南電群益08購06,0,0,0,0,0,0,0,0,0,-265000,0,0,0,92000,357000,-265000,-265000,2021-06-09
9816,030326,大立光麥證0C購02,0,0,0,5000,270000,-265000,0,0,0,-265000,0,0,0,5000,270000,-265000,-265000,2021-06-09
9817,083093,金像電元大07購10,0,0,0,0,0,0,0,0,0,-265000,0,0,0,50000,315000,-265000,-265000,2021-06-09
9818,4976,佳凌,1286200,1552000,-265800,0,0,0,0,0,0,0,57000,57000,0,0,0,0,-265800,2021-06-09
9819,085905,全新富邦0A購01,0,0,0,0,0,0,0,0,0,-266000,0,0,0,318000,584000,-266000,-266000,2021-06-09
9820,082575,台郡統一09購01,0,0,0,0,0,0,0,0,0,-266000,0,0,0,0,266000,-266000,-266000,2021-06-09
9821,033324,智原凱基0C購01,0,0,0,0,0,0,0,0,0,-267000,0,0,0,105000,372000,-267000,-267000,2021-06-09
9822,085364,盛群永豐08購02,0,0,0,0,0,0,0,0,0,-268000,0,0,0,60000,328000,-268000,-268000,2021-06-09
9823,032846,光罩永豐0A購02,0,0,0,0,0,0,0,0,0,-269000,0,0,0,48000,317000,-269000,-269000,2021-06-09
9824,030394,鴻海元大12購03,0,0,0,0,0,0,0,0,0,-269000,0,0,0,67000,336000,-269000,-269000,2021-06-09
9825,034612,新唐統一0C購05,0,0,0,0,0,0,0,0,0,-269000,0,0,0,361000,630000,-269000,-269000,2021-06-09
9826,030059,松翰元大0B購02,0,0,0,0,0,0,0,0,0,-270000,0,0,0,0,270000,-270000,-270000,2021-06-09
9827,082640,大立光富邦09購01,0,0,0,0,0,0,0,0,0,-270000,0,0,0,0,270000,-270000,-270000,2021-06-09
9828,06734P,國巨元大0B售03,0,0,0,0,0,0,0,0,0,-270000,0,0,0,55000,325000,-270000,-270000,2021-06-09
9829,2009,第一銅,1392000,1662500,-270500,0,0,0,0,0,0,0,253000,253000,0,0,0,0,-270500,2021-06-09
9830,087515,聯電凱基11購01,0,0,0,0,0,0,0,0,0,-271000,0,0,0,1000,272000,-271000,-271000,2021-06-09
9831,06916P,欣興元大0A售01,0,0,0,0,0,0,0,0,0,-271000,0,0,0,594000,865000,-271000,-271000,2021-06-09
9832,07188P,長榮凱基11售06,0,0,0,0,0,0,0,0,0,-271000,0,0,0,55000,326000,-271000,-271000,2021-06-09
9833,088180,凌陽麥證0A購01,0,0,0,251000,537000,-286000,0,0,0,-272000,0,0,0,309000,581000,-272000,-272000,2021-06-09
9834,089390,盛群中信0B購01,0,0,0,0,0,0,0,0,0,-272000,0,0,0,43000,315000,-272000,-272000,2021-06-09
9835,06072P,臺股指凱基09售11,0,0,0,0,0,0,0,0,0,-273000,0,0,0,129000,402000,-273000,-273000,2021-06-09
9836,035249,聯茂群益0B購01,0,0,0,0,0,0,0,0,0,-273000,0,0,0,0,273000,-273000,-273000,2021-06-09
9837,083583,電子類群益07購01,0,0,0,0,0,0,0,0,0,-274000,0,0,0,3000,277000,-274000,-274000,2021-06-09
9838,035201,聯詠元富0C購02,0,0,0,0,0,0,0,0,0,-274000,0,0,0,116000,390000,-274000,-274000,2021-06-09
9839,088643,南電國票0A購02,0,0,0,0,0,0,0,0,0,-275000,0,0,0,23000,298000,-275000,-275000,2021-06-09
9840,083131,凱美凱基09購01,0,0,0,0,0,0,0,0,0,-275000,0,0,0,41000,316000,-275000,-275000,2021-06-09
9841,07054P,富邦金元大0B售05,0,0,0,0,0,0,0,0,0,-276000,0,0,0,40000,316000,-276000,-276000,2021-06-09
9842,1103,嘉泥,126000,402000,-276000,0,0,0,0,0,0,0,0,0,0,0,0,0,-276000,2021-06-09
9843,6005,群益證,1098000,1374000,-276000,0,0,0,0,0,0,0,0,0,0,0,0,0,-276000,2021-06-09
9844,083932,聯詠中信09購02,0,0,0,0,0,0,0,0,0,-277000,0,0,0,30000,307000,-277000,-277000,2021-06-09
9845,085835,松翰群益08購04,0,0,0,0,0,0,0,0,0,-277000,0,0,0,20000,297000,-277000,-277000,2021-06-09
9846,086218,微星統一0A購01,0,0,0,0,0,0,0,0,0,-278000,0,0,0,100000,378000,-278000,-278000,2021-06-09
9847,085617,松翰元大09購01,0,0,0,0,0,0,0,0,0,-278000,0,0,0,3000,281000,-278000,-278000,2021-06-09
9848,087719,松翰統一0B購01,0,0,0,0,0,0,0,0,0,-278000,0,0,0,192000,470000,-278000,-278000,2021-06-09
9849,031573,台積電凱基14購04,0,0,0,0,0,0,0,0,0,-278000,0,0,0,60000,338000,-278000,-278000,2021-06-09
9850,036530,欣興兆豐11購01,0,0,0,0,0,0,0,0,0,-278000,0,0,0,0,278000,-278000,-278000,2021-06-09
9851,089528,立積元大09購10,0,0,0,0,0,0,0,0,0,-279000,0,0,0,458000,737000,-279000,-279000,2021-06-09
9852,085461,聯電麥證0B購01,0,0,0,0,280000,-280000,0,0,0,-280000,0,0,0,0,280000,-280000,-280000,2021-06-09
9853,030359,王品群益0A購01,0,0,0,0,0,0,0,0,0,-280000,0,0,0,0,280000,-280000,-280000,2021-06-09
9854,033464,精成科群益0B購01,0,0,0,0,0,0,0,0,0,-280000,0,0,0,0,280000,-280000,-280000,2021-06-09
9855,06272P,南電凱基09售02,0,0,0,0,0,0,0,0,0,-280000,0,0,0,75000,355000,-280000,-280000,2021-06-09
9856,088458,松翰統一0A購02,0,0,0,0,0,0,0,0,0,-281000,0,0,0,0,281000,-281000,-281000,2021-06-09
9857,2913,農林,1278000,1384000,-106000,0,0,0,0,0,0,-175082,0,136000,-136000,15163,54245,-39082,-281082,2021-06-09
9858,033437,聯發科元大0C購08,0,0,0,0,0,0,0,0,0,-282000,0,0,0,8000,290000,-282000,-282000,2021-06-09
9859,030322,凌陽麥證0C購01,0,0,0,213000,510000,-297000,0,0,0,-282000,0,0,0,231000,513000,-282000,-282000,2021-06-09
9860,080984,台郡國泰09購01,0,0,0,0,0,0,0,0,0,-282000,0,0,0,214000,496000,-282000,-282000,2021-06-09
9861,080409,貿聯元大08購01,0,0,0,0,0,0,0,0,0,-282000,0,0,0,23000,305000,-282000,-282000,2021-06-09
9862,085391,緯穎兆豐09購01,0,0,0,0,0,0,0,0,0,-284000,0,0,0,22000,306000,-284000,-284000,2021-06-09
9863,033331,中石化永豐0B購01,0,0,0,0,0,0,0,0,0,-284000,0,0,0,0,284000,-284000,-284000,2021-06-09
9864,087406,松翰元大09購02,0,0,0,0,0,0,0,0,0,-285000,0,0,0,5000,290000,-285000,-285000,2021-06-09
9865,032122,中石化凱基0A購02,0,0,0,0,0,0,0,0,0,-285000,0,0,0,0,285000,-285000,-285000,2021-06-09
9866,035227,南亞科兆豐0B購01,0,0,0,0,0,0,0,0,0,-286000,0,0,0,5000,291000,-286000,-286000,2021-06-09
9867,032990,台積電元富12購05,0,0,0,0,0,0,0,0,0,-287000,0,0,0,125000,412000,-287000,-287000,2021-06-09
9868,087194,台積電麥證11購01,0,0,0,110000,398000,-288000,0,0,0,-288000,0,0,0,110000,398000,-288000,-288000,2021-06-09
9869,033390,晶技元大12購01,0,0,0,0,0,0,0,0,0,-288000,0,0,0,10000,298000,-288000,-288000,2021-06-09
9870,032635,長榮統一0C購11,0,0,0,0,0,0,0,0,0,-288000,0,0,0,21000,309000,-288000,-288000,2021-06-09
9871,033155,聯茂元大0B購01,0,0,0,0,0,0,0,0,0,-288000,0,0,0,0,288000,-288000,-288000,2021-06-09
9872,035195,聯發科元富0C購06,0,0,0,0,0,0,0,0,0,-288000,0,0,0,5000,293000,-288000,-288000,2021-06-09
9873,3682,亞太電,98000,386000,-288000,0,0,0,0,0,0,0,0,0,0,0,0,0,-288000,2021-06-09
9874,033241,華碩元大12購01,0,0,0,0,0,0,0,0,0,-289000,0,0,0,0,289000,-289000,-289000,2021-06-09
9875,035431,萬海元大13購01,0,0,0,0,0,0,0,0,0,-289000,0,0,0,232000,521000,-289000,-289000,2021-06-09
9876,035488,新光金群益0C購02,0,0,0,0,0,0,0,0,0,-289000,0,0,0,0,289000,-289000,-289000,2021-06-09
9877,07135P,台達電凱基0B售02,0,0,0,0,0,0,0,0,0,-289000,0,0,0,12000,301000,-289000,-289000,2021-06-09
9878,032893,光罩統一14購01,0,0,0,0,0,0,0,0,0,-291000,0,0,0,3000,294000,-291000,-291000,2021-06-09
9879,033192,聯發科凱基0B購07,0,0,0,0,0,0,0,0,0,-291000,0,0,0,0,291000,-291000,-291000,2021-06-09
9880,034088,友達元大0B購10,0,0,0,0,0,0,0,0,0,-292000,0,0,0,80000,372000,-292000,-292000,2021-06-09
9881,9917,中保科,40000,329000,-289000,0,0,0,0,0,0,-3000,0,3000,-3000,0,0,0,-292000,2021-06-09
9882,00738U,期元大道瓊白銀,39000,5000,34000,0,0,0,0,0,0,-326218,0,0,0,119000,445218,-326218,-292218,2021-06-09
9883,034005,友達群益0B購04,0,0,0,0,0,0,0,0,0,-293000,0,0,0,652000,945000,-293000,-293000,2021-06-09
9884,2636,台驊投控,223000,540674,-317674,0,0,0,0,0,0,24000,20000,2000,18000,6000,0,6000,-293674,2021-06-09
9885,031908,順德永豐0A購01,0,0,0,0,0,0,0,0,0,-294000,0,0,0,166000,460000,-294000,-294000,2021-06-09
9886,033649,東鋼統一15購01,0,0,0,0,0,0,0,0,0,-294000,0,0,0,16000,310000,-294000,-294000,2021-06-09
9887,06021P,聯電凱基08售07,0,0,0,0,0,0,0,0,0,-295000,0,0,0,0,295000,-295000,-295000,2021-06-09
9888,083097,台光電元大07購01,0,0,0,0,0,0,0,0,0,-298000,0,0,0,1000,299000,-298000,-298000,2021-06-09
9889,088648,聯詠富邦0B購03,0,0,0,0,0,0,0,0,0,-299000,0,0,0,50000,349000,-299000,-299000,2021-06-09
9890,085806,南電元大08購09,0,0,0,0,0,0,0,0,0,-299000,0,0,0,111000,410000,-299000,-299000,2021-06-09
9891,080975,金像電元大07購06,0,0,0,0,0,0,0,0,0,-299000,0,0,0,0,299000,-299000,-299000,2021-06-09
9892,06538P,臺股指凱基09售24,0,0,0,0,0,0,0,0,0,-299000,0,0,0,0,299000,-299000,-299000,2021-06-09
9893,078950,全新元富0C購01,0,0,0,0,0,0,0,0,0,-299000,0,0,0,5000,304000,-299000,-299000,2021-06-09
9894,086015,盛群元大08購03,0,0,0,0,0,0,0,0,0,-300000,0,0,0,110000,410000,-300000,-300000,2021-06-09
9895,083494,嘉晶元富07購05,0,0,0,0,0,0,0,0,0,-300000,0,0,0,0,300000,-300000,-300000,2021-06-09
9896,087602,台積電中信09購12,0,0,0,0,0,0,0,0,0,-300000,0,0,0,0,300000,-300000,-300000,2021-06-09
9897,033547,聯發科元富12購05,0,0,0,0,0,0,0,0,0,-300000,0,0,0,0,300000,-300000,-300000,2021-06-09
9898,035956,中鋼元大0C購07,0,0,0,0,0,0,0,0,0,-300000,0,0,0,0,300000,-300000,-300000,2021-06-09
9899,082571,大立光統一09購07,0,0,0,0,0,0,0,0,0,-300000,0,0,0,0,300000,-300000,-300000,2021-06-09
9900,036403,欣興永豐0C購01,0,0,0,0,0,0,0,0,0,-301000,0,0,0,5000,306000,-301000,-301000,2021-06-09
9901,035261,新唐凱基11購01,0,0,0,0,0,0,0,0,0,-301000,0,0,0,55000,356000,-301000,-301000,2021-06-09
9902,033891,中鋼統一12購03,0,0,0,0,0,0,0,0,0,-301000,0,0,0,0,301000,-301000,-301000,2021-06-09
9903,086706,華邦電元大09購02,0,0,0,0,0,0,0,0,0,-302000,0,0,0,0,302000,-302000,-302000,2021-06-09
9904,086498,南電元富09購06,0,0,0,0,0,0,0,0,0,-302000,0,0,0,56000,358000,-302000,-302000,2021-06-09
9905,032823,友達康和0A購02,0,0,0,0,0,0,0,0,0,-302000,0,0,0,51000,353000,-302000,-302000,2021-06-09
9906,030247,超豐永豐0A購01,0,0,0,0,0,0,0,0,0,-303000,0,0,0,1000,304000,-303000,-303000,2021-06-09
9907,087215,聯發科凱基09購07,0,0,0,0,0,0,0,0,0,-304000,0,0,0,0,304000,-304000,-304000,2021-06-09
9908,084555,凌陽元富09購01,0,0,0,0,0,0,0,0,0,-304000,0,0,0,9000,313000,-304000,-304000,2021-06-09
9909,082772,愛普統一09購05,0,0,0,0,0,0,0,0,0,-304000,0,0,0,2000,306000,-304000,-304000,2021-06-09
9910,084611,凌陽兆豐09購01,0,0,0,0,0,0,0,0,0,-305000,0,0,0,436000,741000,-305000,-305000,2021-06-09
9911,086573,聯茂元大09購01,0,0,0,0,0,0,0,0,0,-305000,0,0,0,55000,360000,-305000,-305000,2021-06-09
9912,033811,國泰金元富0B購02,0,0,0,0,0,0,0,0,0,-305000,0,0,0,7000,312000,-305000,-305000,2021-06-09
9913,034377,台玻元大12購02,0,0,0,0,0,0,0,0,0,-305000,0,0,0,173000,478000,-305000,-305000,2021-06-09
9914,3027,盛達,121000,426000,-305000,0,0,0,0,0,0,0,0,0,0,0,0,0,-305000,2021-06-09
9915,087123,南電元大09購06,0,0,0,0,0,0,0,0,0,-306000,0,0,0,164000,470000,-306000,-306000,2021-06-09
9916,032383,聯電統一0C購04,0,0,0,0,0,0,0,0,0,-306000,0,0,0,1000,307000,-306000,-306000,2021-06-09
9917,088107,儒鴻富邦0A購01,0,0,0,0,0,0,0,0,0,-307000,0,0,0,30000,337000,-307000,-307000,2021-06-09
9918,2461,光群雷,178000,485000,-307000,0,0,0,0,0,0,0,0,0,0,0,0,0,-307000,2021-06-09
9919,6176,瑞儀,390000,638476,-248476,0,0,0,0,166000,-166000,107000,75000,2000,73000,39000,5000,34000,-307476,2021-06-09
9920,086528,圓展凱基09購01,0,0,0,0,0,0,0,0,0,-308000,0,0,0,2000,310000,-308000,-308000,2021-06-09
9921,084567,凌陽國票08購02,0,0,0,0,0,0,0,0,0,-308000,0,0,0,48000,356000,-308000,-308000,2021-06-09
9922,030424,健鼎元大0A購01,0,0,0,0,0,0,0,0,0,-309000,0,0,0,0,309000,-309000,-309000,2021-06-09
9923,080547,嘉澤統一08購01,0,0,0,0,0,0,0,0,0,-309000,0,0,0,1000,310000,-309000,-309000,2021-06-09
9924,089378,南電元大09購08,0,0,0,0,0,0,0,0,0,-309000,0,0,0,135000,444000,-309000,-309000,2021-06-09
9925,086320,南電凱基09購05,0,0,0,0,0,0,0,0,0,-310000,0,0,0,333000,643000,-310000,-310000,2021-06-09
9926,034871,華東元大0C購01,0,0,0,0,0,0,0,0,0,-310000,0,0,0,663000,973000,-310000,-310000,2021-06-09
9927,081720,創意統一09購06,0,0,0,0,0,0,0,0,0,-310000,0,0,0,0,310000,-310000,-310000,2021-06-09
9928,030979,全新元大0A購03,0,0,0,0,0,0,0,0,0,-311000,0,0,0,61000,372000,-311000,-311000,2021-06-09
9929,085900,南電國票09購02,0,0,0,0,0,0,0,0,0,-312000,0,0,0,48000,360000,-312000,-312000,2021-06-09
9930,033395,聯茂元大0C購01,0,0,0,0,0,0,0,0,0,-312000,0,0,0,72000,384000,-312000,-312000,2021-06-09
9931,082639,聯電富邦09購02,0,0,0,0,0,0,0,0,0,-312000,0,0,0,3000,315000,-312000,-312000,2021-06-09
9932,079243,金像電元大06購04,0,0,0,0,0,0,0,0,0,-312000,0,0,0,91000,403000,-312000,-312000,2021-06-09
9933,069834,欣興元富08購03,0,0,0,0,0,0,0,0,0,-312000,0,0,0,50000,362000,-312000,-312000,2021-06-09
9934,089537,矽創元大09購07,0,0,0,0,0,0,0,0,0,-312000,0,0,0,46000,358000,-312000,-312000,2021-06-09
9935,088958,凌陽國票0A購01,0,0,0,0,0,0,0,0,0,-313000,0,0,0,66000,379000,-313000,-313000,2021-06-09
9936,07308P,大成鋼元富0C售01,0,0,0,0,0,0,0,0,0,-313000,0,0,0,0,313000,-313000,-313000,2021-06-09
9937,1220,台榮,37000,352000,-315000,0,0,0,0,0,0,0,0,0,0,0,0,0,-315000,2021-06-09
9938,034791,愛普國泰11購01,0,0,0,0,0,0,0,0,0,-316000,0,0,0,0,316000,-316000,-316000,2021-06-09
9939,083139,欣興凱基0A購01,0,0,0,0,0,0,0,0,0,-316000,0,0,0,233000,549000,-316000,-316000,2021-06-09
9940,4904,遠傳,730000,940200,-210200,0,0,0,0,96000,-96000,-10000,0,10000,-10000,0,0,0,-316200,2021-06-09
9941,6239,力成,1333000,1507398,-174398,0,0,0,3000,141000,-138000,-4000,5000,5000,0,1000,5000,-4000,-316398,2021-06-09
9942,035242,國巨群益0B購06,0,0,0,0,0,0,0,0,0,-318000,0,0,0,0,318000,-318000,-318000,2021-06-09
9943,1701,中化,90000,380000,-290000,0,0,0,0,0,0,-29000,0,0,0,0,29000,-29000,-319000,2021-06-09
9944,088078,聯詠統一0B購06,0,0,0,0,0,0,0,0,0,-320000,0,0,0,233000,553000,-320000,-320000,2021-06-09
9945,085959,光罩凱基08購02,0,0,0,0,0,0,0,0,0,-320000,0,0,0,115000,435000,-320000,-320000,2021-06-09
9946,031696,台化永豐0A購01,0,0,0,0,0,0,0,0,0,-320000,0,0,0,0,320000,-320000,-320000,2021-06-09
9947,033838,TPK國泰11購01,0,0,0,0,0,0,0,0,0,-320000,0,0,0,10000,330000,-320000,-320000,2021-06-09
9948,082551,臺股指凱基0C購05,0,0,0,0,0,0,0,0,0,-320000,0,0,0,1000,321000,-320000,-320000,2021-06-09
9949,074184,啟碁元富0A購01,0,0,0,0,0,0,0,0,0,-320000,0,0,0,0,320000,-320000,-320000,2021-06-09
9950,086442,友達永豐09購02,0,0,0,0,0,0,0,0,0,-321000,0,0,0,44000,365000,-321000,-321000,2021-06-09
9951,034545,國泰金統一0B購04,0,0,0,0,0,0,0,0,0,-321000,0,0,0,0,321000,-321000,-321000,2021-06-09
9952,06716P,南電中信0B售02,0,0,0,0,0,0,0,0,0,-321000,0,0,0,22000,343000,-321000,-321000,2021-06-09
9953,089372,立積元大09購08,0,0,0,0,0,0,0,0,0,-322000,0,0,0,87000,409000,-322000,-322000,2021-06-09
9954,031710,宏達電永豐0A購01,0,0,0,0,0,0,0,0,0,-323000,0,0,0,105000,428000,-323000,-323000,2021-06-09
9955,034994,世紀鋼群益0C購02,0,0,0,0,0,0,0,0,0,-323000,0,0,0,32000,355000,-323000,-323000,2021-06-09
9956,082692,力山凱基08購01,0,0,0,0,0,0,0,0,0,-323000,0,0,0,479000,802000,-323000,-323000,2021-06-09
9957,031973,新唐元大11購01,0,0,0,0,0,0,0,0,0,-326000,0,0,0,79000,405000,-326000,-326000,2021-06-09
9958,032547,群創凱基0A購09,0,0,0,0,0,0,0,0,0,-327000,0,0,0,24000,351000,-327000,-327000,2021-06-09
9959,030013,聯發科元富11購08,0,0,0,0,0,0,0,0,0,-329000,0,0,0,0,329000,-329000,-329000,2021-06-09
9960,034519,允強元富0B購01,0,0,0,0,0,0,0,0,0,-330000,0,0,0,0,330000,-330000,-330000,2021-06-09
9961,033821,友達統一15購04,0,0,0,0,0,0,0,0,0,-330000,0,0,0,620000,950000,-330000,-330000,2021-06-09
9962,04320P,奇鋐元富0A售01,0,0,0,0,0,0,0,0,0,-330000,0,0,0,180000,510000,-330000,-330000,2021-06-09
9963,2013,中鋼構,79000,396000,-317000,0,0,0,0,0,0,-13772,4000,3772,228,0,14000,-14000,-330772,2021-06-09
9964,030407,超豐元大0A購02,0,3000,-3000,0,0,0,0,0,0,-328000,0,0,0,636000,964000,-328000,-331000,2021-06-09
9965,030399,矽統元大0A購01,0,0,0,0,0,0,0,0,0,-332000,0,0,0,272000,604000,-332000,-332000,2021-06-09
9966,030794,威盛凱基0B購01,0,0,0,0,0,0,0,0,0,-332000,0,0,0,5000,337000,-332000,-332000,2021-06-09
9967,2379,瑞昱,568812,1095140,-526328,0,0,0,240000,17000,223000,-29000,35000,56000,-21000,0,8000,-8000,-332328,2021-06-09
9968,087759,光磊富邦0B購01,0,0,0,0,0,0,0,0,0,-333000,0,0,0,34000,367000,-333000,-333000,2021-06-09
9969,030098,盟立永豐0A購02,0,0,0,0,0,0,0,0,0,-333000,0,0,0,0,333000,-333000,-333000,2021-06-09
9970,034865,上緯控元大11購01,0,0,0,0,0,0,0,0,0,-333000,0,0,0,21000,354000,-333000,-333000,2021-06-09
9971,2405,浩鑫,100000,433000,-333000,0,0,0,0,0,0,0,0,0,0,0,0,0,-333000,2021-06-09
9972,083230,臻鼎國泰09購01,0,0,0,0,0,0,0,0,0,-334000,0,0,0,100000,434000,-334000,-334000,2021-06-09
9973,06676P,南電群益09售04,0,0,0,0,0,0,0,0,0,-334000,0,0,0,44000,378000,-334000,-334000,2021-06-09
9974,07096P,東鋼凱基0B售07,0,0,0,0,0,0,0,0,0,-334000,0,0,0,3000,337000,-334000,-334000,2021-06-09
9975,3045,台灣大,564547,782831,-218284,0,0,0,0,76000,-76000,-40000,0,40000,-40000,0,0,0,-334284,2021-06-09
9976,087554,松翰元富09購01,0,0,0,0,0,0,0,0,0,-335000,0,0,0,0,335000,-335000,-335000,2021-06-09
9977,6215,和椿,30000,365000,-335000,0,0,0,0,0,0,0,0,0,0,0,0,0,-335000,2021-06-09
9978,030397,台積電元大0A購07,0,0,0,0,0,0,0,0,0,-336000,0,0,0,11000,347000,-336000,-336000,2021-06-09
9979,032156,華東凱基0A購01,0,0,0,0,0,0,0,0,0,-336000,0,0,0,30000,366000,-336000,-336000,2021-06-09
9980,077484,世紀鋼國票07購02,0,0,0,0,0,0,0,0,0,-336000,0,0,0,0,336000,-336000,-336000,2021-06-09
9981,085586,松翰兆豐08購01,0,0,0,0,0,0,0,0,0,-337000,0,0,0,0,337000,-337000,-337000,2021-06-09
9982,030733,凌陽元大0A購01,0,0,0,0,0,0,0,0,0,-337000,0,0,0,46000,383000,-337000,-337000,2021-06-09
9983,035382,嘉澤凱基0B購01,0,0,0,0,0,0,0,0,0,-337000,0,0,0,53000,390000,-337000,-337000,2021-06-09
9984,1710,東聯,467000,583000,-116000,0,0,0,0,0,0,-221000,0,0,0,26000,247000,-221000,-337000,2021-06-09
9985,083491,台積電元富11購01,0,0,0,0,0,0,0,0,0,-338000,0,0,0,0,338000,-338000,-338000,2021-06-09
9986,2345,智邦,782203,1147480,-365277,0,0,0,40000,18000,22000,4990,11000,11010,-10,14000,9000,5000,-338287,2021-06-09
9987,031338,聯陽元大0A購02,0,0,0,0,0,0,0,0,0,-339000,0,0,0,493000,832000,-339000,-339000,2021-06-09
9988,032861,宏達電群益0B購01,0,0,0,0,0,0,0,0,0,-340000,0,0,0,16000,356000,-340000,-340000,2021-06-09
9989,081959,愛普統一0A購01,0,0,0,0,0,0,0,0,0,-340000,0,0,0,0,340000,-340000,-340000,2021-06-09
9990,2387,精元,43000,363000,-320000,0,0,0,0,0,0,-20000,0,0,0,0,20000,-20000,-340000,2021-06-09
9991,087784,光磊永豐09購01,0,0,0,0,0,0,0,0,0,-341000,0,0,0,224000,565000,-341000,-341000,2021-06-09
9992,8110,華東,1053000,1444000,-391000,0,0,0,0,0,0,50000,0,0,0,65000,15000,50000,-341000,2021-06-09
9993,033266,惠特元大11購01,0,0,0,0,0,0,0,0,0,-342000,0,0,0,60000,402000,-342000,-342000,2021-06-09
9994,034549,矽創統一0C購03,0,0,0,0,0,0,0,0,0,-343000,0,0,0,113000,456000,-343000,-343000,2021-06-09
9995,086574,聯茂元大09購02,0,0,0,0,0,0,0,0,0,-344000,0,0,0,36000,380000,-344000,-344000,2021-06-09
9996,034611,群創統一0B購13,0,0,0,0,0,0,0,0,0,-344000,0,0,0,61000,405000,-344000,-344000,2021-06-09
9997,084333,聯電元大07購25,0,0,0,0,0,0,0,0,0,-345000,0,0,0,350000,695000,-345000,-345000,2021-06-09
9998,07291P,亞德客凱基0C售01,0,0,0,0,0,0,0,0,0,-345000,0,0,0,29000,374000,-345000,-345000,2021-06-09
9999,031601,華新科富邦0C購01,0,0,0,0,0,0,0,0,0,-346000,0,0,0,1000,347000,-346000,-346000,2021-06-09
10000,035694,世紀鋼凱基0B購02,0,0,0,0,0,0,0,0,0,-346000,0,0,0,50000,396000,-346000,-346000,2021-06-09
10001,089453,台積電統一13購02,0,0,0,0,0,0,0,0,0,-347000,0,0,0,73000,420000,-347000,-347000,2021-06-09
10002,3533,嘉澤,516000,249887,266113,0,0,0,3000,580846,-577846,-36227,6000,38000,-32000,5000,9227,-4227,-347960,2021-06-09
10003,030148,松翰凱基0A購04,0,0,0,0,0,0,0,0,0,-348000,0,0,0,2000,350000,-348000,-348000,2021-06-09
10004,2417,圓剛,29000,345000,-316000,0,0,0,0,0,0,-33000,0,0,0,3000,36000,-33000,-349000,2021-06-09
10005,086330,聯電元大09購02,0,0,0,0,0,0,0,0,0,-350000,0,0,0,0,350000,-350000,-350000,2021-06-09
10006,086795,台積電統一09購24,0,0,0,0,0,0,0,0,0,-350000,0,0,0,0,350000,-350000,-350000,2021-06-09
10007,032088,聯成永豐0A購04,0,0,0,0,0,0,0,0,0,-350000,0,0,0,0,350000,-350000,-350000,2021-06-09
10008,035143,長榮統一0C購16,0,0,0,0,0,0,0,0,0,-350000,0,0,0,25000,375000,-350000,-350000,2021-06-09
10009,071450,大立光元富09購05,0,0,0,0,0,0,0,0,0,-350000,0,0,0,0,350000,-350000,-350000,2021-06-09
10010,086152,華邦電元大0B購01,0,0,0,0,0,0,0,0,0,-351000,0,0,0,43000,394000,-351000,-351000,2021-06-09
10011,06475P,南電國泰0B售03,0,0,0,0,0,0,0,0,0,-352000,0,0,0,70000,422000,-352000,-352000,2021-06-09
10012,085512,臺股指凱基09購19,0,0,0,0,0,0,0,0,0,-353000,0,0,0,0,353000,-353000,-353000,2021-06-09
10013,032505,友達永豐0A購06,0,0,0,0,0,0,0,0,0,-354000,0,0,0,254000,608000,-354000,-354000,2021-06-09
10014,035471,緯穎國票0C購03,0,0,0,0,0,0,0,0,0,-354000,0,0,0,0,354000,-354000,-354000,2021-06-09
10015,032061,新唐國票0B購01,0,0,0,0,0,0,0,0,0,-357000,0,0,0,132000,489000,-357000,-357000,2021-06-09
10016,03554P,可成元富08售04,0,0,0,0,0,0,0,0,0,-358000,0,0,0,0,358000,-358000,-358000,2021-06-09
10017,06893P,大成鋼統一0A售01,0,0,0,0,0,0,0,0,0,-358000,0,0,0,5000,363000,-358000,-358000,2021-06-09
10018,079562,長興國票07購01,0,0,0,0,0,0,0,0,0,-358000,0,0,0,180000,538000,-358000,-358000,2021-06-09
10019,3044,健鼎,497000,795368,-298368,0,0,0,0,103000,-103000,41883,1000,2117,-1117,43000,0,43000,-359485,2021-06-09
10020,06718P,群創群益09售11,0,0,0,0,0,0,0,0,0,-360000,0,0,0,0,360000,-360000,-360000,2021-06-09
10021,035778,宏達電富邦0C購01,0,0,0,0,0,0,0,0,0,-361000,0,0,0,23000,384000,-361000,-361000,2021-06-09
10022,3036,文曄,79000,431000,-352000,0,0,0,0,0,0,-9000,0,9000,-9000,0,0,0,-361000,2021-06-09
10023,1474,弘裕,107000,468000,-361000,0,0,0,0,0,0,0,0,0,0,0,0,0,-361000,2021-06-09
10024,1108,幸福,46200,408000,-361800,0,0,0,0,0,0,0,0,0,0,0,0,0,-361800,2021-06-09
10025,031466,晶相光群益0B購02,0,0,0,0,0,0,0,0,0,-362000,0,0,0,0,362000,-362000,-362000,2021-06-09
10026,086332,廣宇元大0B購01,0,0,0,0,0,0,0,0,0,-363000,0,0,0,0,363000,-363000,-363000,2021-06-09
10027,087407,松翰元大09購03,0,0,0,0,0,0,0,0,0,-363000,0,0,0,5000,368000,-363000,-363000,2021-06-09
10028,033598,凌陽兆豐0C購01,0,0,0,0,0,0,0,0,0,-363000,0,0,0,867000,1230000,-363000,-363000,2021-06-09
10029,03747C,聯電富邦13牛01,0,0,0,0,0,0,0,0,0,-363000,0,0,0,0,363000,-363000,-363000,2021-06-09
10030,071236,惠特元富09購01,0,0,0,0,0,0,0,0,0,-363000,0,0,0,31000,394000,-363000,-363000,2021-06-09
10031,088522,金像電國泰0B購01,0,0,0,0,0,0,0,0,0,-364000,0,0,0,10000,374000,-364000,-364000,2021-06-09
10032,089749,全新統一0B購01,0,0,0,0,0,0,0,0,0,-364000,0,0,0,0,364000,-364000,-364000,2021-06-09
10033,9940,信義,208000,502000,-294000,0,0,0,0,0,0,-71000,0,71000,-71000,0,0,0,-365000,2021-06-09
10034,00830,國泰費城半導體,63015,511000,-447985,0,0,0,0,0,0,82000,0,0,0,407000,325000,82000,-365985,2021-06-09
10035,035226,貿聯康和0B購01,0,0,0,0,0,0,0,0,0,-367000,0,0,0,83000,450000,-367000,-367000,2021-06-09
10036,033442,智原元大0B購03,0,0,0,0,0,0,0,0,0,-368000,0,0,0,495000,863000,-368000,-368000,2021-06-09
10037,031127,聯陽統一0C購01,0,0,0,0,0,0,0,0,0,-371000,0,0,0,72000,443000,-371000,-371000,2021-06-09
10038,3035,智原,1892000,2009000,-117000,0,0,0,0,232000,-232000,-22846,60554,69435,-8881,91035,105000,-13965,-371846,2021-06-09
10039,06376P,南電元大09售01,0,0,0,0,0,0,0,0,0,-372000,0,0,0,30000,402000,-372000,-372000,2021-06-09
10040,030315,台達電麥證11購01,0,0,0,38000,411000,-373000,0,0,0,-373000,0,0,0,38000,411000,-373000,-373000,2021-06-09
10041,033523,友達國票0B購03,0,35000,-35000,0,0,0,0,0,0,-338000,0,0,0,265000,603000,-338000,-373000,2021-06-09
10042,076416,台郡統一07購01,0,0,0,0,0,0,0,0,0,-374000,0,0,0,0,374000,-374000,-374000,2021-06-09
10043,033585,技嘉凱基12購01,0,0,0,0,0,0,0,0,0,-377000,0,0,0,171000,548000,-377000,-377000,2021-06-09
10044,030774,凌陽麥證0A購02,0,0,0,216000,596000,-380000,0,0,0,-378000,0,0,0,218000,596000,-378000,-378000,2021-06-09
10045,036376,欣興國票12購01,0,0,0,0,0,0,0,0,0,-378000,0,0,0,344000,722000,-378000,-378000,2021-06-09
10046,086677,微星統一0B購03,0,0,0,0,0,0,0,0,0,-379000,0,0,0,0,379000,-379000,-379000,2021-06-09
10047,2911,麗嬰房,287000,666000,-379000,0,0,0,0,0,0,0,0,0,0,0,0,0,-379000,2021-06-09
10048,088132,嘉威凱基09購01,0,0,0,0,0,0,0,0,0,-380000,0,0,0,20000,400000,-380000,-380000,2021-06-09
10049,036319,長榮航統一12購02,0,0,0,0,0,0,0,0,0,-380000,0,0,0,26000,406000,-380000,-380000,2021-06-09
10050,083123,鴻海凱基0A購08,0,0,0,0,0,0,0,0,0,-380000,0,0,0,0,380000,-380000,-380000,2021-06-09
10051,089409,大立光凱基12購01,0,0,0,0,0,0,0,0,0,-380000,0,0,0,290000,670000,-380000,-380000,2021-06-09
10052,031333,全新元大0C購01,0,0,0,0,0,0,0,0,0,-381000,0,0,0,43000,424000,-381000,-381000,2021-06-09
10053,089025,立積元大11購01,0,0,0,0,0,0,0,0,0,-382000,0,0,0,20000,402000,-382000,-382000,2021-06-09
10054,034395,台郡元大0C購03,0,0,0,0,0,0,0,0,0,-383000,0,0,0,139000,522000,-383000,-383000,2021-06-09
10055,032972,聯陽元大0A購03,0,0,0,0,0,0,0,0,0,-384000,0,0,0,477000,861000,-384000,-384000,2021-06-09
10056,089704,凌陽元富09購02,0,0,0,0,0,0,0,0,0,-384000,0,0,0,30000,414000,-384000,-384000,2021-06-09
10057,075972,健策統一07購01,0,0,0,0,0,0,0,0,0,-387000,0,0,0,383000,770000,-387000,-387000,2021-06-09
10058,2380,虹光,128000,516000,-388000,0,0,0,0,0,0,0,0,0,0,0,0,0,-388000,2021-06-09
10059,03739C,鴻海富邦0C牛01,0,0,0,0,0,0,0,0,0,-389000,0,0,0,15000,404000,-389000,-389000,2021-06-09
10060,030151,臺股指凱基11購04,0,0,0,0,0,0,0,0,0,-390000,0,0,0,380000,770000,-390000,-390000,2021-06-09
10061,034618,廣宇元富12購02,0,0,0,0,0,0,0,0,0,-390000,0,0,0,60000,450000,-390000,-390000,2021-06-09
10062,035611,T50反1國票0C購02,0,0,0,0,0,0,0,0,0,-390000,0,0,0,10000,400000,-390000,-390000,2021-06-09
10063,085509,南電凱基09購04,0,0,0,0,0,0,0,0,0,-391000,0,0,0,99000,490000,-391000,-391000,2021-06-09
10064,030633,惠特元大0A購02,0,0,0,0,0,0,0,0,0,-391000,0,0,0,0,391000,-391000,-391000,2021-06-09
10065,03760C,中鋼富邦13牛02,0,0,0,0,0,0,0,0,0,-391000,0,0,0,132000,523000,-391000,-391000,2021-06-09
10066,031623,聯電統一0C購03,0,0,0,0,0,0,0,0,0,-393000,0,0,0,161000,554000,-393000,-393000,2021-06-09
10067,035904,強茂群益11購01,0,0,0,0,0,0,0,0,0,-393000,0,0,0,117000,510000,-393000,-393000,2021-06-09
10068,030875,致新永豐0A購02,0,0,0,0,0,0,0,0,0,-394000,0,0,0,21000,415000,-394000,-394000,2021-06-09
10069,4958,臻鼎-KY,909000,1284899,-375899,0,0,0,3000,22000,-19000,552,1000,6449,-5449,15000,8999,6001,-394347,2021-06-09
10070,034449,聯詠國泰11購02,0,0,0,0,0,0,0,0,0,-396000,0,0,0,843000,1239000,-396000,-396000,2021-06-09
10071,083615,T50反1凱基09購04,0,0,0,0,0,0,0,0,0,-397000,0,0,0,1347000,1744000,-397000,-397000,2021-06-09
10072,035768,樺漢元富13購01,0,0,0,0,0,0,0,0,0,-397000,0,0,0,15000,412000,-397000,-397000,2021-06-09
10073,032683,台泥國泰0C購01,0,0,0,0,0,0,0,0,0,-398000,0,0,0,0,398000,-398000,-398000,2021-06-09
10074,06789P,群創凱基0A售03,0,0,0,0,0,0,0,0,0,-398000,0,0,0,71000,469000,-398000,-398000,2021-06-09
10075,089995,日月光國泰11購01,0,0,0,0,0,0,0,0,0,-398000,0,0,0,0,398000,-398000,-398000,2021-06-09
10076,086925,精成科兆豐09購01,0,0,0,0,0,0,0,0,0,-399000,0,0,0,23000,422000,-399000,-399000,2021-06-09
10077,06669P,南亞科凱基09售03,0,0,0,0,0,0,0,0,0,-399000,0,0,0,31000,430000,-399000,-399000,2021-06-09
10078,079214,聯電凱基0A購02,0,0,0,0,0,0,0,0,0,-399000,0,0,0,98000,497000,-399000,-399000,2021-06-09
10079,085072,鴻海永豐08購04,0,0,0,0,0,0,0,0,0,-400000,0,0,0,0,400000,-400000,-400000,2021-06-09
10080,05628P,A50正2元富06售02,0,0,0,0,0,0,0,0,0,-400000,0,0,0,0,400000,-400000,-400000,2021-06-09
10081,031964,宏達電元大0B購03,0,0,0,0,0,0,0,0,0,-400000,0,0,0,0,400000,-400000,-400000,2021-06-09
10082,035794,技嘉永豐0B購02,0,0,0,0,0,0,0,0,0,-400000,0,0,0,0,400000,-400000,-400000,2021-06-09
10083,036515,世紀鋼凱基12購01,0,0,0,0,0,0,0,0,0,-400000,0,0,0,0,400000,-400000,-400000,2021-06-09
10084,082590,台達電元大07購06,0,0,0,0,0,0,0,0,0,-400000,0,0,0,0,400000,-400000,-400000,2021-06-09
10085,075935,順德國票07購01,0,0,0,0,0,0,0,0,0,-400000,0,0,0,115000,515000,-400000,-400000,2021-06-09
10086,083401,臺股指日盛09購01,0,0,0,0,0,0,0,0,0,-400000,0,0,0,300000,700000,-400000,-400000,2021-06-09
10087,086103,精成科永豐08購01,0,0,0,0,0,0,0,0,0,-401000,0,0,0,97000,498000,-401000,-401000,2021-06-09
10088,083599,強茂國泰09購01,0,0,0,0,0,0,0,0,0,-401000,0,0,0,2000,403000,-401000,-401000,2021-06-09
10089,033022,宏達電中信0C購01,0,0,0,0,0,0,0,0,0,-401000,0,0,0,0,401000,-401000,-401000,2021-06-09
10090,036104,致新元大11購01,0,0,0,0,0,0,0,0,0,-401000,0,0,0,0,401000,-401000,-401000,2021-06-09
10091,034251,華邦電統一11購01,0,0,0,0,0,0,0,0,0,-402000,0,0,0,30000,432000,-402000,-402000,2021-06-09
10092,030537,圓剛凱基0A購01,0,0,0,0,0,0,0,0,0,-403000,0,0,0,0,403000,-403000,-403000,2021-06-09
10093,035055,聯電國泰11購03,0,0,0,0,0,0,0,0,0,-403000,0,0,0,185000,588000,-403000,-403000,2021-06-09
10094,3042,晶技,1259300,975000,284300,0,0,0,20000,658000,-638000,-49467,64000,92467,-28467,37000,58000,-21000,-403167,2021-06-09
10095,086407,景碩統一0B購01,0,0,0,0,0,0,0,0,0,-404000,0,0,0,705000,1109000,-404000,-404000,2021-06-09
10096,035093,長榮凱基11購05,0,0,0,0,0,0,0,0,0,-404000,0,0,0,492000,896000,-404000,-404000,2021-06-09
10097,2020,美亞,603000,1037000,-434000,0,0,0,0,0,0,30000,30000,0,30000,0,0,0,-404000,2021-06-09
10098,034348,威盛元富12購01,0,0,0,0,0,0,0,0,0,-407000,0,0,0,24000,431000,-407000,-407000,2021-06-09
10099,088812,偉詮電元大0B購01,0,0,0,0,0,0,0,0,0,-409000,0,0,0,203000,612000,-409000,-409000,2021-06-09
10100,031722,宏達電群益0C購03,0,0,0,0,0,0,0,0,0,-409000,0,0,0,82000,491000,-409000,-409000,2021-06-09
10101,088856,矽統永豐09購01,0,0,0,0,0,0,0,0,0,-410000,0,0,0,0,410000,-410000,-410000,2021-06-09
10102,035836,技嘉元大11購03,0,0,0,0,0,0,0,0,0,-410000,0,0,0,219000,629000,-410000,-410000,2021-06-09
10103,033910,南電統一11購02,0,0,0,0,0,0,0,0,0,-411000,0,0,0,1099000,1510000,-411000,-411000,2021-06-09
10104,033755,力山凱基0B購02,0,0,0,0,0,0,0,0,0,-411000,0,0,0,100000,511000,-411000,-411000,2021-06-09
10105,036266,群光群益0C購01,0,0,0,0,0,0,0,0,0,-413000,0,0,0,0,413000,-413000,-413000,2021-06-09
10106,035667,南亞科統一0C購05,0,0,0,0,0,0,0,0,0,-413000,0,0,0,20000,433000,-413000,-413000,2021-06-09
10107,031706,三陽永豐0A購01,0,0,0,0,0,0,0,0,0,-415000,0,0,0,0,415000,-415000,-415000,2021-06-09
10108,033565,技嘉永豐0B購01,0,0,0,0,0,0,0,0,0,-416000,0,0,0,0,416000,-416000,-416000,2021-06-09
10109,030167,鼎元國泰0C購01,0,0,0,0,0,0,0,0,0,-416000,0,0,0,0,416000,-416000,-416000,2021-06-09
10110,034874,恆大國泰11購01,0,0,0,0,0,0,0,0,0,-417000,0,0,0,0,417000,-417000,-417000,2021-06-09
10111,1417,嘉裕,109000,526000,-417000,0,0,0,0,0,0,0,0,0,0,0,0,0,-417000,2021-06-09
10112,033126,台揚元大0C購01,0,0,0,0,0,0,0,0,0,-418000,0,0,0,82000,500000,-418000,-418000,2021-06-09
10113,033602,中石化群益0C購01,0,0,0,0,0,0,0,0,0,-419000,0,0,0,50000,469000,-419000,-419000,2021-06-09
10114,033504,欣興統一11購01,0,0,0,0,0,0,0,0,0,-419000,0,0,0,1426000,1845000,-419000,-419000,2021-06-09
10115,036166,同欣電元富11購01,0,0,0,0,0,0,0,0,0,-420000,0,0,0,0,420000,-420000,-420000,2021-06-09
10116,078739,圓剛元富09購03,0,0,0,0,0,0,0,0,0,-420000,0,0,0,0,420000,-420000,-420000,2021-06-09
10117,079896,全新國票09購01,0,0,0,0,0,0,0,0,0,-420000,0,0,0,0,420000,-420000,-420000,2021-06-09
10118,081345,T50反1凱基11購01,0,0,0,0,0,0,0,0,0,-420000,0,0,0,0,420000,-420000,-420000,2021-06-09
10119,033382,台揚元大0B購02,0,0,0,0,0,0,0,0,0,-422000,0,0,0,98000,520000,-422000,-422000,2021-06-09
10120,034650,國光生國泰11購01,0,0,0,0,0,0,0,0,0,-422000,0,0,0,86000,508000,-422000,-422000,2021-06-09
10121,035926,緯穎元富0C購01,0,0,0,0,0,0,0,0,0,-422000,0,0,0,0,422000,-422000,-422000,2021-06-09
10122,030981,宏達電元大0B購02,0,0,0,0,0,0,0,0,0,-424000,0,0,0,65000,489000,-424000,-424000,2021-06-09
10123,07300P,儒鴻群益0C售01,0,0,0,0,0,0,0,0,0,-424000,0,0,0,0,424000,-424000,-424000,2021-06-09
10124,034639,聚鼎元大0B購01,0,0,0,0,0,0,0,0,0,-425000,0,0,0,197000,622000,-425000,-425000,2021-06-09
10125,083051,台光電兆豐07購01,0,0,0,0,0,0,0,0,0,-425000,0,0,0,38000,463000,-425000,-425000,2021-06-09
10126,033383,矽統元大0B購03,0,0,0,0,0,0,0,0,0,-426000,0,0,0,94000,520000,-426000,-426000,2021-06-09
10127,032330,東鋼群益0B購03,0,0,0,0,0,0,0,0,0,-428000,0,0,0,123000,551000,-428000,-428000,2021-06-09
10128,8215,明基材,219000,598000,-379000,0,0,0,0,0,0,-49144,0,0,0,7000,56144,-49144,-428144,2021-06-09
10129,9904,寶成,3010000,3093864,-83864,0,0,0,0,0,0,-345000,0,18000,-18000,2000,329000,-327000,-428864,2021-06-09
10130,030830,友達中信0A購06,0,0,0,0,0,0,0,0,0,-429000,0,0,0,0,429000,-429000,-429000,2021-06-09
10131,085428,南電元大08購05,0,0,0,0,0,0,0,0,0,-430000,0,0,0,16000,446000,-430000,-430000,2021-06-09
10132,030983,國揚元大0A購03,0,0,0,0,0,0,0,0,0,-430000,0,0,0,0,430000,-430000,-430000,2021-06-09
10133,036308,新纖統一12購01,0,0,0,0,0,0,0,0,0,-430000,0,0,0,0,430000,-430000,-430000,2021-06-09
10134,078274,宏達電國票08購01,0,0,0,0,0,0,0,0,0,-430000,0,0,0,88000,518000,-430000,-430000,2021-06-09
10135,034635,技嘉元大0B購02,0,0,0,0,0,0,0,0,0,-431000,0,0,0,324000,755000,-431000,-431000,2021-06-09
10136,089414,松翰凱基0A購03,0,0,0,0,0,0,0,0,0,-431000,0,0,0,0,431000,-431000,-431000,2021-06-09
10137,2611,志信,303000,737000,-434000,0,0,0,0,0,0,30,30,0,30,0,0,0,-433970,2021-06-09
10138,083928,聯電中信09購02,0,0,0,0,0,0,0,0,0,-434000,0,0,0,100000,534000,-434000,-434000,2021-06-09
10139,031971,新唐元大0A購02,3000,0,3000,0,0,0,0,0,0,-437000,0,0,0,73000,510000,-437000,-434000,2021-06-09
10140,2015,豐興,56000,487708,-431708,0,0,0,0,0,0,-2351,0,2351,-2351,0,0,0,-434059,2021-06-09
10141,031420,聯電凱基14購01,0,10000,-10000,0,0,0,0,0,0,-425000,0,0,0,601000,1026000,-425000,-435000,2021-06-09
10142,087295,松翰元大0A購01,0,0,0,0,0,0,0,0,0,-437000,0,0,0,52000,489000,-437000,-437000,2021-06-09
10143,031785,國喬國票0B購01,0,0,0,0,0,0,0,0,0,-438000,0,0,0,277000,715000,-438000,-438000,2021-06-09
10144,06740P,臺股指凱基0C售19,0,0,0,0,0,0,0,0,0,-438000,0,0,0,103000,541000,-438000,-438000,2021-06-09
10145,035064,技嘉中信0B購02,0,0,0,0,0,0,0,0,0,-439000,0,0,0,0,439000,-439000,-439000,2021-06-09
10146,074423,世紀鋼元大07購03,0,0,0,0,0,0,0,0,0,-440000,0,0,0,0,440000,-440000,-440000,2021-06-09
10147,00850,元大臺灣ESG永續,9000,6000,3000,0,0,0,0,0,0,-443278,0,0,0,87000,530278,-443278,-440278,2021-06-09
10148,1216,統一,2782655,3206546,-423891,0,0,0,0,6000,-6000,-11362,0,16362,-16362,14000,9000,5000,-441253,2021-06-09
10149,033635,新唐元富0B購01,0,0,0,0,0,0,0,0,0,-442000,0,0,0,533000,975000,-442000,-442000,2021-06-09
10150,2492,華新科,758100,1199291,-441191,0,0,0,2000,12000,-10000,7158,5000,5842,-842,21000,13000,8000,-444033,2021-06-09
10151,083740,聯發科國票07購07,0,0,0,0,0,0,0,0,0,-446000,0,0,0,0,446000,-446000,-446000,2021-06-09
10152,085875,松翰元富0B購01,0,0,0,0,0,0,0,0,0,-446000,0,0,0,0,446000,-446000,-446000,2021-06-09
10153,00757,統一FANG+,0,0,0,0,0,0,0,0,0,-446199,0,0,0,143000,589199,-446199,-446199,2021-06-09
10154,035640,愛普富邦0C購01,0,0,0,0,0,0,0,0,0,-447000,0,0,0,16000,463000,-447000,-447000,2021-06-09
10155,07002P,欣興元大0B售01,0,0,0,0,0,0,0,0,0,-447000,0,0,0,292000,739000,-447000,-447000,2021-06-09
10156,080399,全新元大08購01,0,0,0,0,0,0,0,0,0,-447000,0,0,0,32000,479000,-447000,-447000,2021-06-09
10157,032854,聯電群益0B購08,0,0,0,0,0,0,0,0,0,-448000,0,0,0,173000,621000,-448000,-448000,2021-06-09
10158,035993,聯詠國泰12購01,0,0,0,0,0,0,0,0,0,-448000,0,0,0,33000,481000,-448000,-448000,2021-06-09
10159,07284P,健策凱基0C售02,0,0,0,0,0,0,0,0,0,-448000,0,0,0,228000,676000,-448000,-448000,2021-06-09
10160,2727,王品,59200,501150,-441950,0,0,0,0,0,0,-7000,0,0,0,1000,8000,-7000,-448950,2021-06-09
10161,076675,台積電凱基09購01,0,0,0,0,0,0,0,0,0,-450000,0,0,0,0,450000,-450000,-450000,2021-06-09
10162,068533,台郡元富07購03,0,0,0,0,0,0,0,0,0,-450000,0,0,0,0,450000,-450000,-450000,2021-06-09
10163,081857,台達電中信08購01,0,0,0,0,0,0,0,0,0,-450000,0,0,0,0,450000,-450000,-450000,2021-06-09
10164,3005,神基,299000,844608,-545608,0,0,0,0,0,0,95000,50000,2000,48000,49000,2000,47000,-450608,2021-06-09
10165,086382,聯陽國票0A購01,0,0,0,0,0,0,0,0,0,-453000,0,0,0,0,453000,-453000,-453000,2021-06-09
10166,033338,台橡永豐0B購01,0,0,0,0,0,0,0,0,0,-454000,0,0,0,215000,669000,-454000,-454000,2021-06-09
10167,032721,友達元富0A購06,0,0,0,0,0,0,0,0,0,-455000,0,0,0,32000,487000,-455000,-455000,2021-06-09
10168,035213,萬海中信11購01,0,0,0,0,0,0,0,0,0,-455000,0,0,0,0,455000,-455000,-455000,2021-06-09
10169,033476,元翎凱基0C購01,0,0,0,0,0,0,0,0,0,-456000,0,0,0,20000,476000,-456000,-456000,2021-06-09
10170,6541,泰福-KY,46000,502000,-456000,0,0,0,0,0,0,0,0,0,0,0,0,0,-456000,2021-06-09
10171,033945,中鋼國票0C購02,0,0,0,0,0,0,0,0,0,-458000,0,0,0,48000,506000,-458000,-458000,2021-06-09
10172,036123,群創群益12購03,0,0,0,0,0,0,0,0,0,-460000,0,0,0,500000,960000,-460000,-460000,2021-06-09
10173,083899,順德元大07購06,0,0,0,0,0,0,0,0,0,-463000,0,0,0,379000,842000,-463000,-463000,2021-06-09
10174,086966,滬深2X統一0B購01,0,0,0,0,0,0,0,0,0,-463000,0,0,0,13000,476000,-463000,-463000,2021-06-09
10175,034807,世紀鋼凱基0C購01,0,0,0,0,0,0,0,0,0,-464000,0,0,0,0,464000,-464000,-464000,2021-06-09
10176,032697,群創永豐0A購10,0,0,0,0,0,0,0,0,0,-466000,0,0,0,0,466000,-466000,-466000,2021-06-09
10177,078463,聯電統一07購03,0,0,0,0,0,0,0,0,0,-469000,0,0,0,118000,587000,-469000,-469000,2021-06-09
10178,032283,華夏中信0A購01,0,0,0,0,0,0,0,0,0,-470000,0,0,0,0,470000,-470000,-470000,2021-06-09
10179,030841,強茂兆豐0B購01,0,0,0,0,0,0,0,0,0,-471000,0,0,0,210000,681000,-471000,-471000,2021-06-09
10180,085787,台光電元大09購01,0,0,0,0,0,0,0,0,0,-472000,0,0,0,778000,1250000,-472000,-472000,2021-06-09
10181,082489,華邦電統一09購05,0,0,0,0,0,0,0,0,0,-472000,0,0,0,22000,494000,-472000,-472000,2021-06-09
10182,035665,旺宏統一0C購01,0,0,0,0,0,0,0,0,0,-473000,0,0,0,26000,499000,-473000,-473000,2021-06-09
10183,033132,矽統元大0C購01,0,0,0,0,0,0,0,0,0,-474000,0,0,0,402000,876000,-474000,-474000,2021-06-09
10184,088826,精成科元大09購04,0,0,0,0,0,0,0,0,0,-477000,0,0,0,139000,616000,-477000,-477000,2021-06-09
10185,081984,強茂元大0A購01,0,0,0,0,0,0,0,0,0,-477000,0,0,0,168000,645000,-477000,-477000,2021-06-09
10186,06553P,台灣50群益0A售05,0,0,0,0,0,0,0,0,0,-477000,0,0,0,75000,552000,-477000,-477000,2021-06-09
10187,00683L,期元大美元指正2,0,3000,-3000,0,0,0,0,0,0,-475000,20000,0,20000,131000,626000,-495000,-478000,2021-06-09
10188,085343,松翰中信08購01,0,0,0,0,0,0,0,0,0,-479000,0,0,0,0,479000,-479000,-479000,2021-06-09
10189,086853,南電元大09購04,0,0,0,0,0,0,0,0,0,-482000,0,0,0,210000,692000,-482000,-482000,2021-06-09
10190,2845,遠東銀,14000,497000,-483000,0,0,0,0,0,0,0,0,0,0,0,0,0,-483000,2021-06-09
10191,030042,台積電元大0A購05,0,0,0,0,0,0,0,0,0,-485000,0,0,0,171000,656000,-485000,-485000,2021-06-09
10192,035518,華晶科永豐0B購01,0,0,0,0,0,0,0,0,0,-486000,0,0,0,60000,546000,-486000,-486000,2021-06-09
10193,06899P,中鋼元大0A售08,0,0,0,0,0,0,0,0,0,-486000,0,0,0,102000,588000,-486000,-486000,2021-06-09
10194,1476,儒鴻,619100,1021953,-402853,0,0,0,12000,112000,-100000,16300,24000,15700,8300,10000,2000,8000,-486553,2021-06-09
10195,030736,南亞科元大11購02,0,0,0,0,0,0,0,0,0,-487000,0,0,0,0,487000,-487000,-487000,2021-06-09
10196,035394,泰豐永豐0B購01,0,0,0,0,0,0,0,0,0,-487000,0,0,0,469000,956000,-487000,-487000,2021-06-09
10197,8213,志超,136000,734000,-598000,0,0,0,0,0,0,110000,90000,0,90000,23000,3000,20000,-488000,2021-06-09
10198,033692,華擎元大0B購02,0,0,0,0,0,0,0,0,0,-489000,0,0,0,0,489000,-489000,-489000,2021-06-09
10199,033832,華邦電國泰11購01,0,0,0,0,0,0,0,0,0,-489000,0,0,0,6000,495000,-489000,-489000,2021-06-09
10200,081954,祥碩統一09購02,0,0,0,0,0,0,0,0,0,-490000,0,0,0,100000,590000,-490000,-490000,2021-06-09
10201,085114,光磊元大08購01,0,0,0,0,0,0,0,0,0,-491000,0,0,0,30000,521000,-491000,-491000,2021-06-09
10202,087014,國喬永豐09購01,0,0,0,0,0,0,0,0,0,-492000,0,0,0,130000,622000,-492000,-492000,2021-06-09
10203,06948P,大成鋼凱基0A售04,0,0,0,0,0,0,0,0,0,-494000,0,0,0,0,494000,-494000,-494000,2021-06-09
10204,07190P,長榮國票12售04,0,0,0,0,0,0,0,0,0,-494000,0,0,0,217000,711000,-494000,-494000,2021-06-09
10205,082831,愛普元大07購08,0,0,0,0,0,0,0,0,0,-495000,0,0,0,0,495000,-495000,-495000,2021-06-09
10206,2406,國碩,117000,614000,-497000,0,0,0,0,0,0,-82,0,82,-82,0,0,0,-497082,2021-06-09
10207,084700,凌陽統一0A購02,0,0,0,0,0,0,0,0,0,-498000,0,0,0,847000,1345000,-498000,-498000,2021-06-09
10208,085975,松翰凱基08購02,0,0,0,0,0,0,0,0,0,-499000,0,0,0,60000,559000,-499000,-499000,2021-06-09
10209,035894,台玻國泰12購01,0,0,0,0,0,0,0,0,0,-499000,0,0,0,0,499000,-499000,-499000,2021-06-09
10210,07249P,南電凱基0B售03,0,0,0,0,0,0,0,0,0,-499000,0,0,0,0,499000,-499000,-499000,2021-06-09
10211,1477,聚陽,784177,489468,294709,0,0,0,33000,493000,-460000,-334002,54000,391002,-337002,6000,3000,3000,-499293,2021-06-09
10212,033138,新光金元大13購01,0,0,0,0,0,0,0,0,0,-500000,0,0,0,0,500000,-500000,-500000,2021-06-09
10213,074352,大立光統一07購02,0,0,0,0,0,0,0,0,0,-500000,0,0,0,0,500000,-500000,-500000,2021-06-09
10214,030037,岱宇元大0A購01,0,0,0,0,0,0,0,0,0,-501000,0,0,0,0,501000,-501000,-501000,2021-06-09
10215,00710B,FH彭博高收益債,14000,498000,-484000,0,0,0,0,0,0,-19278,0,0,0,0,19278,-19278,-503278,2021-06-09
10216,085008,滬深2X元大08購10,0,0,0,0,0,0,0,0,0,-510000,0,0,0,0,510000,-510000,-510000,2021-06-09
10217,088825,精成科元大09購03,0,0,0,0,0,0,0,0,0,-510000,0,0,0,137000,647000,-510000,-510000,2021-06-09
10218,086709,微星元大09購02,0,0,0,0,0,0,0,0,0,-511000,0,0,0,207000,718000,-511000,-511000,2021-06-09
10219,086497,南電元富09購05,0,0,0,0,0,0,0,0,0,-511000,0,0,0,193000,704000,-511000,-511000,2021-06-09
10220,035819,京鼎兆豐11購01,0,0,0,0,0,0,0,0,0,-511000,0,0,0,0,511000,-511000,-511000,2021-06-09
10221,033816,聯電統一15購03,0,0,0,0,0,0,0,0,0,-514000,0,0,0,20000,534000,-514000,-514000,2021-06-09
10222,031914,宏達電永豐0A購02,0,0,0,0,0,0,0,0,0,-516000,0,0,0,149000,665000,-516000,-516000,2021-06-09
10223,089765,長興凱基11購01,0,0,0,0,0,0,0,0,0,-516000,0,0,0,34000,550000,-516000,-516000,2021-06-09
10224,033498,長榮航統一15購01,0,0,0,0,0,0,0,0,0,-517000,0,0,0,176000,693000,-517000,-517000,2021-06-09
10225,078973,精成科兆豐07購01,0,0,0,0,0,0,0,0,0,-517000,0,0,0,39000,556000,-517000,-517000,2021-06-09
10226,031707,台積電永豐0A購03,0,0,0,0,0,0,0,0,0,-518000,0,0,0,223000,741000,-518000,-518000,2021-06-09
10227,031595,英利國票0A購01,0,0,0,0,0,0,0,0,0,-518000,0,0,0,0,518000,-518000,-518000,2021-06-09
10228,034673,長榮凱基0B購11,0,0,0,0,0,0,0,0,0,-519000,0,0,0,668000,1187000,-519000,-519000,2021-06-09
10229,032939,盛群富邦0C購01,0,0,0,0,0,0,0,0,0,-520000,0,0,0,0,520000,-520000,-520000,2021-06-09
10230,086603,光磊中信09購01,0,0,0,0,0,0,0,0,0,-522000,0,0,0,0,522000,-522000,-522000,2021-06-09
10231,034396,樺漢元大0C購01,0,0,0,0,0,0,0,0,0,-522000,0,0,0,0,522000,-522000,-522000,2021-06-09
10232,035809,強茂凱基0B購01,0,0,0,0,0,0,0,0,0,-522000,0,0,0,165000,687000,-522000,-522000,2021-06-09
10233,032387,宏達電統一0B購02,0,0,0,0,0,0,0,0,0,-524000,0,0,0,531000,1055000,-524000,-524000,2021-06-09
10234,031653,台積電元大0A購13,0,4000,-4000,0,0,0,0,0,0,-520000,0,0,0,557000,1077000,-520000,-524000,2021-06-09
10235,030858,聯電永豐0A購03,0,0,0,0,0,0,0,0,0,-524000,0,0,0,0,524000,-524000,-524000,2021-06-09
10236,032912,國喬國票0B購02,0,0,0,0,0,0,0,0,0,-525000,0,0,0,52000,577000,-525000,-525000,2021-06-09
10237,088528,同欣電國泰0B購01,0,0,0,0,0,0,0,0,0,-527000,0,0,0,49000,576000,-527000,-527000,2021-06-09
10238,031563,國喬凱基11購01,0,0,0,0,0,0,0,0,0,-527000,0,0,0,64000,591000,-527000,-527000,2021-06-09
10239,033154,盛群元大0C購01,0,0,0,0,0,0,0,0,0,-527000,0,0,0,2000,529000,-527000,-527000,2021-06-09
10240,085591,致新兆豐08購01,0,0,0,0,0,0,0,0,0,-528000,0,0,0,0,528000,-528000,-528000,2021-06-09
10241,033657,友達統一15購03,0,0,0,0,0,0,0,0,0,-531000,0,0,0,399000,930000,-531000,-531000,2021-06-09
10242,079597,禾伸堂元富09購01,0,0,0,0,0,0,0,0,0,-531000,0,0,0,22000,553000,-531000,-531000,2021-06-09
10243,06413P,臺股指凱基11售01,0,0,0,0,0,0,0,0,0,-532000,0,0,0,345000,877000,-532000,-532000,2021-06-09
10244,036433,強茂凱基11購01,0,0,0,0,0,0,0,0,0,-533000,0,0,0,0,533000,-533000,-533000,2021-06-09
10245,9945,潤泰新,137722,660309,-522587,0,0,0,0,0,0,-11000,0,6000,-6000,2000,7000,-5000,-533587,2021-06-09
10246,088594,矽創統一0B購06,0,0,0,0,0,0,0,0,0,-534000,0,0,0,213000,747000,-534000,-534000,2021-06-09
10247,030154,大立光富邦0B購03,0,0,0,0,0,0,0,0,0,-534000,0,0,0,0,534000,-534000,-534000,2021-06-09
10248,034943,欣興群益12購01,0,0,0,0,0,0,0,0,0,-534000,0,0,0,177000,711000,-534000,-534000,2021-06-09
10249,034668,東鋼凱基0B購06,0,0,0,0,0,0,0,0,0,-536000,0,0,0,77000,613000,-536000,-536000,2021-06-09
10250,033506,欣興統一13購02,0,0,0,0,0,0,0,0,0,-537000,0,0,0,3000,540000,-537000,-537000,2021-06-09
10251,034453,華擎兆豐0C購01,0,0,0,0,0,0,0,0,0,-537000,0,0,0,80000,617000,-537000,-537000,2021-06-09
10252,036128,威致凱基12購01,0,0,0,0,0,0,0,0,0,-537000,0,0,0,303000,840000,-537000,-537000,2021-06-09
10253,031514,聯詠元大0A購06,0,0,0,0,0,0,0,0,0,-538000,0,0,0,13000,551000,-538000,-538000,2021-06-09
10254,076418,GIS統一07購01,0,0,0,0,0,0,0,0,0,-538000,0,0,0,145000,683000,-538000,-538000,2021-06-09
10255,088224,聯發科元富09購09,0,0,0,0,0,0,0,0,0,-539000,0,0,0,1249000,1788000,-539000,-539000,2021-06-09
10256,2354,鴻準,641549,1177300,-535751,0,0,0,0,0,0,-3846,9000,12846,-3846,0,0,0,-539597,2021-06-09
10257,035114,台積電兆豐0B購03,0,0,0,0,0,0,0,0,0,-541000,0,0,0,0,541000,-541000,-541000,2021-06-09
10258,082717,愛普凱基0A購01,0,0,0,0,0,0,0,0,0,-541000,0,0,0,0,541000,-541000,-541000,2021-06-09
10259,088730,南茂凱基09購02,0,0,0,0,0,0,0,0,0,-543000,0,0,0,0,543000,-543000,-543000,2021-06-09
10260,033347,群創永豐0B購02,0,0,0,0,0,0,0,0,0,-545000,0,0,0,20000,565000,-545000,-545000,2021-06-09
10261,077483,世紀鋼國票07購01,0,0,0,0,0,0,0,0,0,-545000,0,0,0,14000,559000,-545000,-545000,2021-06-09
10262,033536,聯發科富邦0C購06,0,0,0,0,0,0,0,0,0,-550000,0,0,0,0,550000,-550000,-550000,2021-06-09
10263,032851,矽創永豐0A購03,0,0,0,0,0,0,0,0,0,-550000,0,0,0,50000,600000,-550000,-550000,2021-06-09
10264,087846,臺股指凱基09購31,0,0,0,0,0,0,0,0,0,-551000,0,0,0,3732000,4283000,-551000,-551000,2021-06-09
10265,032637,長榮統一11購05,0,0,0,0,0,0,0,0,0,-551000,0,0,0,1000,552000,-551000,-551000,2021-06-09
10266,034499,矽創元大0B購04,0,0,0,0,0,0,0,0,0,-552000,0,0,0,275000,827000,-552000,-552000,2021-06-09
10267,2897,王道銀行,57000,609000,-552000,0,0,0,0,0,0,0,0,0,0,0,0,0,-552000,2021-06-09
10268,031622,大成鋼統一0B購04,0,0,0,0,0,0,0,0,0,-555000,0,0,0,756000,1311000,-555000,-555000,2021-06-09
10269,2498,宏達電,3701100,5528000,-1826900,0,0,0,0,0,0,1270237,26772,4854,21918,1387319,139000,1248319,-556663,2021-06-09
10270,030405,鼎元元大0C購01,0,0,0,0,0,0,0,0,0,-557000,0,0,0,55000,612000,-557000,-557000,2021-06-09
10271,085765,力山凱基08購02,0,0,0,0,0,0,0,0,0,-558000,0,0,0,142000,700000,-558000,-558000,2021-06-09
10272,036383,世紀鋼國票0C購01,0,0,0,0,0,0,0,0,0,-558000,0,0,0,0,558000,-558000,-558000,2021-06-09
10273,086208,南電凱基08購06,0,0,0,0,0,0,0,0,0,-560000,0,0,0,107000,667000,-560000,-560000,2021-06-09
10274,032083,華夏永豐0A購02,0,0,0,0,0,0,0,0,0,-560000,0,0,0,0,560000,-560000,-560000,2021-06-09
10275,035225,南電國泰11購02,0,0,0,0,0,0,0,0,0,-560000,0,0,0,434000,994000,-560000,-560000,2021-06-09
10276,04790P,臺股指中信09售01,0,0,0,0,0,0,0,0,0,-560000,0,0,0,0,560000,-560000,-560000,2021-06-09
10277,03749C,臺股指凱基0C牛07,0,0,0,0,0,0,0,0,0,-561000,0,0,0,282000,843000,-561000,-561000,2021-06-09
10278,031368,聯電永豐11購01,0,0,0,0,0,0,0,0,0,-562000,0,0,0,144000,706000,-562000,-562000,2021-06-09
10279,082870,臺股指中信0B購09,0,0,0,0,0,0,0,0,0,-563000,0,0,0,49000,612000,-563000,-563000,2021-06-09
10280,087177,松翰元富0A購02,0,0,0,0,0,0,0,0,0,-565000,0,0,0,65000,630000,-565000,-565000,2021-06-09
10281,032437,宏達電元大0A購03,0,0,0,0,0,0,0,0,0,-565000,0,0,0,25000,590000,-565000,-565000,2021-06-09
10282,033824,群創統一15購03,0,0,0,0,0,0,0,0,0,-565000,0,0,0,413000,978000,-565000,-565000,2021-06-09
10283,00638R,元大滬深300反1,7000,115000,-108000,0,0,0,0,0,0,-457014,0,0,0,46000,503014,-457014,-565014,2021-06-09
10284,088052,強茂元大09購02,0,0,0,0,0,0,0,0,0,-566000,0,0,0,110000,676000,-566000,-566000,2021-06-09
10285,2489,瑞軒,1255000,1740000,-485000,0,0,0,0,0,0,-81138,0,0,0,30000,111138,-81138,-566138,2021-06-09
10286,036496,欣興國泰12購01,0,0,0,0,0,0,0,0,0,-569000,0,0,0,20000,589000,-569000,-569000,2021-06-09
10287,030201,群光凱基0A購01,0,0,0,0,0,0,0,0,0,-570000,0,0,0,0,570000,-570000,-570000,2021-06-09
10288,2327,國巨,1016110,1577500,-561390,0,0,0,0,5000,-5000,-4353,88000,41882,46118,18000,68471,-50471,-570743,2021-06-09
10289,032309,強茂永豐0A購02,0,0,0,0,0,0,0,0,0,-574000,0,0,0,0,574000,-574000,-574000,2021-06-09
10290,035124,聯詠永豐0B購02,0,0,0,0,0,0,0,0,0,-574000,0,0,0,0,574000,-574000,-574000,2021-06-09
10291,05900P,臺股指國票0B售08,0,0,0,0,0,0,0,0,0,-574000,0,0,0,15000,589000,-574000,-574000,2021-06-09
10292,085616,松翰元大08購05,0,0,0,0,0,0,0,0,0,-575000,0,0,0,111000,686000,-575000,-575000,2021-06-09
10293,032009,臺股指群益0A購11,0,0,0,0,0,0,0,0,0,-575000,0,0,0,25000,600000,-575000,-575000,2021-06-09
10294,077040,世芯國泰07購02,0,0,0,0,0,0,0,0,0,-575000,0,0,0,0,575000,-575000,-575000,2021-06-09
10295,084338,鴻海元大07購40,0,0,0,0,0,0,0,0,0,-578000,0,0,0,12000,590000,-578000,-578000,2021-06-09
10296,035123,長榮永豐0B購06,0,0,0,0,0,0,0,0,0,-578000,0,0,0,19000,597000,-578000,-578000,2021-06-09
10297,089856,精成科元大09購05,0,0,0,0,0,0,0,0,0,-580000,0,0,0,231000,811000,-580000,-580000,2021-06-09
10298,079405,金像電國泰08購01,0,0,0,0,0,0,0,0,0,-581000,0,0,0,60000,641000,-581000,-581000,2021-06-09
10299,084863,凌陽元大08購06,0,0,0,0,0,0,0,0,0,-582000,0,0,0,471000,1053000,-582000,-582000,2021-06-09
10300,3060,銘異,865000,1447000,-582000,0,0,0,0,0,0,-263,400,663,-263,0,0,0,-582263,2021-06-09
10301,2474,可成,707354,1275159,-567805,0,0,0,0,0,0,-15847,11000,9847,1153,0,17000,-17000,-583652,2021-06-09
10302,2617,台航,7437000,8000000,-563000,0,0,0,0,0,0,-21685,290142,289827,315,28000,50000,-22000,-584685,2021-06-09
10303,2481,強茂,4809100,6284000,-1474900,0,0,0,356000,130000,226000,662408,212010,42602,169408,568000,75000,493000,-586492,2021-06-09
10304,081096,T50反1群益09購04,0,0,0,0,0,0,0,0,0,-588000,0,0,0,0,588000,-588000,-588000,2021-06-09
10305,07283P,奇鋐凱基0C售01,0,0,0,0,0,0,0,0,0,-588000,0,0,0,164000,752000,-588000,-588000,2021-06-09
10306,031072,華擎元大0B購01,0,0,0,0,0,0,0,0,0,-592000,0,0,0,50000,642000,-592000,-592000,2021-06-09
10307,5876,上海商銀,1505000,2084800,-579800,0,0,0,0,0,0,-13000,0,13000,-13000,0,0,0,-592800,2021-06-09
10308,035074,萬海群益0B購07,0,0,0,0,0,0,0,0,0,-593000,0,0,0,0,593000,-593000,-593000,2021-06-09
10309,8070,長華*,129000,709000,-580000,0,0,0,0,0,0,-14979,5000,4979,21,1000,16000,-15000,-594979,2021-06-09
10310,036014,矽創凱基0C購02,0,0,0,0,0,0,0,0,0,-597000,0,0,0,79000,676000,-597000,-597000,2021-06-09
10311,031938,SGBR2X元大14購01,0,0,0,0,0,0,0,0,0,-598000,0,0,0,9000,607000,-598000,-598000,2021-06-09
10312,032888,大成鋼統一0A購02,0,0,0,0,0,0,0,0,0,-599000,0,0,0,43000,642000,-599000,-599000,2021-06-09
10313,036495,金像電國泰12購02,0,0,0,0,0,0,0,0,0,-599000,0,0,0,0,599000,-599000,-599000,2021-06-09
10314,036114,中石化群益12購01,0,0,0,0,0,0,0,0,0,-600000,0,0,0,100000,700000,-600000,-600000,2021-06-09
10315,035657,光罩國泰12購01,0,0,0,0,0,0,0,0,0,-604000,0,0,0,226000,830000,-604000,-604000,2021-06-09
10316,6582,申豐,163000,762000,-599000,0,0,0,0,0,0,-6000,0,0,0,0,6000,-6000,-605000,2021-06-09
10317,036337,強茂元富11購01,0,0,0,0,0,0,0,0,0,-607000,0,0,0,0,607000,-607000,-607000,2021-06-09
10318,085219,緯穎國票09購01,0,0,0,0,0,0,0,0,0,-608000,0,0,0,0,608000,-608000,-608000,2021-06-09
10319,035672,南紡第一15購01,0,0,0,0,0,0,0,0,0,-608000,0,0,0,17000,625000,-608000,-608000,2021-06-09
10320,089644,立積凱基12購01,0,0,0,0,0,0,0,0,0,-610000,0,0,0,0,610000,-610000,-610000,2021-06-09
10321,033110,聯電富邦13購02,10000,0,10000,0,0,0,0,0,0,-623000,0,0,0,1046000,1669000,-623000,-613000,2021-06-09
10322,030992,致新元大0A購03,0,0,0,0,0,0,0,0,0,-613000,0,0,0,20000,633000,-613000,-613000,2021-06-09
10323,3702,大聯大,647000,1566100,-919100,0,0,0,0,269000,-269000,574000,472000,6000,466000,146000,38000,108000,-614100,2021-06-09
10324,035142,長榮統一0C購15,0,0,0,0,0,0,0,0,0,-617000,0,0,0,153000,770000,-617000,-617000,2021-06-09
10325,033964,世紀鋼永豐0B購01,0,0,0,0,0,0,0,0,0,-619000,0,0,0,0,619000,-619000,-619000,2021-06-09
10326,035538,儒鴻統一0C購02,0,0,0,0,0,0,0,0,0,-619000,0,0,0,30000,649000,-619000,-619000,2021-06-09
10327,031750,宏達電凱基14購01,0,0,0,0,0,0,0,0,0,-622000,0,0,0,83000,705000,-622000,-622000,2021-06-09
10328,033171,友達永豐0B購01,0,0,0,0,0,0,0,0,0,-623000,0,0,0,185000,808000,-623000,-623000,2021-06-09
10329,1101,台泥,3450550,3552071,-101521,0,0,0,0,625000,-625000,103000,263000,146000,117000,215000,229000,-14000,-623521,2021-06-09
10330,2614,東森,4324000,5022000,-698000,0,0,0,0,0,0,74000,0,0,0,108000,34000,74000,-624000,2021-06-09
10331,034726,台玻元大0B購08,0,0,0,0,0,0,0,0,0,-625000,0,0,0,180000,805000,-625000,-625000,2021-06-09
10332,2606,裕民,6572000,5942000,630000,0,0,0,0,417000,-417000,-840070,260000,509070,-249070,94000,685000,-591000,-627070,2021-06-09
10333,2612,中航,339000,993000,-654000,0,0,0,0,0,0,19000,19000,0,19000,0,0,0,-635000,2021-06-09
10334,2324,仁寶,9999000,10314600,-315600,0,0,0,0,550000,-550000,228727,45000,59273,-14273,288000,45000,243000,-636873,2021-06-09
10335,07106P,長榮群益0B售11,1000,0,1000,0,0,0,0,0,0,-638000,0,0,0,1020000,1658000,-638000,-637000,2021-06-09
10336,089473,聯詠國票09購03,0,0,0,0,0,0,0,0,0,-640000,0,0,0,0,640000,-640000,-640000,2021-06-09
10337,080634,勝一元大09購01,0,0,0,0,0,0,0,0,0,-641000,0,0,0,481000,1122000,-641000,-641000,2021-06-09
10338,034087,友達元大0B購09,0,0,0,0,0,0,0,0,0,-643000,0,0,0,136000,779000,-643000,-643000,2021-06-09
10339,2208,台船,1108000,1551000,-443000,0,0,0,0,0,0,-201000,10000,55000,-45000,0,156000,-156000,-644000,2021-06-09
10340,030514,景碩群益0B購03,0,0,0,0,0,0,0,0,0,-645000,0,0,0,306000,951000,-645000,-645000,2021-06-09
10341,031883,宏達電凱基14購02,0,0,0,0,0,0,0,0,0,-645000,0,0,0,102000,747000,-645000,-645000,2021-06-09
10342,07079P,裕民凱基0B售01,0,0,0,0,0,0,0,0,0,-645000,0,0,0,278000,923000,-645000,-645000,2021-06-09
10343,036384,世紀鋼國票11購01,0,0,0,0,0,0,0,0,0,-646000,0,0,0,0,646000,-646000,-646000,2021-06-09
10344,2104,國際中橡,307000,936000,-629000,0,0,0,0,0,0,-17000,0,0,0,0,17000,-17000,-646000,2021-06-09
10345,1904,正隆,1459000,1930000,-471000,0,0,0,0,0,0,-175143,23000,27143,-4143,75000,246000,-171000,-646143,2021-06-09
10346,030484,聯發科永豐0A購01,0,0,0,0,0,0,0,0,0,-647000,0,0,0,0,647000,-647000,-647000,2021-06-09
10347,030327,盛群麥證0A購01,0,0,0,26000,719000,-693000,0,0,0,-649000,0,0,0,70000,719000,-649000,-649000,2021-06-09
10348,033757,光罩凱基0B購01,0,0,0,0,0,0,0,0,0,-650000,0,0,0,344000,994000,-650000,-650000,2021-06-09
10349,00671R,富邦NASDAQ反1,3000,14000,-11000,0,0,0,0,0,0,-646000,0,0,0,37000,683000,-646000,-657000,2021-06-09
10350,034624,宏達電元富0B購02,0,0,0,0,0,0,0,0,0,-657000,0,0,0,1000,658000,-657000,-657000,2021-06-09
10351,030630,盛群元大0A購01,0,0,0,0,0,0,0,0,0,-658000,0,0,0,45000,703000,-658000,-658000,2021-06-09
10352,084070,聯電元大07購17,0,0,0,0,0,0,0,0,0,-662000,0,0,0,2000,664000,-662000,-662000,2021-06-09
10353,033200,臺股指凱基13購01,0,0,0,0,0,0,0,0,0,-666000,0,0,0,410000,1076000,-666000,-666000,2021-06-09
10354,3706,神達,149000,835000,-686000,0,0,0,0,0,0,19712,0,4288,-4288,60000,36000,24000,-666288,2021-06-09
10355,030404,鼎元元大0A購02,0,0,0,0,0,0,0,0,0,-667000,0,0,0,0,667000,-667000,-667000,2021-06-09
10356,034575,亞德客凱基0B購01,0,0,0,0,0,0,0,0,0,-668000,0,0,0,0,668000,-668000,-668000,2021-06-09
10357,2812,台中銀,646000,1302000,-656000,0,0,0,0,0,0,-12000,0,12000,-12000,0,0,0,-668000,2021-06-09
10358,06354P,南電元富08售04,0,0,0,0,0,0,0,0,0,-671000,0,0,0,55000,726000,-671000,-671000,2021-06-09
10359,035141,長榮統一0B購12,0,0,0,0,0,0,0,0,0,-672000,0,0,0,76000,748000,-672000,-672000,2021-06-09
10360,034572,群創第一15購02,0,0,0,0,0,0,0,0,0,-673000,0,0,0,78000,751000,-673000,-673000,2021-06-09
10361,036396,永豐餘中信11購01,0,0,0,0,0,0,0,0,0,-677000,0,0,0,149000,826000,-677000,-677000,2021-06-09
10362,032856,光罩群益0A購04,0,0,0,0,0,0,0,0,0,-678000,0,0,0,57000,735000,-678000,-678000,2021-06-09
10363,6443,元晶,1289000,1967000,-678000,0,0,0,0,0,0,0,0,0,0,0,0,0,-678000,2021-06-09
10364,089053,凌陽永豐09購01,0,0,0,0,0,0,0,0,0,-680000,0,0,0,10000,690000,-680000,-680000,2021-06-09
10365,07119P,長榮元大0B售10,0,0,0,0,0,0,0,0,0,-681000,0,0,0,280000,961000,-681000,-681000,2021-06-09
10366,6165,浪凡,230000,912000,-682000,0,0,0,0,0,0,0,0,0,0,0,0,0,-682000,2021-06-09
10367,032220,微星統一0C購01,0,0,0,0,0,0,0,0,0,-683000,0,0,0,231000,914000,-683000,-683000,2021-06-09
10368,020020,元大台股領航N,0,0,0,0,0,0,0,0,0,-683000,0,0,0,345000,1028000,-683000,-683000,2021-06-09
10369,036387,聯陽富邦13購01,0,0,0,0,0,0,0,0,0,-683000,0,0,0,277000,960000,-683000,-683000,2021-06-09
10370,087081,精成科統一0B購01,0,0,0,0,0,0,0,0,0,-686000,0,0,0,9000,695000,-686000,-686000,2021-06-09
10371,032137,大成鋼凱基14購03,0,0,0,0,0,0,0,0,0,-686000,0,0,0,780000,1466000,-686000,-686000,2021-06-09
10372,2375,凱美,587000,1268000,-681000,0,0,0,0,0,0,-5396,10000,9396,604,6000,12000,-6000,-686396,2021-06-09
10373,035629,南電國票0C購01,0,0,0,0,0,0,0,0,0,-688000,0,0,0,135000,823000,-688000,-688000,2021-06-09
10374,06977P,裕民元富0A售01,0,0,0,0,0,0,0,0,0,-691000,0,0,0,34000,725000,-691000,-691000,2021-06-09
10375,030866,奇鋐永豐0A購02,0,0,0,0,0,0,0,0,0,-700000,0,0,0,238000,938000,-700000,-700000,2021-06-09
10376,074464,華擎元富0A購01,0,0,0,0,0,0,0,0,0,-705000,0,0,0,120000,825000,-705000,-705000,2021-06-09
10377,8112,至上,375000,1080000,-705000,0,0,0,0,0,0,-417,3000,3417,-417,0,0,0,-705417,2021-06-09
10378,033226,聯電康和0B購01,0,0,0,0,0,0,0,0,0,-710000,0,0,0,116000,826000,-710000,-710000,2021-06-09
10379,033528,台航國票0B購01,0,0,0,0,0,0,0,0,0,-716000,0,0,0,42000,758000,-716000,-716000,2021-06-09
10380,07108P,長榮元富0B售06,0,0,0,0,0,0,0,0,0,-717000,0,0,0,348000,1065000,-717000,-717000,2021-06-09
10381,2007,燁興,377000,1099000,-722000,0,0,0,0,0,0,0,0,0,0,0,0,0,-722000,2021-06-09
10382,2017,官田鋼,893000,1617000,-724000,0,0,0,0,0,0,12,1000,988,12,0,0,0,-723988,2021-06-09
10383,2352,佳世達,906000,1458000,-552000,0,0,0,0,54000,-54000,-120036,149000,167179,-18179,1000,102857,-101857,-726036,2021-06-09
10384,033247,強茂元大0B購01,0,0,0,0,0,0,0,0,0,-734000,0,0,0,343000,1077000,-734000,-734000,2021-06-09
10385,07052P,友達元大0B售11,0,0,0,0,0,0,0,0,0,-734000,0,0,0,8000,742000,-734000,-734000,2021-06-09
10386,089728,台光電永豐09購01,0,0,0,0,0,0,0,0,0,-737000,0,0,0,268000,1005000,-737000,-737000,2021-06-09
10387,4960,誠美材,710000,1448000,-738000,0,0,0,0,0,0,0,0,0,0,0,0,0,-738000,2021-06-09
10388,035884,永豐餘國票11購01,0,0,0,0,0,0,0,0,0,-742000,0,0,0,351000,1093000,-742000,-742000,2021-06-09
10389,034965,技嘉元大11購02,0,0,0,0,0,0,0,0,0,-742000,0,0,0,132000,874000,-742000,-742000,2021-06-09
10390,034867,聯茂元大0B購02,0,0,0,0,0,0,0,0,0,-743000,0,0,0,10000,753000,-743000,-743000,2021-06-09
10391,087298,精成科元大09購01,0,0,0,0,0,0,0,0,0,-744000,0,0,0,108000,852000,-744000,-744000,2021-06-09
10392,07150P,大成鋼元大0B售12,0,0,0,0,0,0,0,0,0,-746000,0,0,0,222000,968000,-746000,-746000,2021-06-09
10393,034796,愛普中信11購01,0,0,0,0,0,0,0,0,0,-747000,0,0,0,0,747000,-747000,-747000,2021-06-09
10394,087773,技嘉中信09購01,0,0,0,0,0,0,0,0,0,-751000,0,0,0,410000,1161000,-751000,-751000,2021-06-09
10395,033433,偉詮電元大0B購02,0,0,0,0,0,0,0,0,0,-758000,0,0,0,469000,1227000,-758000,-758000,2021-06-09
10396,035835,技嘉元大0B購03,0,0,0,0,0,0,0,0,0,-765000,0,0,0,22000,787000,-765000,-765000,2021-06-09
10397,06923P,長榮凱基0A售18,0,14000,-14000,0,0,0,0,0,0,-752000,0,0,0,191000,943000,-752000,-766000,2021-06-09
10398,4967,十銓,1150000,1931000,-781000,0,0,0,0,0,0,10000,10000,0,10000,0,0,0,-771000,2021-06-09
10399,035350,台玻國泰11購01,0,0,0,0,0,0,0,0,0,-772000,0,0,0,53000,825000,-772000,-772000,2021-06-09
10400,032355,中鋼凱基14購04,0,0,0,0,0,0,0,0,0,-775000,0,0,0,567000,1342000,-775000,-775000,2021-06-09
10401,3037,欣興,12709322,17533856,-4824534,0,0,0,2846000,62000,2784000,1264000,2070000,916000,1154000,556000,446000,110000,-776534,2021-06-09
10402,035837,凌陽元大0B購01,0,0,0,0,0,0,0,0,0,-778000,0,0,0,51000,829000,-778000,-778000,2021-06-09
10403,031882,宏達電凱基12購01,0,0,0,0,0,0,0,0,0,-781000,0,0,0,115000,896000,-781000,-781000,2021-06-09
10404,035079,長榮第一15購03,0,0,0,0,0,0,0,0,0,-782000,0,0,0,0,782000,-782000,-782000,2021-06-09
10405,3576,聯合再生,1090000,1872000,-782000,0,0,0,0,0,0,0,0,0,0,0,0,0,-782000,2021-06-09
10406,032411,儒鴻元大0A購02,0,0,0,0,0,0,0,0,0,-784000,0,0,0,139000,923000,-784000,-784000,2021-06-09
10407,083149,臺股指凱基07購27,0,0,0,0,0,0,0,0,0,-784000,0,0,0,90000,874000,-784000,-784000,2021-06-09
10408,2034,允強,381200,1053100,-671900,0,0,0,0,0,0,-113000,0,0,0,0,113000,-113000,-784900,2021-06-09
10409,031683,宏達電中信0A購01,0,0,0,0,0,0,0,0,0,-794000,0,0,0,278000,1072000,-794000,-794000,2021-06-09
10410,2368,金像電,4652000,4703000,-51000,0,0,0,0,90000,-90000,-656752,205002,323915,-118913,240161,778000,-537839,-797752,2021-06-09
10411,2486,一詮,1766005,2566000,-799995,0,0,0,0,0,0,0,0,0,0,0,0,0,-799995,2021-06-09
10412,2867,三商壽,53000,794000,-741000,0,0,0,0,0,0,-61000,0,61000,-61000,0,0,0,-802000,2021-06-09
10413,2520,冠德,264010,254000,10010,0,0,0,0,806000,-806000,-8000,2000,0,2000,26000,36000,-10000,-803990,2021-06-09
10414,4306,炎洲,863000,1614000,-751000,0,0,0,0,0,0,-55000,0,0,0,0,55000,-55000,-806000,2021-06-09
10415,032228,新唐統一0C購03,0,0,0,0,0,0,0,0,0,-810000,0,0,0,6000,816000,-810000,-810000,2021-06-09
10416,071137,大立光元富09購01,0,0,0,0,0,0,0,0,0,-822000,0,0,0,487000,1309000,-822000,-822000,2021-06-09
10417,084027,致新統一09購02,0,0,0,0,0,0,0,0,0,-823000,0,0,0,92000,915000,-823000,-823000,2021-06-09
10418,031148,強茂兆豐0B購02,0,0,0,0,0,0,0,0,0,-826000,0,0,0,115000,941000,-826000,-826000,2021-06-09
10419,034935,力山群益0B購01,0,0,0,0,0,0,0,0,0,-826000,0,0,0,67000,893000,-826000,-826000,2021-06-09
10420,034119,世紀鋼群益0C購01,0,0,0,0,0,0,0,0,0,-827000,0,0,0,26000,853000,-827000,-827000,2021-06-09
10421,033244,京元電元大11購01,0,0,0,0,0,0,0,0,0,-841000,0,0,0,113000,954000,-841000,-841000,2021-06-09
10422,035038,欣興麥證11購01,0,0,0,299000,1141000,-842000,0,0,0,-841000,0,0,0,330000,1171000,-841000,-841000,2021-06-09
10423,077486,世紀鋼國票08購01,0,0,0,0,0,0,0,0,0,-849000,0,0,0,0,849000,-849000,-849000,2021-06-09
10424,033402,友達中信0C購01,0,0,0,0,0,0,0,0,0,-854000,0,0,0,0,854000,-854000,-854000,2021-06-09
10425,035767,聯茂元富13購01,0,0,0,0,0,0,0,0,0,-854000,0,0,0,100000,954000,-854000,-854000,2021-06-09
10426,06273P,台積電元大08售24,0,0,0,0,0,0,0,0,0,-856000,0,0,0,50000,906000,-856000,-856000,2021-06-09
10427,032901,矽創統一0B購10,0,0,0,0,0,0,0,0,0,-859000,0,0,0,317000,1176000,-859000,-859000,2021-06-09
10428,086443,王品永豐09購01,0,0,0,0,0,0,0,0,0,-866000,0,0,0,12000,878000,-866000,-866000,2021-06-09
10429,034043,技嘉元富12購01,0,0,0,0,0,0,0,0,0,-869000,0,0,0,242000,1111000,-869000,-869000,2021-06-09
10430,6191,精成科,1885000,3481000,-1596000,0,0,0,0,0,0,727000,0,0,0,804000,77000,727000,-869000,2021-06-09
10431,035109,世紀鋼元大0B購03,0,0,0,0,0,0,0,0,0,-873000,0,0,0,10000,883000,-873000,-873000,2021-06-09
10432,088938,立積統一0B購01,0,0,0,0,0,0,0,0,0,-874000,0,0,0,383000,1257000,-874000,-874000,2021-06-09
10433,086789,強茂兆豐0A購01,0,0,0,0,0,0,0,0,0,-881000,0,0,0,165000,1046000,-881000,-881000,2021-06-09
10434,034753,世紀鋼元大0C購04,0,0,0,0,0,0,0,0,0,-884000,0,0,0,92000,976000,-884000,-884000,2021-06-09
10435,083034,台積電中信09購09,0,0,0,0,0,0,0,0,0,-888000,0,0,0,7000,895000,-888000,-888000,2021-06-09
10436,074187,世紀鋼元富07購02,0,0,0,0,0,0,0,0,0,-889000,0,0,0,0,889000,-889000,-889000,2021-06-09
10437,080347,台光電統一08購02,0,0,0,0,0,0,0,0,0,-890000,0,0,0,415000,1305000,-890000,-890000,2021-06-09
10438,030003,景碩中信0B購01,0,0,0,0,0,0,0,0,0,-891000,0,0,0,205000,1096000,-891000,-891000,2021-06-09
10439,085228,台積電元大0C購04,0,0,0,0,0,0,0,0,0,-905000,0,0,0,14000,919000,-905000,-905000,2021-06-09
10440,035228,聯詠兆豐0C購04,0,0,0,0,0,0,0,0,0,-907000,0,0,0,520000,1427000,-907000,-907000,2021-06-09
10441,3532,台勝科,556150,1445066,-888916,0,0,0,0,0,0,-23000,22000,2000,20000,2000,45000,-43000,-911916,2021-06-09
10442,033858,明泰凱基0B購01,0,0,0,0,0,0,0,0,0,-920000,0,0,0,0,920000,-920000,-920000,2021-06-09
10443,035561,新唐統一0C購06,0,0,0,0,0,0,0,0,0,-921000,0,0,0,40000,961000,-921000,-921000,2021-06-09
10444,030914,矽創凱基0A購02,0,0,0,0,0,0,0,0,0,-925000,0,0,0,397000,1322000,-925000,-925000,2021-06-09
10445,035897,宏達電國泰12購01,0,0,0,0,0,0,0,0,0,-929000,0,0,0,1943000,2872000,-929000,-929000,2021-06-09
10446,033783,台揚元大0B購03,0,0,0,0,0,0,0,0,0,-936000,0,0,0,30000,966000,-936000,-936000,2021-06-09
10447,1304,台聚,2941000,3819149,-878149,0,0,0,0,0,0,-61873,2053,8926,-6873,14000,69000,-55000,-940022,2021-06-09
10448,077487,世紀鋼國票08購02,0,0,0,0,0,0,0,0,0,-947000,0,0,0,0,947000,-947000,-947000,2021-06-09
10449,1326,台化,1565000,1651700,-86700,0,0,0,0,168000,-168000,-692476,27000,694476,-667476,0,25000,-25000,-947176,2021-06-09
10450,8021,尖點,1156000,2104000,-948000,0,0,0,0,0,0,0,0,0,0,0,0,0,-948000,2021-06-09
10451,2376,技嘉,3629149,4559722,-930573,0,0,0,0,83000,-83000,59566,151566,197000,-45434,137000,32000,105000,-954007,2021-06-09
10452,2385,群光,1028000,1948977,-920977,0,0,0,9000,98020,-89020,55000,0,2000,-2000,68000,11000,57000,-954997,2021-06-09
10453,084835,大立光統一0A購02,0,0,0,0,0,0,0,0,0,-960000,0,0,0,20000,980000,-960000,-960000,2021-06-09
10454,1217,愛之味,608000,1582000,-974000,0,0,0,0,0,0,0,0,0,0,0,0,0,-974000,2021-06-09
10455,032688,大成鋼永豐0A購06,0,0,0,0,0,0,0,0,0,-985000,0,0,0,27000,1012000,-985000,-985000,2021-06-09
10456,034550,世紀鋼統一0C購01,0,0,0,0,0,0,0,0,0,-987000,0,0,0,42000,1029000,-987000,-987000,2021-06-09
10457,3714,富采,624000,1617000,-993000,0,0,0,0,0,0,-929,7000,7929,-929,0,0,0,-993929,2021-06-09
10458,032214,中鋼統一0C購08,0,0,0,0,0,0,0,0,0,-995000,0,0,0,5000,1000000,-995000,-995000,2021-06-09
10459,1452,宏益,312000,1310000,-998000,0,0,0,0,0,0,0,0,0,0,0,0,0,-998000,2021-06-09
10460,082321,台積電統一08購02,0,0,0,0,0,0,0,0,0,-1018000,0,0,0,0,1018000,-1018000,-1018000,2021-06-09
10461,032890,光罩統一0C購01,0,0,0,0,0,0,0,0,0,-1021000,0,0,0,429000,1450000,-1021000,-1021000,2021-06-09
10462,2456,奇力新,206000,370000,-164000,0,0,0,0,833000,-833000,-24362,5000,4533,467,0,24829,-24829,-1021362,2021-06-09
10463,032217,大成鋼統一0B購05,0,0,0,0,0,0,0,0,0,-1032000,0,0,0,614000,1646000,-1032000,-1032000,2021-06-09
10464,030006,新唐中信0B購01,0,0,0,0,0,0,0,0,0,-1038000,0,0,0,294000,1332000,-1038000,-1038000,2021-06-09
10465,089022,立積元大09購07,0,0,0,0,0,0,0,0,0,-1059000,0,0,0,107000,1166000,-1059000,-1059000,2021-06-09
10466,00664R,國泰臺灣加權反1,52000,20000,32000,0,0,0,0,0,0,-1094950,0,0,0,528050,1623000,-1094950,-1062950,2021-06-09
10467,033300,欣興中信0B購01,0,0,0,0,0,0,0,0,0,-1070000,0,0,0,452000,1522000,-1070000,-1070000,2021-06-09
10468,032690,台光電永豐0A購01,0,0,0,0,0,0,0,0,0,-1071000,0,0,0,15000,1086000,-1071000,-1071000,2021-06-09
10469,036034,全新統一12購01,0,0,0,0,0,0,0,0,0,-1076000,0,0,0,0,1076000,-1076000,-1076000,2021-06-09
10470,031744,台揚凱基11購02,0,0,0,0,0,0,0,0,0,-1077000,0,0,0,193000,1270000,-1077000,-1077000,2021-06-09
10471,032670,聯詠富邦13購01,0,0,0,0,0,0,0,0,0,-1080000,0,0,0,80000,1160000,-1080000,-1080000,2021-06-09
10472,1444,力麗,1715000,2780000,-1065000,0,0,0,0,0,0,-19000,0,0,0,13000,32000,-19000,-1084000,2021-06-09
10473,035995,緯穎國泰12購01,0,0,0,0,0,0,0,0,0,-1089000,0,0,0,0,1089000,-1089000,-1089000,2021-06-09
10474,032215,中鋼統一0C購09,0,0,0,0,0,0,0,0,0,-1092000,0,0,0,554000,1646000,-1092000,-1092000,2021-06-09
10475,033179,群創永豐0B購01,0,0,0,0,0,0,0,0,0,-1098000,0,0,0,0,1098000,-1098000,-1098000,2021-06-09
10476,030696,南帝群益0B購05,0,0,0,0,0,0,0,0,0,-1104000,0,0,0,11000,1115000,-1104000,-1104000,2021-06-09
10477,068411,世紀鋼元富07購01,0,0,0,0,0,0,0,0,0,-1112000,0,0,0,265000,1377000,-1112000,-1112000,2021-06-09
10478,036307,世紀鋼元大0C購05,0,0,0,0,0,0,0,0,0,-1113000,0,0,0,0,1113000,-1113000,-1113000,2021-06-09
10479,080317,T50反1凱基0C購04,0,0,0,0,0,0,0,0,0,-1115000,0,0,0,0,1115000,-1115000,-1115000,2021-06-09
10480,031026,南亞科凱基14購01,0,0,0,0,0,0,0,0,0,-1122000,0,0,0,20000,1142000,-1122000,-1122000,2021-06-09
10481,035059,宏達電國泰11購01,0,0,0,0,0,0,0,0,0,-1132000,0,0,0,333000,1465000,-1132000,-1132000,2021-06-09
10482,087385,台積電元大11購04,0,0,0,0,0,0,0,0,0,-1157000,0,0,0,1085000,2242000,-1157000,-1157000,2021-06-09
10483,035610,世紀鋼元大12購01,0,0,0,0,0,0,0,0,0,-1162000,0,0,0,16000,1178000,-1162000,-1162000,2021-06-09
10484,031354,臺股指元大0A購31,0,0,0,0,0,0,0,0,0,-1167000,0,0,0,282000,1449000,-1167000,-1167000,2021-06-09
10485,085743,華泰永豐08購01,0,0,0,0,0,0,0,0,0,-1174000,0,0,0,83000,1257000,-1174000,-1174000,2021-06-09
10486,2069,運錩,2954000,4141020,-1187020,0,0,0,0,0,0,0,0,0,0,0,0,0,-1187020,2021-06-09
10487,080604,世紀鋼統一08購01,0,0,0,0,0,0,0,0,0,-1193000,0,0,0,114000,1307000,-1193000,-1193000,2021-06-09
10488,1909,榮成,4716000,5390000,-674000,0,0,0,0,0,0,-522809,672000,774000,-102000,14000,434809,-420809,-1196809,2021-06-09
10489,031856,宏達電中信11購01,0,0,0,0,0,0,0,0,0,-1201000,0,0,0,710000,1911000,-1201000,-1201000,2021-06-09
10490,2399,映泰,1760000,2961000,-1201000,0,0,0,0,0,0,0,0,0,0,0,0,0,-1201000,2021-06-09
10491,032114,鴻海第一14購01,0,0,0,0,0,0,0,0,0,-1204000,0,0,0,85000,1289000,-1204000,-1204000,2021-06-09
10492,089326,聯詠富邦0B購04,0,0,0,0,0,0,0,0,0,-1205000,0,0,0,318000,1523000,-1205000,-1205000,2021-06-09
10493,2426,鼎元,626000,1908000,-1282000,0,0,0,0,0,0,73000,6000,0,6000,73000,6000,67000,-1209000,2021-06-09
10494,089337,聯電元大09購07,0,0,0,0,0,0,0,0,0,-1216000,0,0,0,221000,1437000,-1216000,-1216000,2021-06-09
10495,2430,燦坤,655000,1897000,-1242000,0,0,0,0,0,0,0,0,0,0,0,0,0,-1242000,2021-06-09
10496,036313,技嘉統一12購02,0,0,0,0,0,0,0,0,0,-1243000,0,0,0,72000,1315000,-1243000,-1243000,2021-06-09
10497,00673R,期元大S&P原油反1,0,0,0,0,0,0,0,0,0,-1243000,0,0,0,0,1243000,-1243000,-1243000,2021-06-09
10498,033503,欣興統一0C購01,0,0,0,0,0,0,0,0,0,-1248000,0,0,0,1149000,2397000,-1248000,-1248000,2021-06-09
10499,034551,世紀鋼統一0C購02,0,0,0,0,0,0,0,0,0,-1248000,0,0,0,683000,1931000,-1248000,-1248000,2021-06-09
10500,089913,眾達凱基11購01,0,0,0,0,0,0,0,0,0,-1259000,0,0,0,0,1259000,-1259000,-1259000,2021-06-09
10501,1504,東元,1077000,2348000,-1271000,0,0,0,0,0,0,5262,8732,1470,7262,0,2000,-2000,-1265738,2021-06-09
10502,032875,光罩凱基0A購01,0,0,0,0,0,0,0,0,0,-1294000,0,0,0,407000,1701000,-1294000,-1294000,2021-06-09
10503,033683,台光電元大0B購01,0,0,0,0,0,0,0,0,0,-1301000,0,0,0,369000,1670000,-1301000,-1301000,2021-06-09
10504,2010,春源,478000,1791000,-1313000,0,0,0,0,0,0,-3000,0,0,0,0,3000,-3000,-1316000,2021-06-09
10505,06866P,長榮元大0B售05,11000,0,11000,0,0,0,0,0,0,-1332000,0,0,0,157000,1489000,-1332000,-1321000,2021-06-09
10506,00881,國泰台灣5G+,265000,1415000,-1150000,0,0,0,0,0,0,-173942,0,0,0,3082000,3255942,-173942,-1323942,2021-06-09
10507,085038,台積電元富12購03,0,0,0,0,0,0,0,0,0,-1338000,0,0,0,0,1338000,-1338000,-1338000,2021-06-09
10508,031745,台揚凱基14購01,0,0,0,0,0,0,0,0,0,-1344000,0,0,0,110000,1454000,-1344000,-1344000,2021-06-09
10509,3661,世芯-KY,770120,2069200,-1299080,0,0,0,0,0,0,-72827,21000,61000,-40000,8000,40827,-32827,-1371907,2021-06-09
10510,032892,光罩統一0C購03,0,0,0,0,0,0,0,0,0,-1391000,0,0,0,185000,1576000,-1391000,-1391000,2021-06-09
10511,033263,盛群元大0B購01,0,0,0,0,0,0,0,0,0,-1397000,0,0,0,0,1397000,-1397000,-1397000,2021-06-09
10512,033159,光罩國泰11購01,0,40000,-40000,0,0,0,0,0,0,-1375000,0,0,0,94000,1469000,-1375000,-1415000,2021-06-09
10513,030482,聯電永豐0A購02,0,0,0,0,0,0,0,0,0,-1427000,0,0,0,103000,1530000,-1427000,-1427000,2021-06-09
10514,084434,大立光群益08購05,0,0,0,0,0,0,0,0,0,-1433000,0,0,0,13000,1446000,-1433000,-1433000,2021-06-09
10515,9907,統一實,74000,1507000,-1433000,0,0,0,0,0,0,0,0,0,0,0,0,0,-1433000,2021-06-09
10516,1608,華榮,1595000,3033000,-1438000,0,0,0,0,0,0,-30000,0,0,0,0,30000,-30000,-1468000,2021-06-09
10517,033801,台玻國票0C購02,0,0,0,0,0,0,0,0,0,-1469000,0,0,0,189000,1658000,-1469000,-1469000,2021-06-09
10518,034121,聯詠國泰11購01,0,0,0,0,0,0,0,0,0,-1482000,0,0,0,130000,1612000,-1482000,-1482000,2021-06-09
10519,031077,盛群元大0A購02,0,0,0,0,0,0,0,0,0,-1483000,0,0,0,260000,1743000,-1483000,-1483000,2021-06-09
10520,033906,群創統一0C購11,0,0,0,0,0,0,0,0,0,-1505000,0,0,0,2164000,3669000,-1505000,-1505000,2021-06-09
10521,2331,精英,334000,1607000,-1273000,0,0,0,0,0,0,-252859,6000,2145,3855,15000,271714,-256714,-1525859,2021-06-09
10522,081995,愛普元大08購02,0,0,0,0,0,0,0,0,0,-1527000,0,0,0,343000,1870000,-1527000,-1527000,2021-06-09
10523,2369,菱生,1961000,3489000,-1528000,0,0,0,0,0,0,-404,596,1000,-404,0,0,0,-1528404,2021-06-09
10524,035164,技嘉國票0B購01,0,0,0,0,0,0,0,0,0,-1544000,0,0,0,101000,1645000,-1544000,-1544000,2021-06-09
10525,035971,晶碩元大0C購03,0,0,0,0,0,0,0,0,0,-1631000,0,0,0,235000,1866000,-1631000,-1631000,2021-06-09
10526,2542,興富發,329882,1880255,-1550373,0,0,0,0,167000,-167000,81483,19000,30517,-11517,108000,15000,93000,-1635890,2021-06-09
10527,087390,金像電元大09購01,0,0,0,0,0,0,0,0,0,-1653000,0,0,0,584000,2237000,-1653000,-1653000,2021-06-09
10528,2312,金寶,213000,1871000,-1658000,0,0,0,0,0,0,-10000,0,0,0,0,10000,-10000,-1668000,2021-06-09
10529,2357,華碩,1385030,3020060,-1635030,0,0,0,0,37000,-37000,1038,9000,12962,-3962,36000,31000,5000,-1670992,2021-06-09
10530,03756C,T50反1元大0B牛08,0,0,0,0,0,0,0,0,0,-1675000,0,0,0,0,1675000,-1675000,-1675000,2021-06-09
10531,034945,同欣電群益0B購02,0,0,0,0,0,0,0,0,0,-1676000,0,0,0,0,1676000,-1676000,-1676000,2021-06-09
10532,089042,台積電群益0A購11,0,0,0,0,0,0,0,0,0,-1687000,0,0,0,0,1687000,-1687000,-1687000,2021-06-09
10533,2030,彰源,1260000,2967000,-1707000,0,0,0,0,0,0,0,0,0,0,0,0,0,-1707000,2021-06-09
10534,03750C,T50反1元大09牛04,0,0,0,0,0,0,0,0,0,-1711000,0,0,0,870000,2581000,-1711000,-1711000,2021-06-09
10535,2823,中壽,1038000,2925350,-1887350,0,0,0,0,0,0,172875,0,14125,-14125,187000,0,187000,-1714475,2021-06-09
10536,082950,台積電元富07購39,0,0,0,0,0,0,0,0,0,-1715000,0,0,0,3026000,4741000,-1715000,-1715000,2021-06-09
10537,00712,FH富時不動產,34000,337000,-303000,0,0,0,0,0,0,-1429678,0,0,0,28000,1457678,-1429678,-1732678,2021-06-09
10538,086016,聚鼎元大08購01,0,0,0,0,0,0,0,0,0,-1742000,0,0,0,0,1742000,-1742000,-1742000,2021-06-09
10539,073413,世紀鋼元富0A購01,0,0,0,0,0,0,0,0,0,-1753000,0,0,0,90000,1843000,-1753000,-1753000,2021-06-09
10540,1717,長興,2997000,4894000,-1897000,0,0,0,5000,0,5000,133366,74401,10035,64366,144000,75000,69000,-1758634,2021-06-09
10541,2351,順德,1371000,2255000,-884000,0,0,0,20000,751000,-731000,-178063,30550,76107,-45557,32000,164506,-132506,-1793063,2021-06-09
10542,082645,愛普中信08購01,0,0,0,0,0,0,0,0,0,-1804000,0,0,0,321000,2125000,-1804000,-1804000,2021-06-09
10543,036103,致新元大0C購02,0,0,0,0,0,0,0,0,0,-1806000,0,0,0,91000,1897000,-1806000,-1806000,2021-06-09
10544,2457,飛宏,1381007,3211000,-1829993,0,0,0,0,0,0,-228,354000,354228,-228,0,0,0,-1830221,2021-06-09
10545,086850,聚鼎元大0A購01,0,0,0,0,0,0,0,0,0,-1840000,0,0,0,165000,2005000,-1840000,-1840000,2021-06-09
10546,2615,萬海,960100,2794703,-1834603,0,0,0,0,25000,-25000,2000,89000,105000,-16000,134000,116000,18000,-1857603,2021-06-09
10547,085834,創意群益08購05,0,0,0,0,0,0,0,0,0,-1866000,0,0,0,100000,1966000,-1866000,-1866000,2021-06-09
10548,033588,台航凱基14購01,0,0,0,0,0,0,0,0,0,-1897000,0,0,0,89000,1986000,-1897000,-1897000,2021-06-09
10549,4938,和碩,1202000,3088646,-1886646,0,0,0,0,227000,-227000,192000,145000,24000,121000,99000,28000,71000,-1921646,2021-06-09
10550,6153,嘉聯益,259000,2168000,-1909000,0,0,0,0,0,0,-18860,40000,40000,0,16000,34860,-18860,-1927860,2021-06-09
10551,2390,云辰,15100000,17093000,-1993000,0,0,0,0,0,0,0,0,0,0,0,0,0,-1993000,2021-06-09
10552,034930,世紀鋼國泰11購01,0,0,0,0,0,0,0,0,0,-2005000,0,0,0,84000,2089000,-2005000,-2005000,2021-06-09
10553,030697,南帝群益0B購06,0,0,0,0,0,0,0,0,0,-2021000,0,0,0,25000,2046000,-2021000,-2021000,2021-06-09
10554,1806,冠軍,2229000,4265000,-2036000,0,0,0,0,0,0,0,0,0,0,0,0,0,-2036000,2021-06-09
10555,031565,岱宇凱基0B購01,0,0,0,0,0,0,0,0,0,-2101000,0,0,0,99000,2200000,-2101000,-2101000,2021-06-09
10556,1402,遠東新,831000,2935700,-2104700,0,0,0,0,0,0,-14801,6199,16000,-9801,0,5000,-5000,-2119501,2021-06-09
10557,2441,超豐,1611000,1939000,-328000,0,0,0,254000,1964000,-1710000,-89000,0,2000,-2000,1000,88000,-87000,-2127000,2021-06-09
10558,034761,長榮統一0C購14,0,0,0,0,0,0,0,0,0,-2141000,0,0,0,862000,3003000,-2141000,-2141000,2021-06-09
10559,2006,東和鋼鐵,2344000,3206591,-862591,0,0,0,0,600000,-600000,-698844,231000,416459,-185459,141000,654385,-513385,-2161435,2021-06-09
10560,2880,華南金,634931,2779200,-2144269,0,0,0,0,0,0,-23120,0,36120,-36120,13000,0,13000,-2167389,2021-06-09
10561,1709,和益,1128000,3264000,-2136000,0,0,0,0,0,0,-46000,0,46000,-46000,0,0,0,-2182000,2021-06-09
10562,035360,欣興兆豐0C購02,0,0,0,0,0,0,0,0,0,-2307000,0,0,0,638000,2945000,-2307000,-2307000,2021-06-09
10563,2108,南帝,2904000,5336000,-2432000,0,0,0,0,0,0,123861,73000,71139,1861,123000,1000,122000,-2308139,2021-06-09
10564,03732C,T50反1元大08牛10,0,0,0,0,0,0,0,0,0,-2323000,0,0,0,295000,2618000,-2323000,-2323000,2021-06-09
10565,035972,愛普元大0C購03,0,0,0,0,0,0,0,0,0,-2440000,0,0,0,0,2440000,-2440000,-2440000,2021-06-09
10566,2891,中信金,12630000,14526230,-1896230,0,0,0,0,411000,-411000,-147010,0,54010,-54010,12000,105000,-93000,-2454240,2021-06-09
10567,1718,中纖,2881000,5063000,-2182000,0,0,0,0,0,0,-362262,0,62000,-62000,307000,607262,-300262,-2544262,2021-06-09
10568,2881,富邦金,1832000,4410900,-2578900,0,0,0,0,0,0,-134323,3000,7323,-4323,28000,158000,-130000,-2713223,2021-06-09
10569,2023,燁輝,2633000,4602000,-1969000,0,0,0,0,0,0,-757000,0,295000,-295000,32000,494000,-462000,-2726000,2021-06-09
10570,2363,矽統,3429000,6309000,-2880000,0,0,0,0,0,0,135000,0,0,0,259000,124000,135000,-2745000,2021-06-09
10571,07189P,長榮元大0B售21,0,0,0,0,0,0,0,0,0,-2850000,0,0,0,251000,3101000,-2850000,-2850000,2021-06-09
10572,1447,力鵬,3470000,6360000,-2890000,0,0,0,0,0,0,-24000,0,0,0,0,24000,-24000,-2914000,2021-06-09
10573,033363,欣興群益0C購02,0,0,0,0,0,0,0,0,0,-2928000,0,0,0,327000,3255000,-2928000,-2928000,2021-06-09
10574,2022,聚亨,394000,3376000,-2982000,0,0,0,0,0,0,0,0,0,0,0,0,0,-2982000,2021-06-09
10575,2887,台新金,2118058,5321200,-3203142,0,0,0,0,0,0,-42000,0,31000,-31000,0,11000,-11000,-3245142,2021-06-09
10576,2353,宏碁,5714000,8905900,-3191900,0,0,0,0,4000,-4000,-52289,183000,121289,61711,321000,435000,-114000,-3248189,2021-06-09
10577,03730C,T50反1元大0A牛09,0,0,0,0,0,0,0,0,0,-3277000,0,0,0,347000,3624000,-3277000,-3277000,2021-06-09
10578,2317,鴻海,11151294,13990185,-2838891,0,0,0,0,324000,-324000,-119202,61000,102202,-41202,175000,253000,-78000,-3282093,2021-06-09
10579,0050,元大台灣50,113865,3262300,-3148435,0,0,0,35000,0,35000,-200984,603000,389370,213630,301000,715614,-414614,-3314419,2021-06-09
10580,03754C,T50反1元大0A牛11,0,0,0,0,0,0,0,0,0,-3337000,0,0,0,750000,4087000,-3337000,-3337000,2021-06-09
10581,2885,元大金,1952000,5818460,-3866460,0,0,0,0,0,0,320000,410000,34000,376000,0,56000,-56000,-3546460,2021-06-09
10582,2884,玉山金,3521038,6948097,-3427059,0,0,0,0,0,0,-120000,0,36000,-36000,2000,86000,-84000,-3547059,2021-06-09
10583,4919,新唐,3555000,7623000,-4068000,0,0,0,0,0,0,398489,748000,498511,249489,209000,60000,149000,-3669511,2021-06-09
10584,2890,永豐金,1635000,5306600,-3671600,0,0,0,0,0,0,-16000,0,32000,-32000,18000,2000,16000,-3687600,2021-06-09
10585,00878,國泰永續高股息,31000,1501000,-1470000,0,0,0,0,0,0,-2238540,0,0,0,657000,2895540,-2238540,-3708540,2021-06-09
10586,2834,臺企銀,9529300,13280500,-3751200,0,0,0,0,0,0,18000,30000,12000,18000,0,0,0,-3733200,2021-06-09
10587,8150,南茂,1729000,4748920,-3019920,0,0,0,60000,0,60000,-816077,11000,4077,6923,153000,976000,-823000,-3775997,2021-06-09
10588,0056,元大高股息,179796,213600,-33804,0,0,0,110000,0,110000,-3877573,0,0,0,206000,4083573,-3877573,-3801377,2021-06-09
10589,2882,國泰金,8489005,12124082,-3635077,0,0,0,0,790000,-790000,290240,452000,100760,351240,0,61000,-61000,-4134837,2021-06-09
10590,2886,兆豐金,4582000,7236600,-2654600,0,0,0,0,1942000,-1942000,401000,360000,46000,314000,148000,61000,87000,-4195600,2021-06-09
10591,5880,合庫金,1055220,5425500,-4370280,0,0,0,0,0,0,-32050,6000,38050,-32050,0,0,0,-4402330,2021-06-09
10592,2801,彰銀,2233000,6789600,-4556600,0,0,0,0,0,0,0,0,0,0,0,0,0,-4556600,2021-06-09
10593,2323,中環,205000,5514000,-5309000,0,0,0,0,0,0,-48882,2718,48600,-45882,4000,7000,-3000,-5357882,2021-06-09
10594,1714,和桐,4198000,9623000,-5425000,0,0,0,0,0,0,-71000,0,30000,-30000,29000,70000,-41000,-5496000,2021-06-09
10595,2330,台積電,8343586,13785625,-5442039,0,0,0,847000,385000,462000,-795070,193552,924126,-730574,30000,94496,-64496,-5775109,2021-06-09
10596,5608,四維航,15533000,21842458,-6309458,0,0,0,0,0,0,5000,0,0,0,5000,0,5000,-6304458,2021-06-09
10597,2889,國票金,389000,6928372,-6539372,0,0,0,0,0,0,-8000,2000,10000,-8000,0,0,0,-6547372,2021-06-09
10598,2344,華邦電,14240100,19083635,-4843535,0,0,0,0,1400000,-1400000,-811132,591000,626132,-35132,304000,1080000,-776000,-7054667,2021-06-09
10599,2609,陽明,23985545,32490912,-8505367,0,0,0,50000,0,50000,860442,4047990,3052548,995442,0,135000,-135000,-7594925,2021-06-09
10600,2356,英業達,1587100,8658600,-7071500,0,0,0,0,675000,-675000,100974,126000,31026,94974,269000,263000,6000,-7645526,2021-06-09
10601,3231,緯創,1373100,8908250,-7535150,0,0,0,0,428000,-428000,273890,219000,47110,171890,215000,113000,102000,-7689260,2021-06-09
10602,2329,華泰,9109000,18001000,-8892000,0,0,0,0,0,0,112369,1127,758,369,204000,92000,112000,-8779631,2021-06-09
10603,2382,廣達,2421050,11886961,-9465911,0,0,0,0,201000,-201000,352218,324000,43782,280218,72000,0,72000,-9314693,2021-06-09
10604,2408,南亞科,4955100,11591700,-6636600,0,0,0,60000,2264000,-2204000,-534267,115000,462719,-347719,84000,270548,-186548,-9374867,2021-06-09
10605,00885,富邦越南,369100,5127000,-4757900,0,0,0,0,0,0,-5231166,0,0,0,2348883,7580049,-5231166,-9989066,2021-06-09
10606,3017,奇鋐,4803000,12710000,-7907000,0,0,0,0,1458000,-1458000,-763000,393000,131000,262000,80000,1105000,-1025000,-10128000,2021-06-09
10607,2603,長榮,39291015,47974921,-8683906,0,0,0,153000,196000,-43000,-1406817,3401717,3791740,-390023,427206,1444000,-1016794,-10133723,2021-06-09
10608,00891,中信關鍵半導體,9240,78000,-68760,0,0,0,0,0,0,-11381781,5000,0,5000,714000,12100781,-11386781,-11450541,2021-06-09
10609,2610,華航,23211200,35532698,-12321498,0,0,0,0,0,0,341666,991000,669334,321666,20000,0,20000,-11979832,2021-06-09
10610,2888,新光金,7144464,37315800,-30171336,0,0,0,0,0,0,688902,92000,49546,42454,719000,72552,646448,-29482434,2021-06-09
10611,2303,聯電,18479776,48172237,-29692461,0,0,0,2721000,4251000,-1530000,-4183496,1732000,3945767,-2213767,292300,2262029,-1969729,-35405957,2021-06-09
10612,2409,友達,44078418,82072000,-37993582,0,0,0,30000,1096000,-1066000,-5719890,4314000,4544548,-230548,907000,6396342,-5489342,-44779472,2021-06-09
10613,3481,群創,44359382,79123547,-34764165,0,0,0,35000,11372000,-11337000,-5672540,2077000,2945540,-868540,557000,5361000,-4804000,-51773705,2021-06-09
10614,2002,中鋼,29024365,46289449,-17265084,0,0,0,707000,21539000,-20832000,-14100568,2850000,14917666,-12067666,753098,2786000,-2032902,-52197652,2021-06-09
